"By age ","By qualification of stay","PERIOD","Total","Male","Female",
"Total","Total","2000 ","173071","101757","71314",
"Total","Total","2001 ","163898","92629","71269",
"Total","Total","2002 ","158941","92311","66630",
"Total","Total","2003 ","168875","102988","65887",
"Total","Total","2004 ","178530","103661","74869",
"Total","Total","2005 ","253729","150337","103392",
"Total","Total","2006 ","302963","180452","122511",
"Total","Total","2007 ","300360","165873","134487",
"Total","Total","2008 ","302174","166526","135648",
"Total","Total","2009 ","232844","121260","111584",
"Total","Total","2010 ","293070","156323","136747",
"Total","Total","2011 ","307249","168714","138535",
"Total","Total","2012 ","300177","165110","135067",
"Total","Total","2013 ","360473","201044","159429",
"Total","Total","2014 ","407063","223706","183357",
"Total","Total","2015 ","372935","200112","172823",
"Total","Total","2016 ","402203","217452","184751",
"Total","Total","2017 ","452657","245397","207260",
"Total","Total","2018 ","495079","268533","226546",
"Total","Total","2019 ","438220","230063","208157",
"Total","Sightseeing Pass","2000 ","14923","8731","6192",
"Total","Sightseeing Pass","2001 ","20954","13521","7433",
"Total","Sightseeing Pass","2002 ","22907","14581","8326",
"Total","Sightseeing Pass","2003 ","17814","10914","6900",
"Total","Sightseeing Pass","2004 ","18729","10858","7871",
"Total","Sightseeing Pass","2005 ","17688","10029","7659",
"Total","Sightseeing Pass","2006 ","15922","8833","7089",
"Total","Sightseeing Pass","2007 ","15911","8750","7161",
"Total","Sightseeing Pass","2008 ","18336","10226","8110",
"Total","Sightseeing Pass","2009 ","21012","11159","9853",
"Total","Sightseeing Pass","2010 ","25681","13778","11903",
"Total","Sightseeing Pass","2011 ","24239","12275","11964",
"Total","Sightseeing Pass","2012 ","24733","12402","12331",
"Total","Sightseeing Pass","2013 ","22044","11290","10754",
"Total","Sightseeing Pass","2014 ","23441","12346","11095",
"Total","Sightseeing Pass","2015 ","26335","14260","12075",
"Total","Sightseeing Pass","2016 ","23863","12822","11041",
"Total","Sightseeing Pass","2017 ","24137","13669","10468",
"Total","Sightseeing Pass","2018 ","32990","19541","13449",
"Total","Sightseeing Pass","2019 ","23192","11590","11602",
"Total","Short-term Business","2000 ","17718","11396","6322",
"Total","Short-term Business","2001 ","21027","13370","7657",
"Total","Short-term Business","2002 ","10761","7248","3513",
"Total","Short-term Business","2003 ","7832","5716","2116",
"Total","Short-term Business","2004 ","7626","5670","1956",
"Total","Short-term Business","2005 ","6505","4810","1695",
"Total","Short-term Business","2006 ","11925","8792","3133",
"Total","Short-term Business","2007 ","16168","12039","4129",
"Total","Short-term Business","2008 ","8443","6609","1834",
"Total","Short-term Business","2009 ","2894","2375","519",
"Total","Short-term Business","2010 ","2752","2367","385",
"Total","Short-term Business","2011 ","2566","2267","299",
"Total","Short-term Visitors","2000 ","50276","27106","23170",
"Total","Short-term Visitors","2001 ","44844","24313","20531",
"Total","Short-term Visitors","2002 ","40911","23394","17517",
"Total","Short-term Visitors","2003 ","31061","16682","14379",
"Total","Short-term Visitors","2004 ","28097","15740","12357",
"Total","Short-term Visitors","2005 ","35747","17793","17954",
"Total","Short-term Visitors","2006 ","37417","19191","18226",
"Total","Short-term Visitors","2007 ","30892","15067","15825",
"Total","Short-term Visitors","2008 ","23862","10857","13005",
"Total","Short-term Visitors","2009 ","16853","6767","10086",
"Total","Short-term Visitors","2010 ","44145","21547","22598",
"Total","Short-term Visitors","2011 ","57438","28414","29024",
"Total","Short-term Visitors","2012 ","56201","28937","27264",
"Total","Short-term Visitors","2013 ","73162","38866","34296",
"Total","Short-term Visitors","2014 ","54904","28822","26082",
"Total","Short-term Visitors","2015 ","64459","33682","30777",
"Total","Short-term Visitors","2016 ","64412","35159","29253",
"Total","Short-term Visitors","2017 ","62527","35336","27191",
"Total","Short-term Visitors","2018 ","63315","35655","27660",
"Total","Short-term Visitors","2019 ","58692","33814","24878",
"Total","Short-term Employment","2000 ","210","166","44",
"Total","Short-term Employment","2001 ","166","99","67",
"Total","Short-term Employment","2002 ","335","213","122",
"Total","Short-term Employment","2003 ","388","247","141",
"Total","Short-term Employment","2004 ","336","201","135",
"Total","Short-term Employment","2005 ","389","243","146",
"Total","Short-term Employment","2006 ","369","231","138",
"Total","Short-term Employment","2007 ","484","293","191",
"Total","Short-term Employment","2008 ","317","200","117",
"Total","Short-term Employment","2009 ","161","95","66",
"Total","Short-term Employment","2010 ","153","84","69",
"Total","Short-term Employment","2011 ","131","82","49",
"Total","Short-term Employment","2012 ","194","118","76",
"Total","Short-term Employment","2013 ","76","51","25",
"Total","Short-term Employment","2014 ","77","51","26",
"Total","Short-term Employment","2015 ","127","93","34",
"Total","Short-term Employment","2016 ","361","326","35",
"Total","Short-term Employment","2017 ","253","140","113",
"Total","Short-term Employment","2018 ","242","170","72",
"Total","Short-term Employment","2019 ","210","155","55",
"Total","Job Seeking","2000 ","0","0","0",
"Total","Job Seeking","2001 ","0","0","0",
"Total","Job Seeking","2002 ","0","0","0",
"Total","Job Seeking","2003 ","0","0","0",
"Total","Job Seeking","2004 ","0","0","0",
"Total","Job Seeking","2005 ","0","0","0",
"Total","Job Seeking","2006 ","0","0","0",
"Total","Job Seeking","2007 ","0","0","0",
"Total","Job Seeking","2008 ","0","0","0",
"Total","Job Seeking","2009 ","1","0","1",
"Total","Job Seeking","2010 ","7","4","3",
"Total","Job Seeking","2011 ","18","11","7",
"Total","Job Seeking","2012 ","87","41","46",
"Total","Job Seeking","2013 ","190","78","112",
"Total","Job Seeking","2014 ","200","88","112",
"Total","Job Seeking","2015 ","199","87","112",
"Total","Job Seeking","2016 ","235","86","149",
"Total","Job Seeking","2017 ","204","85","119",
"Total","Job Seeking","2018 ","295","117","178",
"Total","Job Seeking","2019 ","237","118","119",
"Total","study","2000 ","1702","899","803",
"Total","study","2001 ","2166","1085","1081",
"Total","study","2002 ","2949","1428","1521",
"Total","study","2003 ","4115","2037","2078",
"Total","study","2004 ","6784","3402","3382",
"Total","study","2005 ","8823","4415","4408",
"Total","study","2006 ","12725","6275","6450",
"Total","study","2007 ","14873","7079","7794",
"Total","study","2008 ","14703","6627","8076",
"Total","study","2009 ","14845","6289","8556",
"Total","study","2010 ","16764","6745","10019",
"Total","study","2011 ","15634","6216","9418",
"Total","study","2012 ","15355","6262","9093",
"Total","study","2013 ","19151","7216","11935",
"Total","study","2014 ","21931","7736","14195",
"Total","study","2015 ","23392","8085","15307",
"Total","study","2016 ","27271","9183","18088",
"Total","study","2017 ","28190","10132","18058",
"Total","study","2018 ","35476","13000","22476",
"Total","study","2019 ","35338","13416","21922",
"Total","General Trainees","2000 ","1199","621","578",
"Total","General Trainees","2001 ","1498","746","752",
"Total","General Trainees","2002 ","1423","746","677",
"Total","General Trainees","2003 ","1907","999","908",
"Total","General Trainees","2004 ","3516","1790","1726",
"Total","General Trainees","2005 ","4408","2262","2146",
"Total","General Trainees","2006 ","8465","4396","4069",
"Total","General Trainees","2007 ","13573","7143","6430",
"Total","General Trainees","2008 ","13599","6817","6782",
"Total","General Trainees","2009 ","10895","5119","5776",
"Total","General Trainees","2010 ","11849","5375","6474",
"Total","General Trainees","2011 ","13337","6397","6940",
"Total","General Trainees","2012 ","12214","5579","6635",
"Total","General Trainees","2013 ","12456","5414","7042",
"Total","General Trainees","2014 ","15090","6220","8870",
"Total","General Trainees","2015 ","17027","7146","9881",
"Total","General Trainees","2016 ","25325","11337","13988",
"Total","General Trainees","2017 ","29835","14688","15147",
"Total","General Trainees","2018 ","33345","16790","16555",
"Total","General Trainees","2019 ","30148","13934","16214",
"Total","Religious Activities","2000 ","527","329","198",
"Total","Religious Activities","2001 ","637","358","279",
"Total","Religious Activities","2002 ","579","344","235",
"Total","Religious Activities","2003 ","523","327","196",
"Total","Religious Activities","2004 ","514","332","182",
"Total","Religious Activities","2005 ","585","352","233",
"Total","Religious Activities","2006 ","643","397","246",
"Total","Religious Activities","2007 ","662","399","263",
"Total","Religious Activities","2008 ","632","374","258",
"Total","Religious Activities","2009 ","478","263","215",
"Total","Religious Activities","2010 ","535","308","227",
"Total","Religious Activities","2011 ","491","263","228",
"Total","Religious Activities","2012 ","2151","639","1512",
"Total","Religious Activities","2013 ","667","380","287",
"Total","Religious Activities","2014 ","576","355","221",
"Total","Religious Activities","2015 ","524","268","256",
"Total","Religious Activities","2016 ","567","299","268",
"Total","Religious Activities","2017 ","519","266","253",
"Total","Religious Activities","2018 ","447","206","241",
"Total","Religious Activities","2019 ","422","196","226",
"Total","Investors","2000 ","1891","1201","690",
"Total","Investors","2001 ","1617","1225","392",
"Total","Investors","2002 ","1214","1097","117",
"Total","Investors","2003 ","1036","942","94",
"Total","Investors","2004 ","1145","978","167",
"Total","Investors","2005 ","1474","1244","230",
"Total","Investors","2006 ","895","788","107",
"Total","Investors","2007 ","1001","911","90",
"Total","Investors","2008 ","1020","912","108",
"Total","Investors","2009 ","813","754","59",
"Total","Investors","2010 ","873","789","84",
"Total","Investors","2011 ","840","766","74",
"Total","Investors","2012 ","793","749","44",
"Total","Investors","2013 ","921","854","67",
"Total","Investors","2014 ","593","539","54",
"Total","Investors","2015 ","565","515","50",
"Total","Investors","2016 ","717","660","57",
"Total","Investors","2017 ","501","450","51",
"Total","Investors","2018 ","603","543","60",
"Total","Investors","2019 ","589","505","84",
"Total","Trade and Business","2000 ","336","323","13",
"Total","Trade and Business","2001 ","486","472","14",
"Total","Trade and Business","2002 ","518","505","13",
"Total","Trade and Business","2003 ","548","529","19",
"Total","Trade and Business","2004 ","541","523","18",
"Total","Trade and Business","2005 ","764","745","19",
"Total","Trade and Business","2006 ","586","579","7",
"Total","Trade and Business","2007 ","647","634","13",
"Total","Trade and Business","2008 ","724","708","16",
"Total","Trade and Business","2009 ","819","802","17",
"Total","Trade and Business","2010 ","922","894","28",
"Total","Trade and Business","2011 ","1125","1079","46",
"Total","Trade and Business","2012 ","1213","1173","40",
"Total","Trade and Business","2013 ","1643","1572","71",
"Total","Trade and Business","2014 ","1771","1690","81",
"Total","Trade and Business","2015 ","1393","1328","65",
"Total","Trade and Business","2016 ","1107","1055","52",
"Total","Trade and Business","2017 ","715","671","44",
"Total","Trade and Business","2018 ","650","614","36",
"Total","Trade and Business","2019 ","652","609","43",
"Total","Research","2000 ","471","397","74",
"Total","Research","2001 ","556","465","91",
"Total","Research","2002 ","643","560","83",
"Total","Research","2003 ","691","587","104",
"Total","Research","2004 ","748","628","120",
"Total","Research","2005 ","731","624","107",
"Total","Research","2006 ","812","677","135",
"Total","Research","2007 ","781","659","122",
"Total","Research","2008 ","580","482","98",
"Total","Research","2009 ","550","469","81",
"Total","Research","2010 ","692","595","97",
"Total","Research","2011 ","742","639","103",
"Total","Research","2012 ","762","659","103",
"Total","Research","2013 ","881","764","117",
"Total","Research","2014 ","758","668","90",
"Total","Research","2015 ","675","573","102",
"Total","Research","2016 ","852","744","108",
"Total","Research","2017 ","701","593","108",
"Total","Research","2018 ","768","660","108",
"Total","Research","2019 ","674","569","105",
"Total","Art and Entertainment","2000 ","4747","626","4121",
"Total","Art and Entertainment","2001 ","5600","737","4863",
"Total","Art and Entertainment","2002 ","4515","796","3719",
"Total","Art and Entertainment","2003 ","3179","743","2436",
"Total","Art and Entertainment","2004 ","2950","804","2146",
"Total","Art and Entertainment","2005 ","3571","938","2633",
"Total","Art and Entertainment","2006 ","2911","876","2035",
"Total","Art and Entertainment","2007 ","2678","733","1945",
"Total","Art and Entertainment","2008 ","3035","811","2224",
"Total","Art and Entertainment","2009 ","2780","545","2235",
"Total","Art and Entertainment","2010 ","2549","633","1916",
"Total","Art and Entertainment","2011 ","1941","622","1319",
"Total","Art and Entertainment","2012 ","2472","642","1830",
"Total","Art and Entertainment","2013 ","2423","612","1811",
"Total","Art and Entertainment","2014 ","2516","663","1853",
"Total","Art and Entertainment","2015 ","2119","580","1539",
"Total","Art and Entertainment","2016 ","1575","561","1014",
"Total","Art and Entertainment","2017 ","1112","522","590",
"Total","Art and Entertainment","2018 ","1178","542","636",
"Total","Art and Entertainment","2019 ","1298","536","762",
"Total","Unskilled Employment","2000 ","0","0","0",
"Total","Unskilled Employment","2001 ","0","0","0",
"Total","Unskilled Employment","2002 ","0","0","0",
"Total","Unskilled Employment","2003 ","1465","1066","399",
"Total","Unskilled Employment","2004 ","5849","4533","1316",
"Total","Unskilled Employment","2005 ","31487","27426","4061",
"Total","Unskilled Employment","2006 ","28881","25151","3730",
"Total","Unskilled Employment","2007 ","30213","27481","2732",
"Total","Unskilled Employment","2008 ","45894","41418","4476",
"Total","Unskilled Employment","2009 ","24047","21874","2173",
"Total","Unskilled Employment","2010 ","34862","31898","2964",
"Total","Unskilled Employment","2011 ","50113","45342","4771",
"Total","Unskilled Employment","2012 ","54545","49728","4817",
"Total","Unskilled Employment","2013 ","59522","54421","5101",
"Total","Unskilled Employment","2014 ","53219","48697","4522",
"Total","Unskilled Employment","2015 ","52167","47582","4585",
"Total","Unskilled Employment","2016 ","60538","54999","5539",
"Total","Unskilled Employment","2017 ","51341","46703","4638",
"Total","Unskilled Employment","2018 ","54499","50390","4109",
"Total","Unskilled Employment","2019 ","53399","49494","3905",
"Total","Visiting and Joining Family","2000 ","8594","2462","6132",
"Total","Visiting and Joining Family","2001 ","12123","2498","9625",
"Total","Visiting and Joining Family","2002 ","9290","2682","6608",
"Total","Visiting and Joining Family","2003 ","11337","5672","5665",
"Total","Visiting and Joining Family","2004 ","18245","9617","8628",
"Total","Visiting and Joining Family","2005 ","51204","26703","24501",
"Total","Visiting and Joining Family","2006 ","84400","46391","38009",
"Total","Visiting and Joining Family","2007 ","17668","9173","8495",
"Total","Visiting and Joining Family","2008 ","5554","2794","2760",
"Total","Visiting and Joining Family","2009 ","5335","2631","2704",
"Total","Visiting and Joining Family","2010 ","8410","4404","4006",
"Total","Visiting and Joining Family","2011 ","6955","3337","3618",
"Total","Visiting and Joining Family","2012 ","7132","2627","4505",
"Total","Visiting and Joining Family","2013 ","7684","2629","5055",
"Total","Visiting and Joining Family","2014 ","8091","2763","5328",
"Total","Visiting and Joining Family","2015 ","10394","3671","6723",
"Total","Visiting and Joining Family","2016 ","17195","6535","10660",
"Total","Visiting and Joining Family","2017 ","17803","7265","10538",
"Total","Visiting and Joining Family","2018 ","18177","7559","10618",
"Total","Visiting and Joining Family","2019 ","20493","8239","12254",
"Total","Overseas Koreans","2000 ","1258","669","589",
"Total","Overseas Koreans","2001 ","1584","803","781",
"Total","Overseas Koreans","2002 ","2139","1106","1033",
"Total","Overseas Koreans","2003 ","2190","1157","1033",
"Total","Overseas Koreans","2004 ","2244","1120","1124",
"Total","Overseas Koreans","2005 ","2620","1263","1357",
"Total","Overseas Koreans","2006 ","2655","1264","1391",
"Total","Overseas Koreans","2007 ","3196","1465","1731",
"Total","Overseas Koreans","2008 ","4198","1947","2251",
"Total","Overseas Koreans","2009 ","4942","2390","2552",
"Total","Overseas Koreans","2010 ","15529","7206","8323",
"Total","Overseas Koreans","2011 ","20999","10058","10941",
"Total","Overseas Koreans","2012 ","19480","9324","10156",
"Total","Overseas Koreans","2013 ","28587","13936","14651",
"Total","Overseas Koreans","2014 ","40802","18788","22014",
"Total","Overseas Koreans","2015 ","45617","21165","24452",
"Total","Overseas Koreans","2016 ","51500","24324","27176",
"Total","Overseas Koreans","2017 ","51953","24390","27563",
"Total","Overseas Koreans","2018 ","54882","25604","29278",
"Total","Overseas Koreans","2019 ","52736","24401","28335",
"Total","Permanent Residence","2000 ","0","0","0",
"Total","Permanent Residence","2001 ","0","0","0",
"Total","Permanent Residence","2002 ","14","7","7",
"Total","Permanent Residence","2003 ","246","141","105",
"Total","Permanent Residence","2004 ","419","228","191",
"Total","Permanent Residence","2005 ","420","215","205",
"Total","Permanent Residence","2006 ","358","194","164",
"Total","Permanent Residence","2007 ","468","208","260",
"Total","Permanent Residence","2008 ","586","241","345",
"Total","Permanent Residence","2009 ","610","231","379",
"Total","Permanent Residence","2010 ","1192","526","666",
"Total","Permanent Residence","2011 ","2741","1258","1483",
"Total","Permanent Residence","2012 ","3928","1813","2115",
"Total","Permanent Residence","2013 ","5062","2328","2734",
"Total","Permanent Residence","2014 ","5509","2532","2977",
"Total","Permanent Residence","2015 ","5790","2580","3210",
"Total","Permanent Residence","2016 ","5824","2555","3269",
"Total","Permanent Residence","2017 ","5921","2543","3378",
"Total","Permanent Residence","2018 ","6104","2600","3504",
"Total","Permanent Residence","2019 ","6168","2534","3634",
"Total","Marriage Immigration","2011 ","783","58","725",
"Total","Marriage Immigration","2012 ","17001","1547","15454",
"Total","Marriage Immigration","2013 ","15890","1576","14314",
"Total","Marriage Immigration","2014 ","12204","1440","10764",
"Total","Marriage Immigration","2015 ","11470","1257","10213",
"Total","Marriage Immigration","2016 ","12214","1412","10802",
"Total","Marriage Immigration","2017 ","11679","1371","10308",
"Total","Marriage Immigration","2018 ","12557","1560","10997",
"Total","Marriage Immigration","2019 ","13396","1755","11641",
"0 s","Total","2000 ","1761","899","862",
"0 s","Total","2001 ","2054","1059","995",
"0 s","Total","2002 ","2472","1361","1111",
"0 s","Total","2003 ","2752","1543","1209",
"0 s","Total","2004 ","2963","1620","1343",
"0 s","Total","2005 ","2912","1540","1372",
"0 s","Total","2006 ","2674","1474","1200",
"0 s","Total","2007 ","3370","1783","1587",
"0 s","Total","2008 ","3956","2115","1841",
"0 s","Total","2009 ","3740","2017","1723",
"0 s","Total","2010 ","3845","2003","1842",
"0 s","Total","2011 ","3461","1768","1693",
"0 s","Total","2012 ","3687","1899","1788",
"0 s","Total","2013 ","4104","2181","1923",
"0 s","Total","2014 ","4074","2090","1984",
"0 s","Total","2015 ","4172","2143","2029",
"0 s","Total","2016 ","3732","1954","1778",
"0 s","Total","2017 ","3626","1891","1735",
"0 s","Total","2018 ","3644","1909","1735",
"0 s","Total","2019 ","3708","1911","1797",
"0 s","Sightseeing Pass","2000 ","570","282","288",
"0 s","Sightseeing Pass","2001 ","730","389","341",
"0 s","Sightseeing Pass","2002 ","936","511","425",
"0 s","Sightseeing Pass","2003 ","1202","685","517",
"0 s","Sightseeing Pass","2004 ","1558","863","695",
"0 s","Sightseeing Pass","2005 ","1654","869","785",
"0 s","Sightseeing Pass","2006 ","1576","843","733",
"0 s","Sightseeing Pass","2007 ","2216","1195","1021",
"0 s","Sightseeing Pass","2008 ","2664","1442","1222",
"0 s","Sightseeing Pass","2009 ","2733","1499","1234",
"0 s","Sightseeing Pass","2010 ","2811","1482","1329",
"0 s","Sightseeing Pass","2011 ","2430","1247","1183",
"0 s","Sightseeing Pass","2012 ","2461","1270","1191",
"0 s","Sightseeing Pass","2013 ","2565","1381","1184",
"0 s","Sightseeing Pass","2014 ","2454","1271","1183",
"0 s","Sightseeing Pass","2015 ","2291","1215","1076",
"0 s","Sightseeing Pass","2016 ","1944","1006","938",
"0 s","Sightseeing Pass","2017 ","1848","960","888",
"0 s","Sightseeing Pass","2018 ","1931","1028","903",
"0 s","Sightseeing Pass","2019 ","1896","997","899",
"0 s","Short-term Business","2000 ","3","1","2",
"0 s","Short-term Business","2001 ","2","1","1",
"0 s","Short-term Business","2002 ","5","2","3",
"0 s","Short-term Business","2003 ","5","3","2",
"0 s","Short-term Business","2004 ","4","2","2",
"0 s","Short-term Business","2005 ","6","5","1",
"0 s","Short-term Business","2006 ","7","4","3",
"0 s","Short-term Business","2007 ","6","3","3",
"0 s","Short-term Business","2008 ","1","0","1",
"0 s","Short-term Business","2009 ","5","3","2",
"0 s","Short-term Business","2010 ","2","1","1",
"0 s","Short-term Business","2011 ","3","1","2",
"0 s","Short-term Visitors","2000 ","333","171","162",
"0 s","Short-term Visitors","2001 ","390","205","185",
"0 s","Short-term Visitors","2002 ","423","257","166",
"0 s","Short-term Visitors","2003 ","465","238","227",
"0 s","Short-term Visitors","2004 ","424","222","202",
"0 s","Short-term Visitors","2005 ","426","233","193",
"0 s","Short-term Visitors","2006 ","376","207","169",
"0 s","Short-term Visitors","2007 ","450","216","234",
"0 s","Short-term Visitors","2008 ","592","304","288",
"0 s","Short-term Visitors","2009 ","324","170","154",
"0 s","Short-term Visitors","2010 ","329","166","163",
"0 s","Short-term Visitors","2011 ","480","234","246",
"0 s","Short-term Visitors","2012 ","573","307","266",
"0 s","Short-term Visitors","2013 ","836","427","409",
"0 s","Short-term Visitors","2014 ","750","380","370",
"0 s","Short-term Visitors","2015 ","957","478","479",
"0 s","Short-term Visitors","2016 ","844","442","402",
"0 s","Short-term Visitors","2017 ","737","404","333",
"0 s","Short-term Visitors","2018 ","646","327","319",
"0 s","Short-term Visitors","2019 ","557","272","285",
"0 s","Short-term Employment","2000 ","0","0","0",
"0 s","Short-term Employment","2001 ","0","0","0",
"0 s","Short-term Employment","2002 ","0","0","0",
"0 s","Short-term Employment","2003 ","0","0","0",
"0 s","Short-term Employment","2004 ","0","0","0",
"0 s","Short-term Employment","2005 ","0","0","0",
"0 s","Short-term Employment","2006 ","0","0","0",
"0 s","Short-term Employment","2007 ","0","0","0",
"0 s","Short-term Employment","2008 ","0","0","0",
"0 s","Short-term Employment","2009 ","0","0","0",
"0 s","Short-term Employment","2010 ","0","0","0",
"0 s","Job Seeking","2000 ","0","0","0",
"0 s","Job Seeking","2001 ","0","0","0",
"0 s","Job Seeking","2002 ","0","0","0",
"0 s","Job Seeking","2003 ","0","0","0",
"0 s","Job Seeking","2004 ","0","0","0",
"0 s","Job Seeking","2005 ","0","0","0",
"0 s","Job Seeking","2006 ","0","0","0",
"0 s","Job Seeking","2007 ","0","0","0",
"0 s","Job Seeking","2008 ","0","0","0",
"0 s","Job Seeking","2009 ","0","0","0",
"0 s","Job Seeking","2010 ","0","0","0",
"0 s","study","2000 ","0","0","0",
"0 s","study","2001 ","0","0","0",
"0 s","study","2002 ","1","1","0",
"0 s","study","2003 ","0","0","0",
"0 s","study","2004 ","1","1","0",
"0 s","study","2005 ","0","0","0",
"0 s","study","2006 ","1","1","0",
"0 s","study","2007 ","0","0","0",
"0 s","study","2008 ","0","0","0",
"0 s","study","2009 ","0","0","0",
"0 s","study","2010 ","0","0","0",
"0 s","General Trainees","2000 ","1","1","0",
"0 s","General Trainees","2001 ","0","0","0",
"0 s","General Trainees","2002 ","0","0","0",
"0 s","General Trainees","2003 ","0","0","0",
"0 s","General Trainees","2004 ","0","0","0",
"0 s","General Trainees","2005 ","0","0","0",
"0 s","General Trainees","2006 ","1","1","0",
"0 s","General Trainees","2007 ","0","0","0",
"0 s","General Trainees","2008 ","0","0","0",
"0 s","General Trainees","2009 ","0","0","0",
"0 s","General Trainees","2010 ","0","0","0",
"0 s","Religious Activities","2000 ","0","0","0",
"0 s","Religious Activities","2001 ","0","0","0",
"0 s","Religious Activities","2002 ","0","0","0",
"0 s","Religious Activities","2003 ","0","0","0",
"0 s","Religious Activities","2004 ","0","0","0",
"0 s","Religious Activities","2005 ","0","0","0",
"0 s","Religious Activities","2006 ","0","0","0",
"0 s","Religious Activities","2007 ","0","0","0",
"0 s","Religious Activities","2008 ","0","0","0",
"0 s","Religious Activities","2009 ","0","0","0",
"0 s","Religious Activities","2010 ","0","0","0",
"0 s","Investors","2000 ","0","0","0",
"0 s","Investors","2001 ","4","3","1",
"0 s","Investors","2002 ","1","1","0",
"0 s","Investors","2003 ","0","0","0",
"0 s","Investors","2004 ","2","2","0",
"0 s","Investors","2005 ","3","3","0",
"0 s","Investors","2006 ","2","2","0",
"0 s","Investors","2007 ","0","0","0",
"0 s","Investors","2008 ","0","0","0",
"0 s","Investors","2009 ","0","0","0",
"0 s","Investors","2010 ","0","0","0",
"0 s","Trade and Business","2000 ","0","0","0",
"0 s","Trade and Business","2001 ","0","0","0",
"0 s","Trade and Business","2002 ","0","0","0",
"0 s","Trade and Business","2003 ","0","0","0",
"0 s","Trade and Business","2004 ","0","0","0",
"0 s","Trade and Business","2005 ","0","0","0",
"0 s","Trade and Business","2006 ","1","1","0",
"0 s","Trade and Business","2007 ","0","0","0",
"0 s","Trade and Business","2008 ","0","0","0",
"0 s","Trade and Business","2009 ","0","0","0",
"0 s","Trade and Business","2010 ","0","0","0",
"0 s","Research","2000 ","0","0","0",
"0 s","Research","2001 ","0","0","0",
"0 s","Research","2002 ","0","0","0",
"0 s","Research","2003 ","2","0","2",
"0 s","Research","2004 ","0","0","0",
"0 s","Research","2005 ","0","0","0",
"0 s","Research","2006 ","0","0","0",
"0 s","Research","2007 ","0","0","0",
"0 s","Research","2008 ","0","0","0",
"0 s","Research","2009 ","0","0","0",
"0 s","Research","2010 ","0","0","0",
"0 s","Art and Entertainment","2000 ","1","0","1",
"0 s","Art and Entertainment","2001 ","2","0","2",
"0 s","Art and Entertainment","2002 ","0","0","0",
"0 s","Art and Entertainment","2003 ","0","0","0",
"0 s","Art and Entertainment","2004 ","1","0","1",
"0 s","Art and Entertainment","2005 ","0","0","0",
"0 s","Art and Entertainment","2006 ","0","0","0",
"0 s","Art and Entertainment","2007 ","0","0","0",
"0 s","Art and Entertainment","2008 ","0","0","0",
"0 s","Art and Entertainment","2009 ","0","0","0",
"0 s","Art and Entertainment","2010 ","0","0","0",
"0 s","Unskilled Employment","2000 ","0","0","0",
"0 s","Unskilled Employment","2001 ","0","0","0",
"0 s","Unskilled Employment","2002 ","0","0","0",
"0 s","Unskilled Employment","2003 ","0","0","0",
"0 s","Unskilled Employment","2004 ","1","0","1",
"0 s","Unskilled Employment","2005 ","2","2","0",
"0 s","Unskilled Employment","2006 ","2","2","0",
"0 s","Unskilled Employment","2007 ","0","0","0",
"0 s","Unskilled Employment","2008 ","0","0","0",
"0 s","Unskilled Employment","2009 ","0","0","0",
"0 s","Unskilled Employment","2010 ","0","0","0",
"0 s","Unskilled Employment","2012 ","1","1","",
"0 s","Visiting and Joining Family","2000 ","605","321","284",
"0 s","Visiting and Joining Family","2001 ","678","334","344",
"0 s","Visiting and Joining Family","2002 ","816","435","381",
"0 s","Visiting and Joining Family","2003 ","774","458","316",
"0 s","Visiting and Joining Family","2004 ","602","332","270",
"0 s","Visiting and Joining Family","2005 ","471","251","220",
"0 s","Visiting and Joining Family","2006 ","403","249","154",
"0 s","Visiting and Joining Family","2007 ","370","201","169",
"0 s","Visiting and Joining Family","2008 ","351","190","161",
"0 s","Visiting and Joining Family","2009 ","318","175","143",
"0 s","Visiting and Joining Family","2010 ","255","133","122",
"0 s","Visiting and Joining Family","2011 ","114","56","58",
"0 s","Visiting and Joining Family","2012 ","85","41","44",
"0 s","Visiting and Joining Family","2013 ","106","60","46",
"0 s","Visiting and Joining Family","2014 ","156","75","81",
"0 s","Visiting and Joining Family","2015 ","176","90","86",
"0 s","Visiting and Joining Family","2016 ","261","136","125",
"0 s","Visiting and Joining Family","2017 ","355","172","183",
"0 s","Visiting and Joining Family","2018 ","363","181","182",
"0 s","Visiting and Joining Family","2019 ","478","241","237",
"0 s","Overseas Koreans","2000 ","35","18","17",
"0 s","Overseas Koreans","2001 ","19","10","9",
"0 s","Overseas Koreans","2002 ","15","8","7",
"0 s","Overseas Koreans","2003 ","9","7","2",
"0 s","Overseas Koreans","2004 ","5","2","3",
"0 s","Overseas Koreans","2005 ","4","0","4",
"0 s","Overseas Koreans","2006 ","5","3","2",
"0 s","Overseas Koreans","2007 ","5","2","3",
"0 s","Overseas Koreans","2008 ","6","4","2",
"0 s","Overseas Koreans","2009 ","10","5","5",
"0 s","Overseas Koreans","2010 ","29","12","17",
"0 s","Overseas Koreans","2011 ","29","16","13",
"0 s","Overseas Koreans","2012 ","15","8","7",
"0 s","Overseas Koreans","2013 ","8","2","6",
"0 s","Overseas Koreans","2014 ","9","5","4",
"0 s","Overseas Koreans","2015 ","8","3","5",
"0 s","Overseas Koreans","2016 ","13","9","4",
"0 s","Overseas Koreans","2017 ","8","3","5",
"0 s","Overseas Koreans","2018 ","5","2","3",
"0 s","Overseas Koreans","2019 ","13","7","6",
"0 s","Permanent Residence","2000 ","0","0","0",
"0 s","Permanent Residence","2001 ","0","0","0",
"0 s","Permanent Residence","2002 ","0","0","0",
"0 s","Permanent Residence","2003 ","2","1","1",
"0 s","Permanent Residence","2004 ","3","1","2",
"0 s","Permanent Residence","2005 ","0","0","0",
"0 s","Permanent Residence","2006 ","2","2","0",
"0 s","Permanent Residence","2007 ","1","1","0",
"0 s","Permanent Residence","2008 ","3","2","1",
"0 s","Permanent Residence","2009 ","1","1","0",
"0 s","Permanent Residence","2010 ","3","2","1",
"0 s","Permanent Residence","2011 ","3","1","2",
"0 s","Permanent Residence","2012 ","14","8","6",
"0 s","Permanent Residence","2013 ","35","16","19",
"0 s","Permanent Residence","2014 ","37","17","20",
"0 s","Permanent Residence","2015 ","58","34","24",
"0 s","Permanent Residence","2016 ","35","16","19",
"0 s","Permanent Residence","2017 ","56","29","27",
"0 s","Permanent Residence","2018 ","33","19","14",
"0 s","Permanent Residence","2019 ","39","19","20",
"0 s","Marriage Immigration","2012 ","1","","1",
"0 s","Marriage Immigration","2014 ","1","1","0",
"1 s","Total","2000 ","987","499","488",
"1 s","Total","2001 ","1094","590","504",
"1 s","Total","2002 ","1161","639","522",
"1 s","Total","2003 ","1098","547","551",
"1 s","Total","2004 ","1152","595","557",
"1 s","Total","2005 ","1170","609","561",
"1 s","Total","2006 ","1259","689","570",
"1 s","Total","2007 ","1279","649","630",
"1 s","Total","2008 ","1623","825","798",
"1 s","Total","2009 ","1782","906","876",
"1 s","Total","2010 ","1993","995","998",
"1 s","Total","2011 ","2091","1067","1024",
"1 s","Total","2012 ","2360","1201","1159",
"1 s","Total","2013 ","2713","1416","1297",
"1 s","Total","2014 ","2967","1505","1462",
"1 s","Total","2015 ","2912","1412","1500",
"1 s","Total","2016 ","2879","1500","1379",
"1 s","Total","2017 ","2774","1461","1313",
"1 s","Total","2018 ","3048","1518","1530",
"1 s","Total","2019 ","2854","1442","1412",
"1 s","Sightseeing Pass","2000 ","259","138","121",
"1 s","Sightseeing Pass","2001 ","351","195","156",
"1 s","Sightseeing Pass","2002 ","410","231","179",
"1 s","Sightseeing Pass","2003 ","405","194","211",
"1 s","Sightseeing Pass","2004 ","464","234","230",
"1 s","Sightseeing Pass","2005 ","483","242","241",
"1 s","Sightseeing Pass","2006 ","520","278","242",
"1 s","Sightseeing Pass","2007 ","519","247","272",
"1 s","Sightseeing Pass","2008 ","746","376","370",
"1 s","Sightseeing Pass","2009 ","939","476","463",
"1 s","Sightseeing Pass","2010 ","1045","509","536",
"1 s","Sightseeing Pass","2011 ","997","492","505",
"1 s","Sightseeing Pass","2012 ","1103","550","553",
"1 s","Sightseeing Pass","2013 ","1099","547","552",
"1 s","Sightseeing Pass","2014 ","1060","536","524",
"1 s","Sightseeing Pass","2015 ","956","459","497",
"1 s","Sightseeing Pass","2016 ","788","409","379",
"1 s","Sightseeing Pass","2017 ","778","399","379",
"1 s","Sightseeing Pass","2018 ","866","421","445",
"1 s","Sightseeing Pass","2019 ","803","400","403",
"1 s","Short-term Business","2000 ","5","2","3",
"1 s","Short-term Business","2001 ","5","3","2",
"1 s","Short-term Business","2002 ","2","1","1",
"1 s","Short-term Business","2003 ","1","1","0",
"1 s","Short-term Business","2004 ","2","0","2",
"1 s","Short-term Business","2005 ","2","2","0",
"1 s","Short-term Business","2006 ","1","1","0",
"1 s","Short-term Business","2007 ","1","0","1",
"1 s","Short-term Business","2008 ","4","1","3",
"1 s","Short-term Business","2009 ","4","2","2",
"1 s","Short-term Business","2010 ","1","1","0",
"1 s","Short-term Visitors","2000 ","220","118","102",
"1 s","Short-term Visitors","2001 ","246","139","107",
"1 s","Short-term Visitors","2002 ","248","128","120",
"1 s","Short-term Visitors","2003 ","236","127","109",
"1 s","Short-term Visitors","2004 ","229","113","116",
"1 s","Short-term Visitors","2005 ","251","142","109",
"1 s","Short-term Visitors","2006 ","255","146","109",
"1 s","Short-term Visitors","2007 ","308","159","149",
"1 s","Short-term Visitors","2008 ","424","211","213",
"1 s","Short-term Visitors","2009 ","291","137","154",
"1 s","Short-term Visitors","2010 ","238","117","121",
"1 s","Short-term Visitors","2011 ","423","230","193",
"1 s","Short-term Visitors","2012 ","577","311","266",
"1 s","Short-term Visitors","2013 ","810","426","384",
"1 s","Short-term Visitors","2014 ","917","478","439",
"1 s","Short-term Visitors","2015 ","989","485","504",
"1 s","Short-term Visitors","2016 ","879","477","402",
"1 s","Short-term Visitors","2017 ","722","379","343",
"1 s","Short-term Visitors","2018 ","627","298","329",
"1 s","Short-term Visitors","2019 ","553","285","268",
"1 s","Short-term Employment","2000 ","0","0","0",
"1 s","Short-term Employment","2001 ","0","0","0",
"1 s","Short-term Employment","2002 ","0","0","0",
"1 s","Short-term Employment","2003 ","0","0","0",
"1 s","Short-term Employment","2004 ","0","0","0",
"1 s","Short-term Employment","2005 ","0","0","0",
"1 s","Short-term Employment","2006 ","0","0","0",
"1 s","Short-term Employment","2007 ","0","0","0",
"1 s","Short-term Employment","2008 ","0","0","0",
"1 s","Short-term Employment","2009 ","0","0","0",
"1 s","Short-term Employment","2010 ","0","0","0",
"1 s","Job Seeking","2000 ","0","0","0",
"1 s","Job Seeking","2001 ","0","0","0",
"1 s","Job Seeking","2002 ","0","0","0",
"1 s","Job Seeking","2003 ","0","0","0",
"1 s","Job Seeking","2004 ","0","0","0",
"1 s","Job Seeking","2005 ","0","0","0",
"1 s","Job Seeking","2006 ","0","0","0",
"1 s","Job Seeking","2007 ","0","0","0",
"1 s","Job Seeking","2008 ","0","0","0",
"1 s","Job Seeking","2009 ","0","0","0",
"1 s","Job Seeking","2010 ","0","0","0",
"1 s","study","2000 ","0","0","0",
"1 s","study","2001 ","0","0","0",
"1 s","study","2002 ","0","0","0",
"1 s","study","2003 ","0","0","0",
"1 s","study","2004 ","0","0","0",
"1 s","study","2005 ","0","0","0",
"1 s","study","2006 ","1","1","0",
"1 s","study","2007 ","1","1","0",
"1 s","study","2008 ","0","0","0",
"1 s","study","2009 ","0","0","0",
"1 s","study","2010 ","0","0","0",
"1 s","General Trainees","2000 ","0","0","0",
"1 s","General Trainees","2001 ","0","0","0",
"1 s","General Trainees","2002 ","0","0","0",
"1 s","General Trainees","2003 ","0","0","0",
"1 s","General Trainees","2004 ","0","0","0",
"1 s","General Trainees","2005 ","1","0","1",
"1 s","General Trainees","2006 ","0","0","0",
"1 s","General Trainees","2007 ","0","0","0",
"1 s","General Trainees","2008 ","0","0","0",
"1 s","General Trainees","2009 ","0","0","0",
"1 s","General Trainees","2010 ","0","0","0",
"1 s","Religious Activities","2000 ","0","0","0",
"1 s","Religious Activities","2001 ","0","0","0",
"1 s","Religious Activities","2002 ","0","0","0",
"1 s","Religious Activities","2003 ","0","0","0",
"1 s","Religious Activities","2004 ","0","0","0",
"1 s","Religious Activities","2005 ","0","0","0",
"1 s","Religious Activities","2006 ","0","0","0",
"1 s","Religious Activities","2007 ","0","0","0",
"1 s","Religious Activities","2008 ","0","0","0",
"1 s","Religious Activities","2009 ","0","0","0",
"1 s","Religious Activities","2010 ","0","0","0",
"1 s","Investors","2000 ","0","0","0",
"1 s","Investors","2001 ","0","0","0",
"1 s","Investors","2002 ","0","0","0",
"1 s","Investors","2003 ","1","0","1",
"1 s","Investors","2004 ","0","0","0",
"1 s","Investors","2005 ","0","0","0",
"1 s","Investors","2006 ","1","1","0",
"1 s","Investors","2007 ","0","0","0",
"1 s","Investors","2008 ","0","0","0",
"1 s","Investors","2009 ","0","0","0",
"1 s","Investors","2010 ","0","0","0",
"1 s","Trade and Business","2000 ","1","0","1",
"1 s","Trade and Business","2001 ","0","0","0",
"1 s","Trade and Business","2002 ","0","0","0",
"1 s","Trade and Business","2003 ","0","0","0",
"1 s","Trade and Business","2004 ","0","0","0",
"1 s","Trade and Business","2005 ","0","0","0",
"1 s","Trade and Business","2006 ","0","0","0",
"1 s","Trade and Business","2007 ","0","0","0",
"1 s","Trade and Business","2008 ","0","0","0",
"1 s","Trade and Business","2009 ","0","0","0",
"1 s","Trade and Business","2010 ","0","0","0",
"1 s","Trade and Business","2011 ","1","1","",
"1 s","Research","2000 ","0","0","0",
"1 s","Research","2001 ","0","0","0",
"1 s","Research","2002 ","0","0","0",
"1 s","Research","2003 ","0","0","0",
"1 s","Research","2004 ","0","0","0",
"1 s","Research","2005 ","0","0","0",
"1 s","Research","2006 ","0","0","0",
"1 s","Research","2007 ","0","0","0",
"1 s","Research","2008 ","1","0","1",
"1 s","Research","2009 ","0","0","0",
"1 s","Research","2010 ","0","0","0",
"1 s","Art and Entertainment","2000 ","0","0","0",
"1 s","Art and Entertainment","2001 ","0","0","0",
"1 s","Art and Entertainment","2002 ","0","0","0",
"1 s","Art and Entertainment","2003 ","0","0","0",
"1 s","Art and Entertainment","2004 ","0","0","0",
"1 s","Art and Entertainment","2005 ","0","0","0",
"1 s","Art and Entertainment","2006 ","0","0","0",
"1 s","Art and Entertainment","2007 ","0","0","0",
"1 s","Art and Entertainment","2008 ","0","0","0",
"1 s","Art and Entertainment","2009 ","0","0","0",
"1 s","Art and Entertainment","2010 ","0","0","0",
"1 s","Unskilled Employment","2000 ","0","0","0",
"1 s","Unskilled Employment","2001 ","0","0","0",
"1 s","Unskilled Employment","2002 ","0","0","0",
"1 s","Unskilled Employment","2003 ","0","0","0",
"1 s","Unskilled Employment","2004 ","0","0","0",
"1 s","Unskilled Employment","2005 ","0","0","0",
"1 s","Unskilled Employment","2006 ","0","0","0",
"1 s","Unskilled Employment","2007 ","0","0","0",
"1 s","Unskilled Employment","2008 ","0","0","0",
"1 s","Unskilled Employment","2009 ","0","0","0",
"1 s","Unskilled Employment","2010 ","0","0","0",
"1 s","Visiting and Joining Family","2000 ","285","133","152",
"1 s","Visiting and Joining Family","2001 ","257","133","124",
"1 s","Visiting and Joining Family","2002 ","316","179","137",
"1 s","Visiting and Joining Family","2003 ","245","118","127",
"1 s","Visiting and Joining Family","2004 ","220","119","101",
"1 s","Visiting and Joining Family","2005 ","181","95","86",
"1 s","Visiting and Joining Family","2006 ","193","115","78",
"1 s","Visiting and Joining Family","2007 ","189","100","89",
"1 s","Visiting and Joining Family","2008 ","184","100","84",
"1 s","Visiting and Joining Family","2009 ","233","121","112",
"1 s","Visiting and Joining Family","2010 ","287","149","138",
"1 s","Visiting and Joining Family","2011 ","205","97","108",
"1 s","Visiting and Joining Family","2012 ","148","74","74",
"1 s","Visiting and Joining Family","2013 ","205","113","92",
"1 s","Visiting and Joining Family","2014 ","353","170","183",
"1 s","Visiting and Joining Family","2015 ","311","160","151",
"1 s","Visiting and Joining Family","2016 ","503","241","262",
"1 s","Visiting and Joining Family","2017 ","597","325","272",
"1 s","Visiting and Joining Family","2018 ","721","366","355",
"1 s","Visiting and Joining Family","2019 ","744","370","374",
"1 s","Overseas Koreans","2000 ","21","15","6",
"1 s","Overseas Koreans","2001 ","14","10","4",
"1 s","Overseas Koreans","2002 ","9","6","3",
"1 s","Overseas Koreans","2003 ","7","4","3",
"1 s","Overseas Koreans","2004 ","2","1","1",
"1 s","Overseas Koreans","2005 ","10","3","7",
"1 s","Overseas Koreans","2006 ","4","0","4",
"1 s","Overseas Koreans","2007 ","4","3","1",
"1 s","Overseas Koreans","2008 ","6","2","4",
"1 s","Overseas Koreans","2009 ","6","4","2",
"1 s","Overseas Koreans","2010 ","36","17","19",
"1 s","Overseas Koreans","2011 ","56","27","29",
"1 s","Overseas Koreans","2012 ","33","14","19",
"1 s","Overseas Koreans","2013 ","22","11","11",
"1 s","Overseas Koreans","2014 ","15","7","8",
"1 s","Overseas Koreans","2015 ","16","9","7",
"1 s","Overseas Koreans","2016 ","18","14","4",
"1 s","Overseas Koreans","2017 ","16","7","9",
"1 s","Overseas Koreans","2018 ","11","3","8",
"1 s","Overseas Koreans","2019 ","22","9","13",
"1 s","Permanent Residence","2000 ","0","0","0",
"1 s","Permanent Residence","2001 ","0","0","0",
"1 s","Permanent Residence","2002 ","0","0","0",
"1 s","Permanent Residence","2003 ","0","0","0",
"1 s","Permanent Residence","2004 ","1","1","0",
"1 s","Permanent Residence","2005 ","0","0","0",
"1 s","Permanent Residence","2006 ","2","2","0",
"1 s","Permanent Residence","2007 ","5","4","1",
"1 s","Permanent Residence","2008 ","0","0","0",
"1 s","Permanent Residence","2009 ","3","1","2",
"1 s","Permanent Residence","2010 ","0","0","0",
"1 s","Permanent Residence","2011 ","4","1","3",
"1 s","Permanent Residence","2012 ","22","9","13",
"1 s","Permanent Residence","2013 ","40","22","18",
"1 s","Permanent Residence","2014 ","60","29","31",
"1 s","Permanent Residence","2015 ","79","40","39",
"1 s","Permanent Residence","2016 ","86","42","44",
"1 s","Permanent Residence","2017 ","68","30","38",
"1 s","Permanent Residence","2018 ","116","64","52",
"1 s","Permanent Residence","2019 ","73","41","32",
"2 s","Total","2000 ","812","452","360",
"2 s","Total","2001 ","786","376","410",
"2 s","Total","2002 ","881","454","427",
"2 s","Total","2003 ","844","418","426",
"2 s","Total","2004 ","836","453","383",
"2 s","Total","2005 ","888","462","426",
"2 s","Total","2006 ","998","499","499",
"2 s","Total","2007 ","1044","577","467",
"2 s","Total","2008 ","1121","597","524",
"2 s","Total","2009 ","1269","658","611",
"2 s","Total","2010 ","1472","747","725",
"2 s","Total","2011 ","1704","838","866",
"2 s","Total","2012 ","1733","909","824",
"2 s","Total","2013 ","2042","1068","974",
"2 s","Total","2014 ","2230","1134","1096",
"2 s","Total","2015 ","2391","1200","1191",
"2 s","Total","2016 ","2339","1188","1151",
"2 s","Total","2017 ","2199","1124","1075",
"2 s","Total","2018 ","2376","1212","1164",
"2 s","Total","2019 ","2506","1239","1267",
"2 s","Sightseeing Pass","2000 ","187","110","77",
"2 s","Sightseeing Pass","2001 ","243","116","127",
"2 s","Sightseeing Pass","2002 ","273","145","128",
"2 s","Sightseeing Pass","2003 ","277","142","135",
"2 s","Sightseeing Pass","2004 ","287","142","145",
"2 s","Sightseeing Pass","2005 ","307","151","156",
"2 s","Sightseeing Pass","2006 ","364","178","186",
"2 s","Sightseeing Pass","2007 ","391","215","176",
"2 s","Sightseeing Pass","2008 ","445","239","206",
"2 s","Sightseeing Pass","2009 ","596","312","284",
"2 s","Sightseeing Pass","2010 ","688","348","340",
"2 s","Sightseeing Pass","2011 ","699","367","332",
"2 s","Sightseeing Pass","2012 ","732","414","318",
"2 s","Sightseeing Pass","2013 ","694","365","329",
"2 s","Sightseeing Pass","2014 ","620","314","306",
"2 s","Sightseeing Pass","2015 ","629","317","312",
"2 s","Sightseeing Pass","2016 ","498","255","243",
"2 s","Sightseeing Pass","2017 ","454","247","207",
"2 s","Sightseeing Pass","2018 ","538","279","259",
"2 s","Sightseeing Pass","2019 ","599","299","300",
"2 s","Short-term Business","2000 ","3","1","2",
"2 s","Short-term Business","2001 ","2","1","1",
"2 s","Short-term Business","2002 ","2","1","1",
"2 s","Short-term Business","2003 ","2","1","1",
"2 s","Short-term Business","2004 ","0","0","0",
"2 s","Short-term Business","2005 ","2","0","2",
"2 s","Short-term Business","2006 ","2","1","1",
"2 s","Short-term Business","2007 ","1","0","1",
"2 s","Short-term Business","2008 ","0","0","0",
"2 s","Short-term Business","2009 ","3","1","2",
"2 s","Short-term Business","2010 ","0","0","0",
"2 s","Short-term Business","2011 ","1","1","",
"2 s","Short-term Visitors","2000 ","224","123","101",
"2 s","Short-term Visitors","2001 ","211","105","106",
"2 s","Short-term Visitors","2002 ","195","105","90",
"2 s","Short-term Visitors","2003 ","211","98","113",
"2 s","Short-term Visitors","2004 ","182","101","81",
"2 s","Short-term Visitors","2005 ","182","100","82",
"2 s","Short-term Visitors","2006 ","239","127","112",
"2 s","Short-term Visitors","2007 ","255","137","118",
"2 s","Short-term Visitors","2008 ","320","164","156",
"2 s","Short-term Visitors","2009 ","221","120","101",
"2 s","Short-term Visitors","2010 ","249","137","112",
"2 s","Short-term Visitors","2011 ","427","205","222",
"2 s","Short-term Visitors","2012 ","515","270","245",
"2 s","Short-term Visitors","2013 ","716","372","344",
"2 s","Short-term Visitors","2014 ","772","387","385",
"2 s","Short-term Visitors","2015 ","870","415","455",
"2 s","Short-term Visitors","2016 ","848","431","417",
"2 s","Short-term Visitors","2017 ","648","324","324",
"2 s","Short-term Visitors","2018 ","556","274","282",
"2 s","Short-term Visitors","2019 ","550","295","255",
"2 s","Short-term Employment","2000 ","0","0","0",
"2 s","Short-term Employment","2001 ","0","0","0",
"2 s","Short-term Employment","2002 ","0","0","0",
"2 s","Short-term Employment","2003 ","1","0","1",
"2 s","Short-term Employment","2004 ","0","0","0",
"2 s","Short-term Employment","2005 ","0","0","0",
"2 s","Short-term Employment","2006 ","0","0","0",
"2 s","Short-term Employment","2007 ","0","0","0",
"2 s","Short-term Employment","2008 ","0","0","0",
"2 s","Short-term Employment","2009 ","0","0","0",
"2 s","Short-term Employment","2010 ","0","0","0",
"2 s","Job Seeking","2000 ","0","0","0",
"2 s","Job Seeking","2001 ","0","0","0",
"2 s","Job Seeking","2002 ","0","0","0",
"2 s","Job Seeking","2003 ","0","0","0",
"2 s","Job Seeking","2004 ","0","0","0",
"2 s","Job Seeking","2005 ","0","0","0",
"2 s","Job Seeking","2006 ","0","0","0",
"2 s","Job Seeking","2007 ","0","0","0",
"2 s","Job Seeking","2008 ","0","0","0",
"2 s","Job Seeking","2009 ","0","0","0",
"2 s","Job Seeking","2010 ","0","0","0",
"2 s","study","2000 ","0","0","0",
"2 s","study","2001 ","0","0","0",
"2 s","study","2002 ","0","0","0",
"2 s","study","2003 ","0","0","0",
"2 s","study","2004 ","0","0","0",
"2 s","study","2005 ","0","0","0",
"2 s","study","2006 ","1","0","1",
"2 s","study","2007 ","0","0","0",
"2 s","study","2008 ","0","0","0",
"2 s","study","2009 ","0","0","0",
"2 s","study","2010 ","0","0","0",
"2 s","General Trainees","2000 ","1","1","0",
"2 s","General Trainees","2001 ","0","0","0",
"2 s","General Trainees","2002 ","0","0","0",
"2 s","General Trainees","2003 ","0","0","0",
"2 s","General Trainees","2004 ","0","0","0",
"2 s","General Trainees","2005 ","1","1","0",
"2 s","General Trainees","2006 ","0","0","0",
"2 s","General Trainees","2007 ","0","0","0",
"2 s","General Trainees","2008 ","0","0","0",
"2 s","General Trainees","2009 ","0","0","0",
"2 s","General Trainees","2010 ","0","0","0",
"2 s","Religious Activities","2000 ","0","0","0",
"2 s","Religious Activities","2001 ","0","0","0",
"2 s","Religious Activities","2002 ","0","0","0",
"2 s","Religious Activities","2003 ","0","0","0",
"2 s","Religious Activities","2004 ","0","0","0",
"2 s","Religious Activities","2005 ","1","0","1",
"2 s","Religious Activities","2006 ","0","0","0",
"2 s","Religious Activities","2007 ","0","0","0",
"2 s","Religious Activities","2008 ","0","0","0",
"2 s","Religious Activities","2009 ","0","0","0",
"2 s","Religious Activities","2010 ","0","0","0",
"2 s","Investors","2000 ","0","0","0",
"2 s","Investors","2001 ","0","0","0",
"2 s","Investors","2002 ","0","0","0",
"2 s","Investors","2003 ","0","0","0",
"2 s","Investors","2004 ","0","0","0",
"2 s","Investors","2005 ","0","0","0",
"2 s","Investors","2006 ","0","0","0",
"2 s","Investors","2007 ","0","0","0",
"2 s","Investors","2008 ","0","0","0",
"2 s","Investors","2009 ","0","0","0",
"2 s","Investors","2010 ","0","0","0",
"2 s","Trade and Business","2000 ","0","0","0",
"2 s","Trade and Business","2001 ","0","0","0",
"2 s","Trade and Business","2002 ","0","0","0",
"2 s","Trade and Business","2003 ","0","0","0",
"2 s","Trade and Business","2004 ","0","0","0",
"2 s","Trade and Business","2005 ","0","0","0",
"2 s","Trade and Business","2006 ","0","0","0",
"2 s","Trade and Business","2007 ","0","0","0",
"2 s","Trade and Business","2008 ","0","0","0",
"2 s","Trade and Business","2009 ","0","0","0",
"2 s","Trade and Business","2010 ","0","0","0",
"2 s","Research","2000 ","0","0","0",
"2 s","Research","2001 ","0","0","0",
"2 s","Research","2002 ","0","0","0",
"2 s","Research","2003 ","0","0","0",
"2 s","Research","2004 ","0","0","0",
"2 s","Research","2005 ","0","0","0",
"2 s","Research","2006 ","1","1","0",
"2 s","Research","2007 ","0","0","0",
"2 s","Research","2008 ","0","0","0",
"2 s","Research","2009 ","0","0","0",
"2 s","Research","2010 ","0","0","0",
"2 s","Research","2013 ","1","1","0",
"2 s","Art and Entertainment","2000 ","0","0","0",
"2 s","Art and Entertainment","2001 ","0","0","0",
"2 s","Art and Entertainment","2002 ","0","0","0",
"2 s","Art and Entertainment","2003 ","0","0","0",
"2 s","Art and Entertainment","2004 ","0","0","0",
"2 s","Art and Entertainment","2005 ","0","0","0",
"2 s","Art and Entertainment","2006 ","0","0","0",
"2 s","Art and Entertainment","2007 ","0","0","0",
"2 s","Art and Entertainment","2008 ","0","0","0",
"2 s","Art and Entertainment","2009 ","0","0","0",
"2 s","Art and Entertainment","2010 ","0","0","0",
"2 s","Unskilled Employment","2000 ","0","0","0",
"2 s","Unskilled Employment","2001 ","0","0","0",
"2 s","Unskilled Employment","2002 ","0","0","0",
"2 s","Unskilled Employment","2003 ","0","0","0",
"2 s","Unskilled Employment","2004 ","0","0","0",
"2 s","Unskilled Employment","2005 ","0","0","0",
"2 s","Unskilled Employment","2006 ","1","1","0",
"2 s","Unskilled Employment","2007 ","0","0","0",
"2 s","Unskilled Employment","2008 ","0","0","0",
"2 s","Unskilled Employment","2009 ","1","1","0",
"2 s","Unskilled Employment","2010 ","1","1","0",
"2 s","Visiting and Joining Family","2000 ","217","126","91",
"2 s","Visiting and Joining Family","2001 ","158","74","84",
"2 s","Visiting and Joining Family","2002 ","214","104","110",
"2 s","Visiting and Joining Family","2003 ","165","84","81",
"2 s","Visiting and Joining Family","2004 ","170","96","74",
"2 s","Visiting and Joining Family","2005 ","139","72","67",
"2 s","Visiting and Joining Family","2006 ","164","84","80",
"2 s","Visiting and Joining Family","2007 ","156","86","70",
"2 s","Visiting and Joining Family","2008 ","147","77","70",
"2 s","Visiting and Joining Family","2009 ","187","101","86",
"2 s","Visiting and Joining Family","2010 ","243","119","124",
"2 s","Visiting and Joining Family","2011 ","188","90","98",
"2 s","Visiting and Joining Family","2012 ","103","48","55",
"2 s","Visiting and Joining Family","2013 ","161","81","80",
"2 s","Visiting and Joining Family","2014 ","293","137","156",
"2 s","Visiting and Joining Family","2015 ","330","177","153",
"2 s","Visiting and Joining Family","2016 ","439","209","230",
"2 s","Visiting and Joining Family","2017 ","526","265","261",
"2 s","Visiting and Joining Family","2018 ","601","300","301",
"2 s","Visiting and Joining Family","2019 ","690","337","353",
"2 s","Overseas Koreans","2000 ","18","8","10",
"2 s","Overseas Koreans","2001 ","9","4","5",
"2 s","Overseas Koreans","2002 ","13","6","7",
"2 s","Overseas Koreans","2003 ","9","5","4",
"2 s","Overseas Koreans","2004 ","5","1","4",
"2 s","Overseas Koreans","2005 ","7","4","3",
"2 s","Overseas Koreans","2006 ","6","3","3",
"2 s","Overseas Koreans","2007 ","6","2","4",
"2 s","Overseas Koreans","2008 ","6","2","4",
"2 s","Overseas Koreans","2009 ","11","6","5",
"2 s","Overseas Koreans","2010 ","31","15","16",
"2 s","Overseas Koreans","2011 ","54","27","27",
"2 s","Overseas Koreans","2012 ","37","15","22",
"2 s","Overseas Koreans","2013 ","17","7","10",
"2 s","Overseas Koreans","2014 ","12","4","8",
"2 s","Overseas Koreans","2015 ","19","8","11",
"2 s","Overseas Koreans","2016 ","16","9","7",
"2 s","Overseas Koreans","2017 ","14","10","4",
"2 s","Overseas Koreans","2018 ","21","8","13",
"2 s","Overseas Koreans","2019 ","15","6","9",
"2 s","Permanent Residence","2000 ","0","0","0",
"2 s","Permanent Residence","2001 ","0","0","0",
"2 s","Permanent Residence","2002 ","0","0","0",
"2 s","Permanent Residence","2003 ","0","0","0",
"2 s","Permanent Residence","2004 ","3","1","2",
"2 s","Permanent Residence","2005 ","5","4","1",
"2 s","Permanent Residence","2006 ","3","1","2",
"2 s","Permanent Residence","2007 ","9","1","8",
"2 s","Permanent Residence","2008 ","2","2","0",
"2 s","Permanent Residence","2009 ","2","1","1",
"2 s","Permanent Residence","2010 ","2","2","0",
"2 s","Permanent Residence","2011 ","3","2","1",
"2 s","Permanent Residence","2012 ","3","2","1",
"2 s","Permanent Residence","2013 ","16","8","8",
"2 s","Permanent Residence","2014 ","52","21","31",
"2 s","Permanent Residence","2015 ","55","29","26",
"2 s","Permanent Residence","2016 ","66","35","31",
"2 s","Permanent Residence","2017 ","64","34","30",
"2 s","Permanent Residence","2018 ","72","36","36",
"2 s","Permanent Residence","2019 ","71","29","42",
"2 s","Marriage Immigration","2014 ","1","1","0",
"3 s","Total","2000 ","694","342","352",
"3 s","Total","2001 ","727","365","362",
"3 s","Total","2002 ","699","357","342",
"3 s","Total","2003 ","733","375","358",
"3 s","Total","2004 ","756","380","376",
"3 s","Total","2005 ","756","409","347",
"3 s","Total","2006 ","734","367","367",
"3 s","Total","2007 ","872","448","424",
"3 s","Total","2008 ","954","490","464",
"3 s","Total","2009 ","985","528","457",
"3 s","Total","2010 ","1168","598","570",
"3 s","Total","2011 ","1492","778","714",
"3 s","Total","2012 ","1539","779","760",
"3 s","Total","2013 ","1685","846","839",
"3 s","Total","2014 ","1916","1008","908",
"3 s","Total","2015 ","1891","978","913",
"3 s","Total","2016 ","1978","999","979",
"3 s","Total","2017 ","1856","905","951",
"3 s","Total","2018 ","1959","962","997",
"3 s","Total","2019 ","2009","1069","940",
"3 s","Sightseeing Pass","2000 ","152","76","76",
"3 s","Sightseeing Pass","2001 ","196","109","87",
"3 s","Sightseeing Pass","2002 ","222","109","113",
"3 s","Sightseeing Pass","2003 ","221","107","114",
"3 s","Sightseeing Pass","2004 ","248","116","132",
"3 s","Sightseeing Pass","2005 ","244","144","100",
"3 s","Sightseeing Pass","2006 ","233","117","116",
"3 s","Sightseeing Pass","2007 ","324","161","163",
"3 s","Sightseeing Pass","2008 ","337","181","156",
"3 s","Sightseeing Pass","2009 ","452","254","198",
"3 s","Sightseeing Pass","2010 ","483","230","253",
"3 s","Sightseeing Pass","2011 ","598","314","284",
"3 s","Sightseeing Pass","2012 ","626","330","296",
"3 s","Sightseeing Pass","2013 ","551","290","261",
"3 s","Sightseeing Pass","2014 ","557","296","261",
"3 s","Sightseeing Pass","2015 ","497","267","230",
"3 s","Sightseeing Pass","2016 ","391","191","200",
"3 s","Sightseeing Pass","2017 ","366","178","188",
"3 s","Sightseeing Pass","2018 ","493","255","238",
"3 s","Sightseeing Pass","2019 ","474","256","218",
"3 s","Short-term Business","2000 ","2","1","1",
"3 s","Short-term Business","2001 ","4","2","2",
"3 s","Short-term Business","2002 ","1","0","1",
"3 s","Short-term Business","2003 ","5","4","1",
"3 s","Short-term Business","2004 ","2","1","1",
"3 s","Short-term Business","2005 ","1","0","1",
"3 s","Short-term Business","2006 ","3","0","3",
"3 s","Short-term Business","2007 ","2","0","2",
"3 s","Short-term Business","2008 ","0","0","0",
"3 s","Short-term Business","2009 ","1","0","1",
"3 s","Short-term Business","2010 ","1","1","0",
"3 s","Short-term Visitors","2000 ","179","88","91",
"3 s","Short-term Visitors","2001 ","164","74","90",
"3 s","Short-term Visitors","2002 ","175","91","84",
"3 s","Short-term Visitors","2003 ","201","97","104",
"3 s","Short-term Visitors","2004 ","156","74","82",
"3 s","Short-term Visitors","2005 ","178","105","73",
"3 s","Short-term Visitors","2006 ","178","86","92",
"3 s","Short-term Visitors","2007 ","237","133","104",
"3 s","Short-term Visitors","2008 ","288","135","153",
"3 s","Short-term Visitors","2009 ","211","102","109",
"3 s","Short-term Visitors","2010 ","257","133","124",
"3 s","Short-term Visitors","2011 ","439","236","203",
"3 s","Short-term Visitors","2012 ","482","235","247",
"3 s","Short-term Visitors","2013 ","617","311","306",
"3 s","Short-term Visitors","2014 ","731","382","349",
"3 s","Short-term Visitors","2015 ","711","362","349",
"3 s","Short-term Visitors","2016 ","780","419","361",
"3 s","Short-term Visitors","2017 ","563","266","297",
"3 s","Short-term Visitors","2018 ","489","228","261",
"3 s","Short-term Visitors","2019 ","459","219","240",
"3 s","Short-term Employment","2000 ","0","0","0",
"3 s","Short-term Employment","2001 ","0","0","0",
"3 s","Short-term Employment","2002 ","0","0","0",
"3 s","Short-term Employment","2003 ","1","0","1",
"3 s","Short-term Employment","2004 ","0","0","0",
"3 s","Short-term Employment","2005 ","0","0","0",
"3 s","Short-term Employment","2006 ","0","0","0",
"3 s","Short-term Employment","2007 ","0","0","0",
"3 s","Short-term Employment","2008 ","0","0","0",
"3 s","Short-term Employment","2009 ","0","0","0",
"3 s","Short-term Employment","2010 ","0","0","0",
"3 s","Job Seeking","2000 ","0","0","0",
"3 s","Job Seeking","2001 ","0","0","0",
"3 s","Job Seeking","2002 ","0","0","0",
"3 s","Job Seeking","2003 ","0","0","0",
"3 s","Job Seeking","2004 ","0","0","0",
"3 s","Job Seeking","2005 ","0","0","0",
"3 s","Job Seeking","2006 ","0","0","0",
"3 s","Job Seeking","2007 ","0","0","0",
"3 s","Job Seeking","2008 ","0","0","0",
"3 s","Job Seeking","2009 ","0","0","0",
"3 s","Job Seeking","2010 ","0","0","0",
"3 s","study","2000 ","0","0","0",
"3 s","study","2001 ","0","0","0",
"3 s","study","2002 ","0","0","0",
"3 s","study","2003 ","0","0","0",
"3 s","study","2004 ","0","0","0",
"3 s","study","2005 ","0","0","0",
"3 s","study","2006 ","0","0","0",
"3 s","study","2007 ","0","0","0",
"3 s","study","2008 ","0","0","0",
"3 s","study","2009 ","1","1","0",
"3 s","study","2010 ","0","0","0",
"3 s","General Trainees","2000 ","0","0","0",
"3 s","General Trainees","2001 ","0","0","0",
"3 s","General Trainees","2002 ","0","0","0",
"3 s","General Trainees","2003 ","0","0","0",
"3 s","General Trainees","2004 ","0","0","0",
"3 s","General Trainees","2005 ","0","0","0",
"3 s","General Trainees","2006 ","0","0","0",
"3 s","General Trainees","2007 ","0","0","0",
"3 s","General Trainees","2008 ","0","0","0",
"3 s","General Trainees","2009 ","0","0","0",
"3 s","General Trainees","2010 ","0","0","0",
"3 s","General Trainees","2017 ","1","0","1",
"3 s","Religious Activities","2000 ","1","1","0",
"3 s","Religious Activities","2001 ","0","0","0",
"3 s","Religious Activities","2002 ","0","0","0",
"3 s","Religious Activities","2003 ","0","0","0",
"3 s","Religious Activities","2004 ","0","0","0",
"3 s","Religious Activities","2005 ","0","0","0",
"3 s","Religious Activities","2006 ","0","0","0",
"3 s","Religious Activities","2007 ","0","0","0",
"3 s","Religious Activities","2008 ","0","0","0",
"3 s","Religious Activities","2009 ","0","0","0",
"3 s","Religious Activities","2010 ","0","0","0",
"3 s","Investors","2000 ","0","0","0",
"3 s","Investors","2001 ","0","0","0",
"3 s","Investors","2002 ","0","0","0",
"3 s","Investors","2003 ","0","0","0",
"3 s","Investors","2004 ","0","0","0",
"3 s","Investors","2005 ","1","0","1",
"3 s","Investors","2006 ","0","0","0",
"3 s","Investors","2007 ","0","0","0",
"3 s","Investors","2008 ","0","0","0",
"3 s","Investors","2009 ","0","0","0",
"3 s","Investors","2010 ","0","0","0",
"3 s","Trade and Business","2000 ","0","0","0",
"3 s","Trade and Business","2001 ","0","0","0",
"3 s","Trade and Business","2002 ","0","0","0",
"3 s","Trade and Business","2003 ","0","0","0",
"3 s","Trade and Business","2004 ","0","0","0",
"3 s","Trade and Business","2005 ","0","0","0",
"3 s","Trade and Business","2006 ","0","0","0",
"3 s","Trade and Business","2007 ","1","1","0",
"3 s","Trade and Business","2008 ","0","0","0",
"3 s","Trade and Business","2009 ","0","0","0",
"3 s","Trade and Business","2010 ","0","0","0",
"3 s","Research","2000 ","0","0","0",
"3 s","Research","2001 ","0","0","0",
"3 s","Research","2002 ","0","0","0",
"3 s","Research","2003 ","0","0","0",
"3 s","Research","2004 ","0","0","0",
"3 s","Research","2005 ","0","0","0",
"3 s","Research","2006 ","2","2","0",
"3 s","Research","2007 ","0","0","0",
"3 s","Research","2008 ","0","0","0",
"3 s","Research","2009 ","0","0","0",
"3 s","Research","2010 ","0","0","0",
"3 s","Art and Entertainment","2000 ","0","0","0",
"3 s","Art and Entertainment","2001 ","0","0","0",
"3 s","Art and Entertainment","2002 ","0","0","0",
"3 s","Art and Entertainment","2003 ","0","0","0",
"3 s","Art and Entertainment","2004 ","0","0","0",
"3 s","Art and Entertainment","2005 ","0","0","0",
"3 s","Art and Entertainment","2006 ","1","0","1",
"3 s","Art and Entertainment","2007 ","1","1","0",
"3 s","Art and Entertainment","2008 ","0","0","0",
"3 s","Art and Entertainment","2009 ","0","0","0",
"3 s","Art and Entertainment","2010 ","0","0","0",
"3 s","Unskilled Employment","2000 ","0","0","0",
"3 s","Unskilled Employment","2001 ","0","0","0",
"3 s","Unskilled Employment","2002 ","0","0","0",
"3 s","Unskilled Employment","2003 ","0","0","0",
"3 s","Unskilled Employment","2004 ","0","0","0",
"3 s","Unskilled Employment","2005 ","0","0","0",
"3 s","Unskilled Employment","2006 ","0","0","0",
"3 s","Unskilled Employment","2007 ","0","0","0",
"3 s","Unskilled Employment","2008 ","0","0","0",
"3 s","Unskilled Employment","2009 ","0","0","0",
"3 s","Unskilled Employment","2010 ","0","0","0",
"3 s","Visiting and Joining Family","2000 ","190","95","95",
"3 s","Visiting and Joining Family","2001 ","180","87","93",
"3 s","Visiting and Joining Family","2002 ","137","75","62",
"3 s","Visiting and Joining Family","2003 ","129","75","54",
"3 s","Visiting and Joining Family","2004 ","161","78","83",
"3 s","Visiting and Joining Family","2005 ","137","75","62",
"3 s","Visiting and Joining Family","2006 ","123","67","56",
"3 s","Visiting and Joining Family","2007 ","122","61","61",
"3 s","Visiting and Joining Family","2008 ","129","64","65",
"3 s","Visiting and Joining Family","2009 ","116","58","58",
"3 s","Visiting and Joining Family","2010 ","182","111","71",
"3 s","Visiting and Joining Family","2011 ","157","78","79",
"3 s","Visiting and Joining Family","2012 ","87","43","44",
"3 s","Visiting and Joining Family","2013 ","117","55","62",
"3 s","Visiting and Joining Family","2014 ","195","100","95",
"3 s","Visiting and Joining Family","2015 ","236","115","121",
"3 s","Visiting and Joining Family","2016 ","353","177","176",
"3 s","Visiting and Joining Family","2017 ","426","218","208",
"3 s","Visiting and Joining Family","2018 ","416","197","219",
"3 s","Visiting and Joining Family","2019 ","464","253","211",
"3 s","Overseas Koreans","2000 ","15","5","10",
"3 s","Overseas Koreans","2001 ","14","4","10",
"3 s","Overseas Koreans","2002 ","10","4","6",
"3 s","Overseas Koreans","2003 ","11","6","5",
"3 s","Overseas Koreans","2004 ","3","2","1",
"3 s","Overseas Koreans","2005 ","5","0","5",
"3 s","Overseas Koreans","2006 ","6","3","3",
"3 s","Overseas Koreans","2007 ","5","2","3",
"3 s","Overseas Koreans","2008 ","3","2","1",
"3 s","Overseas Koreans","2009 ","7","4","3",
"3 s","Overseas Koreans","2010 ","24","9","15",
"3 s","Overseas Koreans","2011 ","45","26","19",
"3 s","Overseas Koreans","2012 ","39","22","17",
"3 s","Overseas Koreans","2013 ","38","15","23",
"3 s","Overseas Koreans","2014 ","22","12","10",
"3 s","Overseas Koreans","2015 ","14","7","7",
"3 s","Overseas Koreans","2016 ","22","8","14",
"3 s","Overseas Koreans","2017 ","21","13","8",
"3 s","Overseas Koreans","2018 ","19","13","6",
"3 s","Overseas Koreans","2019 ","23","10","13",
"3 s","Permanent Residence","2000 ","0","0","0",
"3 s","Permanent Residence","2001 ","0","0","0",
"3 s","Permanent Residence","2002 ","0","0","0",
"3 s","Permanent Residence","2003 ","2","2","0",
"3 s","Permanent Residence","2004 ","0","0","0",
"3 s","Permanent Residence","2005 ","2","0","2",
"3 s","Permanent Residence","2006 ","2","1","1",
"3 s","Permanent Residence","2007 ","2","0","2",
"3 s","Permanent Residence","2008 ","3","1","2",
"3 s","Permanent Residence","2009 ","3","1","2",
"3 s","Permanent Residence","2010 ","4","0","4",
"3 s","Permanent Residence","2011 ","4","1","3",
"3 s","Permanent Residence","2012 ","2","1","1",
"3 s","Permanent Residence","2013 ","8","3","5",
"3 s","Permanent Residence","2014 ","24","14","10",
"3 s","Permanent Residence","2015 ","40","17","23",
"3 s","Permanent Residence","2016 ","46","16","30",
"3 s","Permanent Residence","2017 ","51","22","29",
"3 s","Permanent Residence","2018 ","56","37","19",
"3 s","Permanent Residence","2019 ","62","40","22",
"4 s","Total","2000 ","624","311","313",
"4 s","Total","2001 ","607","315","292",
"4 s","Total","2002 ","616","307","309",
"4 s","Total","2003 ","580","298","282",
"4 s","Total","2004 ","616","321","295",
"4 s","Total","2005 ","668","371","297",
"4 s","Total","2006 ","665","340","325",
"4 s","Total","2007 ","624","324","300",
"4 s","Total","2008 ","779","443","336",
"4 s","Total","2009 ","828","454","374",
"4 s","Total","2010 ","915","466","449",
"4 s","Total","2011 ","1166","617","549",
"4 s","Total","2012 ","1276","677","599",
"4 s","Total","2013 ","1405","717","688",
"4 s","Total","2014 ","1482","776","706",
"4 s","Total","2015 ","1552","766","786",
"4 s","Total","2016 ","1602","798","804",
"4 s","Total","2017 ","1571","777","794",
"4 s","Total","2018 ","1586","790","796",
"4 s","Total","2019 ","1775","894","881",
"4 s","Sightseeing Pass","2000 ","136","58","78",
"4 s","Sightseeing Pass","2001 ","156","84","72",
"4 s","Sightseeing Pass","2002 ","186","98","88",
"4 s","Sightseeing Pass","2003 ","185","96","89",
"4 s","Sightseeing Pass","2004 ","226","120","106",
"4 s","Sightseeing Pass","2005 ","223","126","97",
"4 s","Sightseeing Pass","2006 ","228","126","102",
"4 s","Sightseeing Pass","2007 ","193","110","83",
"4 s","Sightseeing Pass","2008 ","282","166","116",
"4 s","Sightseeing Pass","2009 ","349","188","161",
"4 s","Sightseeing Pass","2010 ","376","200","176",
"4 s","Sightseeing Pass","2011 ","457","249","208",
"4 s","Sightseeing Pass","2012 ","509","263","246",
"4 s","Sightseeing Pass","2013 ","430","210","220",
"4 s","Sightseeing Pass","2014 ","434","229","205",
"4 s","Sightseeing Pass","2015 ","430","198","232",
"4 s","Sightseeing Pass","2016 ","321","163","158",
"4 s","Sightseeing Pass","2017 ","332","159","173",
"4 s","Sightseeing Pass","2018 ","357","183","174",
"4 s","Sightseeing Pass","2019 ","392","218","174",
"4 s","Short-term Business","2000 ","5","3","2",
"4 s","Short-term Business","2001 ","1","0","1",
"4 s","Short-term Business","2002 ","0","0","0",
"4 s","Short-term Business","2003 ","2","0","2",
"4 s","Short-term Business","2004 ","2","1","1",
"4 s","Short-term Business","2005 ","2","2","0",
"4 s","Short-term Business","2006 ","0","0","0",
"4 s","Short-term Business","2007 ","2","1","1",
"4 s","Short-term Business","2008 ","2","2","0",
"4 s","Short-term Business","2009 ","0","0","0",
"4 s","Short-term Business","2010 ","0","0","0",
"4 s","Short-term Visitors","2000 ","191","97","94",
"4 s","Short-term Visitors","2001 ","158","77","81",
"4 s","Short-term Visitors","2002 ","150","70","80",
"4 s","Short-term Visitors","2003 ","127","70","57",
"4 s","Short-term Visitors","2004 ","139","71","68",
"4 s","Short-term Visitors","2005 ","141","79","62",
"4 s","Short-term Visitors","2006 ","138","65","73",
"4 s","Short-term Visitors","2007 ","164","90","74",
"4 s","Short-term Visitors","2008 ","221","119","102",
"4 s","Short-term Visitors","2009 ","171","94","77",
"4 s","Short-term Visitors","2010 ","182","77","105",
"4 s","Short-term Visitors","2011 ","353","183","170",
"4 s","Short-term Visitors","2012 ","446","240","206",
"4 s","Short-term Visitors","2013 ","550","270","280",
"4 s","Short-term Visitors","2014 ","571","301","270",
"4 s","Short-term Visitors","2015 ","639","322","317",
"4 s","Short-term Visitors","2016 ","659","309","350",
"4 s","Short-term Visitors","2017 ","513","257","256",
"4 s","Short-term Visitors","2018 ","416","193","223",
"4 s","Short-term Visitors","2019 ","422","200","222",
"4 s","Short-term Employment","2000 ","0","0","0",
"4 s","Short-term Employment","2001 ","0","0","0",
"4 s","Short-term Employment","2002 ","0","0","0",
"4 s","Short-term Employment","2003 ","0","0","0",
"4 s","Short-term Employment","2004 ","0","0","0",
"4 s","Short-term Employment","2005 ","0","0","0",
"4 s","Short-term Employment","2006 ","0","0","0",
"4 s","Short-term Employment","2007 ","0","0","0",
"4 s","Short-term Employment","2008 ","0","0","0",
"4 s","Short-term Employment","2009 ","0","0","0",
"4 s","Short-term Employment","2010 ","0","0","0",
"4 s","Job Seeking","2000 ","0","0","0",
"4 s","Job Seeking","2001 ","0","0","0",
"4 s","Job Seeking","2002 ","0","0","0",
"4 s","Job Seeking","2003 ","0","0","0",
"4 s","Job Seeking","2004 ","0","0","0",
"4 s","Job Seeking","2005 ","0","0","0",
"4 s","Job Seeking","2006 ","0","0","0",
"4 s","Job Seeking","2007 ","0","0","0",
"4 s","Job Seeking","2008 ","0","0","0",
"4 s","Job Seeking","2009 ","0","0","0",
"4 s","Job Seeking","2010 ","0","0","0",
"4 s","study","2000 ","0","0","0",
"4 s","study","2001 ","0","0","0",
"4 s","study","2002 ","0","0","0",
"4 s","study","2003 ","2","0","2",
"4 s","study","2004 ","0","0","0",
"4 s","study","2005 ","0","0","0",
"4 s","study","2006 ","0","0","0",
"4 s","study","2007 ","0","0","0",
"4 s","study","2008 ","0","0","0",
"4 s","study","2009 ","0","0","0",
"4 s","study","2010 ","0","0","0",
"4 s","General Trainees","2000 ","0","0","0",
"4 s","General Trainees","2001 ","0","0","0",
"4 s","General Trainees","2002 ","0","0","0",
"4 s","General Trainees","2003 ","0","0","0",
"4 s","General Trainees","2004 ","0","0","0",
"4 s","General Trainees","2005 ","0","0","0",
"4 s","General Trainees","2006 ","0","0","0",
"4 s","General Trainees","2007 ","0","0","0",
"4 s","General Trainees","2008 ","0","0","0",
"4 s","General Trainees","2009 ","0","0","0",
"4 s","General Trainees","2010 ","0","0","0",
"4 s","Religious Activities","2000 ","1","0","1",
"4 s","Religious Activities","2001 ","0","0","0",
"4 s","Religious Activities","2002 ","0","0","0",
"4 s","Religious Activities","2003 ","0","0","0",
"4 s","Religious Activities","2004 ","0","0","0",
"4 s","Religious Activities","2005 ","0","0","0",
"4 s","Religious Activities","2006 ","0","0","0",
"4 s","Religious Activities","2007 ","0","0","0",
"4 s","Religious Activities","2008 ","0","0","0",
"4 s","Religious Activities","2009 ","0","0","0",
"4 s","Religious Activities","2010 ","0","0","0",
"4 s","Investors","2000 ","0","0","0",
"4 s","Investors","2001 ","0","0","0",
"4 s","Investors","2002 ","0","0","0",
"4 s","Investors","2003 ","0","0","0",
"4 s","Investors","2004 ","0","0","0",
"4 s","Investors","2005 ","0","0","0",
"4 s","Investors","2006 ","0","0","0",
"4 s","Investors","2007 ","0","0","0",
"4 s","Investors","2008 ","1","1","0",
"4 s","Investors","2009 ","0","0","0",
"4 s","Investors","2010 ","0","0","0",
"4 s","Trade and Business","2000 ","0","0","0",
"4 s","Trade and Business","2001 ","0","0","0",
"4 s","Trade and Business","2002 ","0","0","0",
"4 s","Trade and Business","2003 ","0","0","0",
"4 s","Trade and Business","2004 ","0","0","0",
"4 s","Trade and Business","2005 ","0","0","0",
"4 s","Trade and Business","2006 ","0","0","0",
"4 s","Trade and Business","2007 ","1","1","0",
"4 s","Trade and Business","2008 ","0","0","0",
"4 s","Trade and Business","2009 ","0","0","0",
"4 s","Trade and Business","2010 ","0","0","0",
"4 s","Research","2000 ","0","0","0",
"4 s","Research","2001 ","0","0","0",
"4 s","Research","2002 ","0","0","0",
"4 s","Research","2003 ","0","0","0",
"4 s","Research","2004 ","0","0","0",
"4 s","Research","2005 ","0","0","0",
"4 s","Research","2006 ","0","0","0",
"4 s","Research","2007 ","0","0","0",
"4 s","Research","2008 ","0","0","0",
"4 s","Research","2009 ","0","0","0",
"4 s","Research","2010 ","0","0","0",
"4 s","Art and Entertainment","2000 ","0","0","0",
"4 s","Art and Entertainment","2001 ","0","0","0",
"4 s","Art and Entertainment","2002 ","1","1","0",
"4 s","Art and Entertainment","2003 ","0","0","0",
"4 s","Art and Entertainment","2004 ","0","0","0",
"4 s","Art and Entertainment","2005 ","0","0","0",
"4 s","Art and Entertainment","2006 ","1","0","1",
"4 s","Art and Entertainment","2007 ","0","0","0",
"4 s","Art and Entertainment","2008 ","0","0","0",
"4 s","Art and Entertainment","2009 ","0","0","0",
"4 s","Art and Entertainment","2010 ","0","0","0",
"4 s","Art and Entertainment","2015 ","1","0","1",
"4 s","Unskilled Employment","2000 ","0","0","0",
"4 s","Unskilled Employment","2001 ","0","0","0",
"4 s","Unskilled Employment","2002 ","0","0","0",
"4 s","Unskilled Employment","2003 ","0","0","0",
"4 s","Unskilled Employment","2004 ","1","0","1",
"4 s","Unskilled Employment","2005 ","0","0","0",
"4 s","Unskilled Employment","2006 ","0","0","0",
"4 s","Unskilled Employment","2007 ","0","0","0",
"4 s","Unskilled Employment","2008 ","0","0","0",
"4 s","Unskilled Employment","2009 ","0","0","0",
"4 s","Unskilled Employment","2010 ","0","0","0",
"4 s","Visiting and Joining Family","2000 ","115","55","60",
"4 s","Visiting and Joining Family","2001 ","135","73","62",
"4 s","Visiting and Joining Family","2002 ","126","65","61",
"4 s","Visiting and Joining Family","2003 ","94","48","46",
"4 s","Visiting and Joining Family","2004 ","95","47","48",
"4 s","Visiting and Joining Family","2005 ","100","45","55",
"4 s","Visiting and Joining Family","2006 ","102","46","56",
"4 s","Visiting and Joining Family","2007 ","93","42","51",
"4 s","Visiting and Joining Family","2008 ","105","57","48",
"4 s","Visiting and Joining Family","2009 ","115","66","49",
"4 s","Visiting and Joining Family","2010 ","163","84","79",
"4 s","Visiting and Joining Family","2011 ","111","55","56",
"4 s","Visiting and Joining Family","2012 ","61","40","21",
"4 s","Visiting and Joining Family","2013 ","86","43","43",
"4 s","Visiting and Joining Family","2014 ","138","77","61",
"4 s","Visiting and Joining Family","2015 ","161","79","82",
"4 s","Visiting and Joining Family","2016 ","270","138","132",
"4 s","Visiting and Joining Family","2017 ","349","170","179",
"4 s","Visiting and Joining Family","2018 ","388","201","187",
"4 s","Visiting and Joining Family","2019 ","457","220","237",
"4 s","Overseas Koreans","2000 ","11","6","5",
"4 s","Overseas Koreans","2001 ","6","3","3",
"4 s","Overseas Koreans","2002 ","14","6","8",
"4 s","Overseas Koreans","2003 ","5","3","2",
"4 s","Overseas Koreans","2004 ","7","3","4",
"4 s","Overseas Koreans","2005 ","2","1","1",
"4 s","Overseas Koreans","2006 ","5","1","4",
"4 s","Overseas Koreans","2007 ","5","2","3",
"4 s","Overseas Koreans","2008 ","7","3","4",
"4 s","Overseas Koreans","2009 ","5","4","1",
"4 s","Overseas Koreans","2010 ","16","5","11",
"4 s","Overseas Koreans","2011 ","36","20","16",
"4 s","Overseas Koreans","2012 ","25","14","11",
"4 s","Overseas Koreans","2013 ","31","21","10",
"4 s","Overseas Koreans","2014 ","23","11","12",
"4 s","Overseas Koreans","2015 ","16","12","4",
"4 s","Overseas Koreans","2016 ","27","11","16",
"4 s","Overseas Koreans","2017 ","24","11","13",
"4 s","Overseas Koreans","2018 ","9","4","5",
"4 s","Overseas Koreans","2019 ","14","5","9",
"4 s","Permanent Residence","2000 ","0","0","0",
"4 s","Permanent Residence","2001 ","0","0","0",
"4 s","Permanent Residence","2002 ","0","0","0",
"4 s","Permanent Residence","2003 ","3","2","1",
"4 s","Permanent Residence","2004 ","4","2","2",
"4 s","Permanent Residence","2005 ","2","1","1",
"4 s","Permanent Residence","2006 ","1","1","0",
"4 s","Permanent Residence","2007 ","2","1","1",
"4 s","Permanent Residence","2008 ","2","2","0",
"4 s","Permanent Residence","2009 ","2","1","1",
"4 s","Permanent Residence","2010 ","4","2","2",
"4 s","Permanent Residence","2011 ","1","","1",
"4 s","Permanent Residence","2012 ","2","1","1",
"4 s","Permanent Residence","2013 ","2","1","1",
"4 s","Permanent Residence","2014 ","7","5","2",
"4 s","Permanent Residence","2015 ","16","6","10",
"4 s","Permanent Residence","2016 ","25","16","9",
"4 s","Permanent Residence","2017 ","22","15","7",
"4 s","Permanent Residence","2018 ","40","20","20",
"4 s","Permanent Residence","2019 ","38","14","24",
"4 s","Marriage Immigration","2012 ","1","1","",
"5 s","Total","2000 ","532","277","255",
"5 s","Total","2001 ","490","257","233",
"5 s","Total","2002 ","538","273","265",
"5 s","Total","2003 ","494","259","235",
"5 s","Total","2004 ","488","243","245",
"5 s","Total","2005 ","507","245","262",
"5 s","Total","2006 ","590","294","296",
"5 s","Total","2007 ","551","280","271",
"5 s","Total","2008 ","598","313","285",
"5 s","Total","2009 ","653","329","324",
"5 s","Total","2010 ","764","374","390",
"5 s","Total","2011 ","914","446","468",
"5 s","Total","2012 ","1066","525","541",
"5 s","Total","2013 ","1181","615","566",
"5 s","Total","2014 ","1240","621","619",
"5 s","Total","2015 ","1219","612","607",
"5 s","Total","2016 ","1330","667","663",
"5 s","Total","2017 ","1335","664","671",
"5 s","Total","2018 ","1503","767","736",
"5 s","Total","2019 ","1492","727","765",
"5 s","Sightseeing Pass","2000 ","123","56","67",
"5 s","Sightseeing Pass","2001 ","125","63","62",
"5 s","Sightseeing Pass","2002 ","153","76","77",
"5 s","Sightseeing Pass","2003 ","141","73","68",
"5 s","Sightseeing Pass","2004 ","187","97","90",
"5 s","Sightseeing Pass","2005 ","160","81","79",
"5 s","Sightseeing Pass","2006 ","195","101","94",
"5 s","Sightseeing Pass","2007 ","177","89","88",
"5 s","Sightseeing Pass","2008 ","215","116","99",
"5 s","Sightseeing Pass","2009 ","280","147","133",
"5 s","Sightseeing Pass","2010 ","318","150","168",
"5 s","Sightseeing Pass","2011 ","383","186","197",
"5 s","Sightseeing Pass","2012 ","435","216","219",
"5 s","Sightseeing Pass","2013 ","377","183","194",
"5 s","Sightseeing Pass","2014 ","381","198","183",
"5 s","Sightseeing Pass","2015 ","367","198","169",
"5 s","Sightseeing Pass","2016 ","284","126","158",
"5 s","Sightseeing Pass","2017 ","269","131","138",
"5 s","Sightseeing Pass","2018 ","316","168","148",
"5 s","Sightseeing Pass","2019 ","336","166","170",
"5 s","Short-term Business","2000 ","4","4","0",
"5 s","Short-term Business","2001 ","3","2","1",
"5 s","Short-term Business","2002 ","1","0","1",
"5 s","Short-term Business","2003 ","4","2","2",
"5 s","Short-term Business","2004 ","1","1","0",
"5 s","Short-term Business","2005 ","1","1","0",
"5 s","Short-term Business","2006 ","0","0","0",
"5 s","Short-term Business","2007 ","2","0","2",
"5 s","Short-term Business","2008 ","0","0","0",
"5 s","Short-term Business","2009 ","1","1","0",
"5 s","Short-term Business","2010 ","0","0","0",
"5 s","Short-term Business","2011 ","1","","1",
"5 s","Short-term Visitors","2000 ","140","73","67",
"5 s","Short-term Visitors","2001 ","127","65","62",
"5 s","Short-term Visitors","2002 ","134","73","61",
"5 s","Short-term Visitors","2003 ","120","62","58",
"5 s","Short-term Visitors","2004 ","77","30","47",
"5 s","Short-term Visitors","2005 ","102","41","61",
"5 s","Short-term Visitors","2006 ","126","56","70",
"5 s","Short-term Visitors","2007 ","127","65","62",
"5 s","Short-term Visitors","2008 ","148","77","71",
"5 s","Short-term Visitors","2009 ","111","55","56",
"5 s","Short-term Visitors","2010 ","146","80","66",
"5 s","Short-term Visitors","2011 ","251","115","136",
"5 s","Short-term Visitors","2012 ","376","180","196",
"5 s","Short-term Visitors","2013 ","431","229","202",
"5 s","Short-term Visitors","2014 ","455","213","242",
"5 s","Short-term Visitors","2015 ","504","236","268",
"5 s","Short-term Visitors","2016 ","538","296","242",
"5 s","Short-term Visitors","2017 ","412","204","208",
"5 s","Short-term Visitors","2018 ","417","208","209",
"5 s","Short-term Visitors","2019 ","345","168","177",
"5 s","Short-term Employment","2000 ","0","0","0",
"5 s","Short-term Employment","2001 ","0","0","0",
"5 s","Short-term Employment","2002 ","0","0","0",
"5 s","Short-term Employment","2003 ","0","0","0",
"5 s","Short-term Employment","2004 ","0","0","0",
"5 s","Short-term Employment","2005 ","0","0","0",
"5 s","Short-term Employment","2006 ","0","0","0",
"5 s","Short-term Employment","2007 ","0","0","0",
"5 s","Short-term Employment","2008 ","0","0","0",
"5 s","Short-term Employment","2009 ","0","0","0",
"5 s","Short-term Employment","2010 ","0","0","0",
"5 s","Job Seeking","2000 ","0","0","0",
"5 s","Job Seeking","2001 ","0","0","0",
"5 s","Job Seeking","2002 ","0","0","0",
"5 s","Job Seeking","2003 ","0","0","0",
"5 s","Job Seeking","2004 ","0","0","0",
"5 s","Job Seeking","2005 ","0","0","0",
"5 s","Job Seeking","2006 ","0","0","0",
"5 s","Job Seeking","2007 ","0","0","0",
"5 s","Job Seeking","2008 ","0","0","0",
"5 s","Job Seeking","2009 ","0","0","0",
"5 s","Job Seeking","2010 ","0","0","0",
"5 s","study","2000 ","0","0","0",
"5 s","study","2001 ","1","0","1",
"5 s","study","2002 ","1","0","1",
"5 s","study","2003 ","1","1","0",
"5 s","study","2004 ","1","0","1",
"5 s","study","2005 ","0","0","0",
"5 s","study","2006 ","0","0","0",
"5 s","study","2007 ","0","0","0",
"5 s","study","2008 ","0","0","0",
"5 s","study","2009 ","0","0","0",
"5 s","study","2010 ","0","0","0",
"5 s","General Trainees","2000 ","0","0","0",
"5 s","General Trainees","2001 ","0","0","0",
"5 s","General Trainees","2002 ","0","0","0",
"5 s","General Trainees","2003 ","0","0","0",
"5 s","General Trainees","2004 ","0","0","0",
"5 s","General Trainees","2005 ","0","0","0",
"5 s","General Trainees","2006 ","0","0","0",
"5 s","General Trainees","2007 ","0","0","0",
"5 s","General Trainees","2008 ","0","0","0",
"5 s","General Trainees","2009 ","0","0","0",
"5 s","General Trainees","2010 ","0","0","0",
"5 s","General Trainees","2016 ","1","1","0",
"5 s","Religious Activities","2000 ","1","1","0",
"5 s","Religious Activities","2001 ","0","0","0",
"5 s","Religious Activities","2002 ","0","0","0",
"5 s","Religious Activities","2003 ","0","0","0",
"5 s","Religious Activities","2004 ","0","0","0",
"5 s","Religious Activities","2005 ","0","0","0",
"5 s","Religious Activities","2006 ","0","0","0",
"5 s","Religious Activities","2007 ","0","0","0",
"5 s","Religious Activities","2008 ","1","0","1",
"5 s","Religious Activities","2009 ","0","0","0",
"5 s","Religious Activities","2010 ","0","0","0",
"5 s","Investors","2000 ","0","0","0",
"5 s","Investors","2001 ","0","0","0",
"5 s","Investors","2002 ","0","0","0",
"5 s","Investors","2003 ","0","0","0",
"5 s","Investors","2004 ","0","0","0",
"5 s","Investors","2005 ","0","0","0",
"5 s","Investors","2006 ","0","0","0",
"5 s","Investors","2007 ","0","0","0",
"5 s","Investors","2008 ","0","0","0",
"5 s","Investors","2009 ","0","0","0",
"5 s","Investors","2010 ","0","0","0",
"5 s","Trade and Business","2000 ","1","1","0",
"5 s","Trade and Business","2001 ","0","0","0",
"5 s","Trade and Business","2002 ","0","0","0",
"5 s","Trade and Business","2003 ","0","0","0",
"5 s","Trade and Business","2004 ","0","0","0",
"5 s","Trade and Business","2005 ","0","0","0",
"5 s","Trade and Business","2006 ","0","0","0",
"5 s","Trade and Business","2007 ","0","0","0",
"5 s","Trade and Business","2008 ","0","0","0",
"5 s","Trade and Business","2009 ","0","0","0",
"5 s","Trade and Business","2010 ","0","0","0",
"5 s","Research","2000 ","1","1","0",
"5 s","Research","2001 ","0","0","0",
"5 s","Research","2002 ","0","0","0",
"5 s","Research","2003 ","0","0","0",
"5 s","Research","2004 ","0","0","0",
"5 s","Research","2005 ","1","1","0",
"5 s","Research","2006 ","0","0","0",
"5 s","Research","2007 ","0","0","0",
"5 s","Research","2008 ","0","0","0",
"5 s","Research","2009 ","0","0","0",
"5 s","Research","2010 ","0","0","0",
"5 s","Art and Entertainment","2000 ","0","0","0",
"5 s","Art and Entertainment","2001 ","2","1","1",
"5 s","Art and Entertainment","2002 ","1","0","1",
"5 s","Art and Entertainment","2003 ","0","0","0",
"5 s","Art and Entertainment","2004 ","0","0","0",
"5 s","Art and Entertainment","2005 ","0","0","0",
"5 s","Art and Entertainment","2006 ","0","0","0",
"5 s","Art and Entertainment","2007 ","1","0","1",
"5 s","Art and Entertainment","2008 ","1","1","0",
"5 s","Art and Entertainment","2009 ","0","0","0",
"5 s","Art and Entertainment","2010 ","0","0","0",
"5 s","Art and Entertainment","2012 ","1","","1",
"5 s","Unskilled Employment","2000 ","0","0","0",
"5 s","Unskilled Employment","2001 ","0","0","0",
"5 s","Unskilled Employment","2002 ","0","0","0",
"5 s","Unskilled Employment","2003 ","0","0","0",
"5 s","Unskilled Employment","2004 ","0","0","0",
"5 s","Unskilled Employment","2005 ","0","0","0",
"5 s","Unskilled Employment","2006 ","0","0","0",
"5 s","Unskilled Employment","2007 ","0","0","0",
"5 s","Unskilled Employment","2008 ","0","0","0",
"5 s","Unskilled Employment","2009 ","0","0","0",
"5 s","Unskilled Employment","2010 ","0","0","0",
"5 s","Visiting and Joining Family","2000 ","102","55","47",
"5 s","Visiting and Joining Family","2001 ","75","42","33",
"5 s","Visiting and Joining Family","2002 ","99","54","45",
"5 s","Visiting and Joining Family","2003 ","79","47","32",
"5 s","Visiting and Joining Family","2004 ","83","45","38",
"5 s","Visiting and Joining Family","2005 ","67","43","24",
"5 s","Visiting and Joining Family","2006 ","106","56","50",
"5 s","Visiting and Joining Family","2007 ","76","40","36",
"5 s","Visiting and Joining Family","2008 ","78","37","41",
"5 s","Visiting and Joining Family","2009 ","107","51","56",
"5 s","Visiting and Joining Family","2010 ","140","72","68",
"5 s","Visiting and Joining Family","2011 ","71","36","35",
"5 s","Visiting and Joining Family","2012 ","28","14","14",
"5 s","Visiting and Joining Family","2013 ","71","40","31",
"5 s","Visiting and Joining Family","2014 ","97","44","53",
"5 s","Visiting and Joining Family","2015 ","89","43","46",
"5 s","Visiting and Joining Family","2016 ","234","114","120",
"5 s","Visiting and Joining Family","2017 ","316","169","147",
"5 s","Visiting and Joining Family","2018 ","371","184","187",
"5 s","Visiting and Joining Family","2019 ","380","181","199",
"5 s","Overseas Koreans","2000 ","12","4","8",
"5 s","Overseas Koreans","2001 ","5","2","3",
"5 s","Overseas Koreans","2002 ","7","5","2",
"5 s","Overseas Koreans","2003 ","5","2","3",
"5 s","Overseas Koreans","2004 ","9","6","3",
"5 s","Overseas Koreans","2005 ","2","0","2",
"5 s","Overseas Koreans","2006 ","2","0","2",
"5 s","Overseas Koreans","2007 ","3","3","0",
"5 s","Overseas Koreans","2008 ","4","2","2",
"5 s","Overseas Koreans","2009 ","4","3","1",
"5 s","Overseas Koreans","2010 ","10","5","5",
"5 s","Overseas Koreans","2011 ","18","6","12",
"5 s","Overseas Koreans","2012 ","27","10","17",
"5 s","Overseas Koreans","2013 ","19","10","9",
"5 s","Overseas Koreans","2014 ","19","8","11",
"5 s","Overseas Koreans","2015 ","27","13","14",
"5 s","Overseas Koreans","2016 ","13","5","8",
"5 s","Overseas Koreans","2017 ","29","10","19",
"5 s","Overseas Koreans","2018 ","21","10","11",
"5 s","Overseas Koreans","2019 ","11","5","6",
"5 s","Permanent Residence","2000 ","0","0","0",
"5 s","Permanent Residence","2001 ","0","0","0",
"5 s","Permanent Residence","2002 ","0","0","0",
"5 s","Permanent Residence","2003 ","0","0","0",
"5 s","Permanent Residence","2004 ","2","1","1",
"5 s","Permanent Residence","2005 ","1","0","1",
"5 s","Permanent Residence","2006 ","3","1","2",
"5 s","Permanent Residence","2007 ","5","4","1",
"5 s","Permanent Residence","2008 ","2","1","1",
"5 s","Permanent Residence","2009 ","5","1","4",
"5 s","Permanent Residence","2010 ","4","2","2",
"5 s","Permanent Residence","2011 ","2","","2",
"5 s","Permanent Residence","2012 ","2","1","1",
"5 s","Permanent Residence","2013 ","8","3","5",
"5 s","Permanent Residence","2014 ","3","0","3",
"5 s","Permanent Residence","2015 ","6","3","3",
"5 s","Permanent Residence","2016 ","9","4","5",
"5 s","Permanent Residence","2017 ","24","13","11",
"5 s","Permanent Residence","2018 ","18","6","12",
"5 s","Permanent Residence","2019 ","35","17","18",
"6 s","Total","2000 ","479","253","226",
"6 s","Total","2001 ","452","230","222",
"6 s","Total","2002 ","445","221","224",
"6 s","Total","2003 ","407","215","192",
"6 s","Total","2004 ","436","232","204",
"6 s","Total","2005 ","444","246","198",
"6 s","Total","2006 ","461","255","206",
"6 s","Total","2007 ","503","264","239",
"6 s","Total","2008 ","504","254","250",
"6 s","Total","2009 ","523","237","286",
"6 s","Total","2010 ","614","293","321",
"6 s","Total","2011 ","786","420","366",
"6 s","Total","2012 ","803","404","399",
"6 s","Total","2013 ","838","420","418",
"6 s","Total","2014 ","1048","511","537",
"6 s","Total","2015 ","981","516","465",
"6 s","Total","2016 ","1161","569","592",
"6 s","Total","2017 ","1041","547","494",
"6 s","Total","2018 ","1180","595","585",
"6 s","Total","2019 ","1255","628","627",
"6 s","Sightseeing Pass","2000 ","131","75","56",
"6 s","Sightseeing Pass","2001 ","147","83","64",
"6 s","Sightseeing Pass","2002 ","130","61","69",
"6 s","Sightseeing Pass","2003 ","133","78","55",
"6 s","Sightseeing Pass","2004 ","169","91","78",
"6 s","Sightseeing Pass","2005 ","158","79","79",
"6 s","Sightseeing Pass","2006 ","173","91","82",
"6 s","Sightseeing Pass","2007 ","164","88","76",
"6 s","Sightseeing Pass","2008 ","163","91","72",
"6 s","Sightseeing Pass","2009 ","242","111","131",
"6 s","Sightseeing Pass","2010 ","259","117","142",
"6 s","Sightseeing Pass","2011 ","337","180","157",
"6 s","Sightseeing Pass","2012 ","390","196","194",
"6 s","Sightseeing Pass","2013 ","349","173","176",
"6 s","Sightseeing Pass","2014 ","374","179","195",
"6 s","Sightseeing Pass","2015 ","320","178","142",
"6 s","Sightseeing Pass","2016 ","296","138","158",
"6 s","Sightseeing Pass","2017 ","292","140","152",
"6 s","Sightseeing Pass","2018 ","293","150","143",
"6 s","Sightseeing Pass","2019 ","270","140","130",
"6 s","Short-term Business","2000 ","3","0","3",
"6 s","Short-term Business","2001 ","5","5","0",
"6 s","Short-term Business","2002 ","2","2","0",
"6 s","Short-term Business","2003 ","1","0","1",
"6 s","Short-term Business","2004 ","0","0","0",
"6 s","Short-term Business","2005 ","1","0","1",
"6 s","Short-term Business","2006 ","0","0","0",
"6 s","Short-term Business","2007 ","1","0","1",
"6 s","Short-term Business","2008 ","0","0","0",
"6 s","Short-term Business","2009 ","0","0","0",
"6 s","Short-term Business","2010 ","0","0","0",
"6 s","Short-term Visitors","2000 ","116","52","64",
"6 s","Short-term Visitors","2001 ","94","37","57",
"6 s","Short-term Visitors","2002 ","88","41","47",
"6 s","Short-term Visitors","2003 ","74","31","43",
"6 s","Short-term Visitors","2004 ","75","41","34",
"6 s","Short-term Visitors","2005 ","77","43","34",
"6 s","Short-term Visitors","2006 ","83","46","37",
"6 s","Short-term Visitors","2007 ","96","43","53",
"6 s","Short-term Visitors","2008 ","149","61","88",
"6 s","Short-term Visitors","2009 ","83","40","43",
"6 s","Short-term Visitors","2010 ","101","42","59",
"6 s","Short-term Visitors","2011 ","173","90","83",
"6 s","Short-term Visitors","2012 ","219","106","113",
"6 s","Short-term Visitors","2013 ","256","121","135",
"6 s","Short-term Visitors","2014 ","378","180","198",
"6 s","Short-term Visitors","2015 ","371","183","188",
"6 s","Short-term Visitors","2016 ","409","208","201",
"6 s","Short-term Visitors","2017 ","306","175","131",
"6 s","Short-term Visitors","2018 ","349","176","173",
"6 s","Short-term Visitors","2019 ","302","149","153",
"6 s","Short-term Employment","2000 ","0","0","0",
"6 s","Short-term Employment","2001 ","0","0","0",
"6 s","Short-term Employment","2002 ","0","0","0",
"6 s","Short-term Employment","2003 ","0","0","0",
"6 s","Short-term Employment","2004 ","0","0","0",
"6 s","Short-term Employment","2005 ","0","0","0",
"6 s","Short-term Employment","2006 ","0","0","0",
"6 s","Short-term Employment","2007 ","0","0","0",
"6 s","Short-term Employment","2008 ","0","0","0",
"6 s","Short-term Employment","2009 ","0","0","0",
"6 s","Short-term Employment","2010 ","0","0","0",
"6 s","Job Seeking","2000 ","0","0","0",
"6 s","Job Seeking","2001 ","0","0","0",
"6 s","Job Seeking","2002 ","0","0","0",
"6 s","Job Seeking","2003 ","0","0","0",
"6 s","Job Seeking","2004 ","0","0","0",
"6 s","Job Seeking","2005 ","0","0","0",
"6 s","Job Seeking","2006 ","0","0","0",
"6 s","Job Seeking","2007 ","0","0","0",
"6 s","Job Seeking","2008 ","0","0","0",
"6 s","Job Seeking","2009 ","0","0","0",
"6 s","Job Seeking","2010 ","0","0","0",
"6 s","study","2000 ","0","0","0",
"6 s","study","2001 ","0","0","0",
"6 s","study","2002 ","0","0","0",
"6 s","study","2003 ","0","0","0",
"6 s","study","2004 ","0","0","0",
"6 s","study","2005 ","0","0","0",
"6 s","study","2006 ","0","0","0",
"6 s","study","2007 ","0","0","0",
"6 s","study","2008 ","0","0","0",
"6 s","study","2009 ","0","0","0",
"6 s","study","2010 ","0","0","0",
"6 s","General Trainees","2000 ","0","0","0",
"6 s","General Trainees","2001 ","1","1","0",
"6 s","General Trainees","2002 ","0","0","0",
"6 s","General Trainees","2003 ","0","0","0",
"6 s","General Trainees","2004 ","1","1","0",
"6 s","General Trainees","2005 ","0","0","0",
"6 s","General Trainees","2006 ","0","0","0",
"6 s","General Trainees","2007 ","1","1","0",
"6 s","General Trainees","2008 ","0","0","0",
"6 s","General Trainees","2009 ","0","0","0",
"6 s","General Trainees","2010 ","0","0","0",
"6 s","General Trainees","2013 ","1","1","0",
"6 s","General Trainees","2014 ","1","0","1",
"6 s","Religious Activities","2000 ","0","0","0",
"6 s","Religious Activities","2001 ","0","0","0",
"6 s","Religious Activities","2002 ","0","0","0",
"6 s","Religious Activities","2003 ","0","0","0",
"6 s","Religious Activities","2004 ","0","0","0",
"6 s","Religious Activities","2005 ","0","0","0",
"6 s","Religious Activities","2006 ","0","0","0",
"6 s","Religious Activities","2007 ","0","0","0",
"6 s","Religious Activities","2008 ","1","1","0",
"6 s","Religious Activities","2009 ","0","0","0",
"6 s","Religious Activities","2010 ","0","0","0",
"6 s","Investors","2000 ","0","0","0",
"6 s","Investors","2001 ","0","0","0",
"6 s","Investors","2002 ","0","0","0",
"6 s","Investors","2003 ","1","1","0",
"6 s","Investors","2004 ","0","0","0",
"6 s","Investors","2005 ","0","0","0",
"6 s","Investors","2006 ","0","0","0",
"6 s","Investors","2007 ","0","0","0",
"6 s","Investors","2008 ","0","0","0",
"6 s","Investors","2009 ","0","0","0",
"6 s","Investors","2010 ","0","0","0",
"6 s","Trade and Business","2000 ","0","0","0",
"6 s","Trade and Business","2001 ","0","0","0",
"6 s","Trade and Business","2002 ","0","0","0",
"6 s","Trade and Business","2003 ","0","0","0",
"6 s","Trade and Business","2004 ","0","0","0",
"6 s","Trade and Business","2005 ","0","0","0",
"6 s","Trade and Business","2006 ","0","0","0",
"6 s","Trade and Business","2007 ","0","0","0",
"6 s","Trade and Business","2008 ","0","0","0",
"6 s","Trade and Business","2009 ","0","0","0",
"6 s","Trade and Business","2010 ","0","0","0",
"6 s","Research","2000 ","1","0","1",
"6 s","Research","2001 ","0","0","0",
"6 s","Research","2002 ","0","0","0",
"6 s","Research","2003 ","0","0","0",
"6 s","Research","2004 ","0","0","0",
"6 s","Research","2005 ","0","0","0",
"6 s","Research","2006 ","1","0","1",
"6 s","Research","2007 ","0","0","0",
"6 s","Research","2008 ","0","0","0",
"6 s","Research","2009 ","0","0","0",
"6 s","Research","2010 ","0","0","0",
"6 s","Art and Entertainment","2000 ","0","0","0",
"6 s","Art and Entertainment","2001 ","0","0","0",
"6 s","Art and Entertainment","2002 ","0","0","0",
"6 s","Art and Entertainment","2003 ","0","0","0",
"6 s","Art and Entertainment","2004 ","0","0","0",
"6 s","Art and Entertainment","2005 ","1","0","1",
"6 s","Art and Entertainment","2006 ","0","0","0",
"6 s","Art and Entertainment","2007 ","0","0","0",
"6 s","Art and Entertainment","2008 ","0","0","0",
"6 s","Art and Entertainment","2009 ","0","0","0",
"6 s","Art and Entertainment","2010 ","0","0","0",
"6 s","Unskilled Employment","2000 ","0","0","0",
"6 s","Unskilled Employment","2001 ","0","0","0",
"6 s","Unskilled Employment","2002 ","0","0","0",
"6 s","Unskilled Employment","2003 ","0","0","0",
"6 s","Unskilled Employment","2004 ","0","0","0",
"6 s","Unskilled Employment","2005 ","0","0","0",
"6 s","Unskilled Employment","2006 ","0","0","0",
"6 s","Unskilled Employment","2007 ","0","0","0",
"6 s","Unskilled Employment","2008 ","0","0","0",
"6 s","Unskilled Employment","2009 ","0","0","0",
"6 s","Unskilled Employment","2010 ","0","0","0",
"6 s","Visiting and Joining Family","2000 ","86","48","38",
"6 s","Visiting and Joining Family","2001 ","73","40","33",
"6 s","Visiting and Joining Family","2002 ","63","33","30",
"6 s","Visiting and Joining Family","2003 ","66","34","32",
"6 s","Visiting and Joining Family","2004 ","45","26","19",
"6 s","Visiting and Joining Family","2005 ","76","41","35",
"6 s","Visiting and Joining Family","2006 ","75","41","34",
"6 s","Visiting and Joining Family","2007 ","89","41","48",
"6 s","Visiting and Joining Family","2008 ","72","39","33",
"6 s","Visiting and Joining Family","2009 ","82","33","49",
"6 s","Visiting and Joining Family","2010 ","100","51","49",
"6 s","Visiting and Joining Family","2011 ","76","36","40",
"6 s","Visiting and Joining Family","2012 ","25","11","14",
"6 s","Visiting and Joining Family","2013 ","26","15","11",
"6 s","Visiting and Joining Family","2014 ","72","40","32",
"6 s","Visiting and Joining Family","2015 ","82","40","42",
"6 s","Visiting and Joining Family","2016 ","177","80","97",
"6 s","Visiting and Joining Family","2017 ","219","112","107",
"6 s","Visiting and Joining Family","2018 ","243","118","125",
"6 s","Visiting and Joining Family","2019 ","301","149","152",
"6 s","Overseas Koreans","2000 ","8","6","2",
"6 s","Overseas Koreans","2001 ","3","1","2",
"6 s","Overseas Koreans","2002 ","9","4","5",
"6 s","Overseas Koreans","2003 ","8","6","2",
"6 s","Overseas Koreans","2004 ","6","2","4",
"6 s","Overseas Koreans","2005 ","6","4","2",
"6 s","Overseas Koreans","2006 ","3","3","0",
"6 s","Overseas Koreans","2007 ","4","2","2",
"6 s","Overseas Koreans","2008 ","3","1","2",
"6 s","Overseas Koreans","2009 ","1","1","0",
"6 s","Overseas Koreans","2010 ","9","6","3",
"6 s","Overseas Koreans","2011 ","21","12","9",
"6 s","Overseas Koreans","2012 ","15","4","11",
"6 s","Overseas Koreans","2013 ","16","8","8",
"6 s","Overseas Koreans","2014 ","13","6","7",
"6 s","Overseas Koreans","2015 ","18","9","9",
"6 s","Overseas Koreans","2016 ","28","14","14",
"6 s","Overseas Koreans","2017 ","20","6","14",
"6 s","Overseas Koreans","2018 ","26","15","11",
"6 s","Overseas Koreans","2019 ","21","11","10",
"6 s","Permanent Residence","2000 ","0","0","0",
"6 s","Permanent Residence","2001 ","0","0","0",
"6 s","Permanent Residence","2002 ","0","0","0",
"6 s","Permanent Residence","2003 ","2","1","1",
"6 s","Permanent Residence","2004 ","1","0","1",
"6 s","Permanent Residence","2005 ","2","1","1",
"6 s","Permanent Residence","2006 ","4","3","1",
"6 s","Permanent Residence","2007 ","3","2","1",
"6 s","Permanent Residence","2008 ","3","3","0",
"6 s","Permanent Residence","2009 ","1","1","0",
"6 s","Permanent Residence","2010 ","1","1","0",
"6 s","Permanent Residence","2011 ","3","","3",
"6 s","Permanent Residence","2012 ","2","1","1",
"6 s","Permanent Residence","2013 ","1","1","0",
"6 s","Permanent Residence","2015 ","5","4","1",
"6 s","Permanent Residence","2016 ","11","6","5",
"6 s","Permanent Residence","2017 ","4","4","0",
"6 s","Permanent Residence","2018 ","22","13","9",
"6 s","Permanent Residence","2019 ","19","14","5",
"7 s","Total","2000 ","367","184","183",
"7 s","Total","2001 ","384","202","182",
"7 s","Total","2002 ","381","203","178",
"7 s","Total","2003 ","387","207","180",
"7 s","Total","2004 ","371","194","177",
"7 s","Total","2005 ","414","203","211",
"7 s","Total","2006 ","376","206","170",
"7 s","Total","2007 ","417","216","201",
"7 s","Total","2008 ","456","232","224",
"7 s","Total","2009 ","455","237","218",
"7 s","Total","2010 ","514","270","244",
"7 s","Total","2011 ","606","291","315",
"7 s","Total","2012 ","690","355","335",
"7 s","Total","2013 ","678","351","327",
"7 s","Total","2014 ","781","380","401",
"7 s","Total","2015 ","816","404","412",
"7 s","Total","2016 ","843","455","388",
"7 s","Total","2017 ","788","401","387",
"7 s","Total","2018 ","885","440","445",
"7 s","Total","2019 ","974","478","496",
"7 s","Sightseeing Pass","2000 ","104","50","54",
"7 s","Sightseeing Pass","2001 ","116","57","59",
"7 s","Sightseeing Pass","2002 ","112","55","57",
"7 s","Sightseeing Pass","2003 ","127","69","58",
"7 s","Sightseeing Pass","2004 ","148","71","77",
"7 s","Sightseeing Pass","2005 ","138","71","67",
"7 s","Sightseeing Pass","2006 ","131","75","56",
"7 s","Sightseeing Pass","2007 ","136","73","63",
"7 s","Sightseeing Pass","2008 ","168","93","75",
"7 s","Sightseeing Pass","2009 ","219","126","93",
"7 s","Sightseeing Pass","2010 ","232","129","103",
"7 s","Sightseeing Pass","2011 ","310","139","171",
"7 s","Sightseeing Pass","2012 ","354","187","167",
"7 s","Sightseeing Pass","2013 ","311","155","156",
"7 s","Sightseeing Pass","2014 ","322","163","159",
"7 s","Sightseeing Pass","2015 ","296","144","152",
"7 s","Sightseeing Pass","2016 ","221","119","102",
"7 s","Sightseeing Pass","2017 ","205","107","98",
"7 s","Sightseeing Pass","2018 ","254","125","129",
"7 s","Sightseeing Pass","2019 ","234","119","115",
"7 s","Short-term Business","2000 ","4","2","2",
"7 s","Short-term Business","2001 ","5","2","3",
"7 s","Short-term Business","2002 ","7","6","1",
"7 s","Short-term Business","2003 ","4","4","0",
"7 s","Short-term Business","2004 ","0","0","0",
"7 s","Short-term Business","2005 ","1","1","0",
"7 s","Short-term Business","2006 ","1","1","0",
"7 s","Short-term Business","2007 ","1","0","1",
"7 s","Short-term Business","2008 ","0","0","0",
"7 s","Short-term Business","2009 ","1","1","0",
"7 s","Short-term Business","2010 ","0","0","0",
"7 s","Short-term Business","2011 ","2","2","",
"7 s","Short-term Visitors","2000 ","94","43","51",
"7 s","Short-term Visitors","2001 ","82","45","37",
"7 s","Short-term Visitors","2002 ","87","44","43",
"7 s","Short-term Visitors","2003 ","79","42","37",
"7 s","Short-term Visitors","2004 ","56","29","27",
"7 s","Short-term Visitors","2005 ","89","46","43",
"7 s","Short-term Visitors","2006 ","62","31","31",
"7 s","Short-term Visitors","2007 ","84","43","41",
"7 s","Short-term Visitors","2008 ","119","59","60",
"7 s","Short-term Visitors","2009 ","66","35","31",
"7 s","Short-term Visitors","2010 ","82","40","42",
"7 s","Short-term Visitors","2011 ","123","65","58",
"7 s","Short-term Visitors","2012 ","178","83","95",
"7 s","Short-term Visitors","2013 ","159","85","74",
"7 s","Short-term Visitors","2014 ","256","127","129",
"7 s","Short-term Visitors","2015 ","305","143","162",
"7 s","Short-term Visitors","2016 ","316","177","139",
"7 s","Short-term Visitors","2017 ","236","112","124",
"7 s","Short-term Visitors","2018 ","221","106","115",
"7 s","Short-term Visitors","2019 ","247","115","132",
"7 s","Short-term Employment","2000 ","0","0","0",
"7 s","Short-term Employment","2001 ","0","0","0",
"7 s","Short-term Employment","2002 ","0","0","0",
"7 s","Short-term Employment","2003 ","0","0","0",
"7 s","Short-term Employment","2004 ","0","0","0",
"7 s","Short-term Employment","2005 ","0","0","0",
"7 s","Short-term Employment","2006 ","0","0","0",
"7 s","Short-term Employment","2007 ","1","1","0",
"7 s","Short-term Employment","2008 ","0","0","0",
"7 s","Short-term Employment","2009 ","0","0","0",
"7 s","Short-term Employment","2010 ","0","0","0",
"7 s","Job Seeking","2000 ","0","0","0",
"7 s","Job Seeking","2001 ","0","0","0",
"7 s","Job Seeking","2002 ","0","0","0",
"7 s","Job Seeking","2003 ","0","0","0",
"7 s","Job Seeking","2004 ","0","0","0",
"7 s","Job Seeking","2005 ","0","0","0",
"7 s","Job Seeking","2006 ","0","0","0",
"7 s","Job Seeking","2007 ","0","0","0",
"7 s","Job Seeking","2008 ","0","0","0",
"7 s","Job Seeking","2009 ","0","0","0",
"7 s","Job Seeking","2010 ","0","0","0",
"7 s","study","2000 ","0","0","0",
"7 s","study","2001 ","0","0","0",
"7 s","study","2002 ","1","1","0",
"7 s","study","2003 ","0","0","0",
"7 s","study","2004 ","0","0","0",
"7 s","study","2005 ","0","0","0",
"7 s","study","2006 ","0","0","0",
"7 s","study","2007 ","0","0","0",
"7 s","study","2008 ","0","0","0",
"7 s","study","2009 ","0","0","0",
"7 s","study","2010 ","0","0","0",
"7 s","General Trainees","2000 ","0","0","0",
"7 s","General Trainees","2001 ","0","0","0",
"7 s","General Trainees","2002 ","0","0","0",
"7 s","General Trainees","2003 ","1","0","1",
"7 s","General Trainees","2004 ","0","0","0",
"7 s","General Trainees","2005 ","1","0","1",
"7 s","General Trainees","2006 ","0","0","0",
"7 s","General Trainees","2007 ","0","0","0",
"7 s","General Trainees","2008 ","0","0","0",
"7 s","General Trainees","2009 ","0","0","0",
"7 s","General Trainees","2010 ","0","0","0",
"7 s","General Trainees","2011 ","2","2","",
"7 s","General Trainees","2014 ","1","1","0",
"7 s","General Trainees","2017 ","2","2","0",
"7 s","General Trainees","2019 ","2","1","1",
"7 s","Religious Activities","2000 ","0","0","0",
"7 s","Religious Activities","2001 ","0","0","0",
"7 s","Religious Activities","2002 ","0","0","0",
"7 s","Religious Activities","2003 ","0","0","0",
"7 s","Religious Activities","2004 ","0","0","0",
"7 s","Religious Activities","2005 ","0","0","0",
"7 s","Religious Activities","2006 ","0","0","0",
"7 s","Religious Activities","2007 ","0","0","0",
"7 s","Religious Activities","2008 ","0","0","0",
"7 s","Religious Activities","2009 ","0","0","0",
"7 s","Religious Activities","2010 ","0","0","0",
"7 s","Investors","2000 ","0","0","0",
"7 s","Investors","2001 ","1","1","0",
"7 s","Investors","2002 ","1","1","0",
"7 s","Investors","2003 ","0","0","0",
"7 s","Investors","2004 ","0","0","0",
"7 s","Investors","2005 ","0","0","0",
"7 s","Investors","2006 ","0","0","0",
"7 s","Investors","2007 ","0","0","0",
"7 s","Investors","2008 ","0","0","0",
"7 s","Investors","2009 ","0","0","0",
"7 s","Investors","2010 ","0","0","0",
"7 s","Trade and Business","2000 ","0","0","0",
"7 s","Trade and Business","2001 ","0","0","0",
"7 s","Trade and Business","2002 ","0","0","0",
"7 s","Trade and Business","2003 ","0","0","0",
"7 s","Trade and Business","2004 ","0","0","0",
"7 s","Trade and Business","2005 ","2","1","1",
"7 s","Trade and Business","2006 ","0","0","0",
"7 s","Trade and Business","2007 ","0","0","0",
"7 s","Trade and Business","2008 ","0","0","0",
"7 s","Trade and Business","2009 ","0","0","0",
"7 s","Trade and Business","2010 ","0","0","0",
"7 s","Research","2000 ","0","0","0",
"7 s","Research","2001 ","0","0","0",
"7 s","Research","2002 ","0","0","0",
"7 s","Research","2003 ","1","0","1",
"7 s","Research","2004 ","1","1","0",
"7 s","Research","2005 ","0","0","0",
"7 s","Research","2006 ","0","0","0",
"7 s","Research","2007 ","0","0","0",
"7 s","Research","2008 ","0","0","0",
"7 s","Research","2009 ","0","0","0",
"7 s","Research","2010 ","0","0","0",
"7 s","Art and Entertainment","2000 ","0","0","0",
"7 s","Art and Entertainment","2001 ","2","0","2",
"7 s","Art and Entertainment","2002 ","0","0","0",
"7 s","Art and Entertainment","2003 ","0","0","0",
"7 s","Art and Entertainment","2004 ","0","0","0",
"7 s","Art and Entertainment","2005 ","0","0","0",
"7 s","Art and Entertainment","2006 ","2","0","2",
"7 s","Art and Entertainment","2007 ","0","0","0",
"7 s","Art and Entertainment","2008 ","0","0","0",
"7 s","Art and Entertainment","2009 ","0","0","0",
"7 s","Art and Entertainment","2010 ","1","0","1",
"7 s","Art and Entertainment","2011 ","1","1","",
"7 s","Art and Entertainment","2018 ","1","1","0",
"7 s","Unskilled Employment","2000 ","0","0","0",
"7 s","Unskilled Employment","2001 ","0","0","0",
"7 s","Unskilled Employment","2002 ","0","0","0",
"7 s","Unskilled Employment","2003 ","0","0","0",
"7 s","Unskilled Employment","2004 ","0","0","0",
"7 s","Unskilled Employment","2005 ","0","0","0",
"7 s","Unskilled Employment","2006 ","0","0","0",
"7 s","Unskilled Employment","2007 ","0","0","0",
"7 s","Unskilled Employment","2008 ","0","0","0",
"7 s","Unskilled Employment","2009 ","0","0","0",
"7 s","Unskilled Employment","2010 ","0","0","0",
"7 s","Visiting and Joining Family","2000 ","53","34","19",
"7 s","Visiting and Joining Family","2001 ","54","27","27",
"7 s","Visiting and Joining Family","2002 ","60","34","26",
"7 s","Visiting and Joining Family","2003 ","61","32","29",
"7 s","Visiting and Joining Family","2004 ","47","32","15",
"7 s","Visiting and Joining Family","2005 ","43","16","27",
"7 s","Visiting and Joining Family","2006 ","54","27","27",
"7 s","Visiting and Joining Family","2007 ","72","35","37",
"7 s","Visiting and Joining Family","2008 ","73","33","40",
"7 s","Visiting and Joining Family","2009 ","62","28","34",
"7 s","Visiting and Joining Family","2010 ","76","42","34",
"7 s","Visiting and Joining Family","2011 ","43","23","20",
"7 s","Visiting and Joining Family","2012 ","17","7","10",
"7 s","Visiting and Joining Family","2013 ","19","12","7",
"7 s","Visiting and Joining Family","2014 ","21","9","12",
"7 s","Visiting and Joining Family","2015 ","53","25","28",
"7 s","Visiting and Joining Family","2016 ","110","51","59",
"7 s","Visiting and Joining Family","2017 ","139","77","62",
"7 s","Visiting and Joining Family","2018 ","168","83","85",
"7 s","Visiting and Joining Family","2019 ","214","93","121",
"7 s","Overseas Koreans","2000 ","6","1","5",
"7 s","Overseas Koreans","2001 ","6","3","3",
"7 s","Overseas Koreans","2002 ","6","2","4",
"7 s","Overseas Koreans","2003 ","5","3","2",
"7 s","Overseas Koreans","2004 ","6","3","3",
"7 s","Overseas Koreans","2005 ","2","1","1",
"7 s","Overseas Koreans","2006 ","3","0","3",
"7 s","Overseas Koreans","2007 ","8","5","3",
"7 s","Overseas Koreans","2008 ","2","1","1",
"7 s","Overseas Koreans","2009 ","4","1","3",
"7 s","Overseas Koreans","2010 ","4","3","1",
"7 s","Overseas Koreans","2011 ","7","4","3",
"7 s","Overseas Koreans","2012 ","10","4","6",
"7 s","Overseas Koreans","2013 ","8","5","3",
"7 s","Overseas Koreans","2014 ","11","6","5",
"7 s","Overseas Koreans","2015 ","8","5","3",
"7 s","Overseas Koreans","2016 ","17","8","9",
"7 s","Overseas Koreans","2017 ","18","9","9",
"7 s","Overseas Koreans","2018 ","15","9","6",
"7 s","Overseas Koreans","2019 ","11","8","3",
"7 s","Permanent Residence","2000 ","0","0","0",
"7 s","Permanent Residence","2001 ","0","0","0",
"7 s","Permanent Residence","2002 ","0","0","0",
"7 s","Permanent Residence","2003 ","2","2","0",
"7 s","Permanent Residence","2004 ","3","1","2",
"7 s","Permanent Residence","2005 ","2","1","1",
"7 s","Permanent Residence","2006 ","0","0","0",
"7 s","Permanent Residence","2007 ","2","1","1",
"7 s","Permanent Residence","2008 ","2","2","0",
"7 s","Permanent Residence","2009 ","3","3","0",
"7 s","Permanent Residence","2010 ","0","0","0",
"7 s","Permanent Residence","2012 ","4","1","3",
"7 s","Permanent Residence","2013 ","3","0","3",
"7 s","Permanent Residence","2015 ","1","1","0",
"7 s","Permanent Residence","2016 ","5","4","1",
"7 s","Permanent Residence","2017 ","3","2","1",
"7 s","Permanent Residence","2018 ","8","4","4",
"7 s","Permanent Residence","2019 ","8","3","5",
"8 s","Total","2000 ","320","171","149",
"8 s","Total","2001 ","378","202","176",
"8 s","Total","2002 ","356","194","162",
"8 s","Total","2003 ","351","180","171",
"8 s","Total","2004 ","364","185","179",
"8 s","Total","2005 ","439","217","222",
"8 s","Total","2006 ","376","202","174",
"8 s","Total","2007 ","376","184","192",
"8 s","Total","2008 ","417","197","220",
"8 s","Total","2009 ","426","200","226",
"8 s","Total","2010 ","473","241","232",
"8 s","Total","2011 ","566","284","282",
"8 s","Total","2012 ","613","291","322",
"8 s","Total","2013 ","634","329","305",
"8 s","Total","2014 ","664","338","326",
"8 s","Total","2015 ","698","343","355",
"8 s","Total","2016 ","820","434","386",
"8 s","Total","2017 ","735","384","351",
"8 s","Total","2018 ","861","398","463",
"8 s","Total","2019 ","852","432","420",
"8 s","Sightseeing Pass","2000 ","91","50","41",
"8 s","Sightseeing Pass","2001 ","113","62","51",
"8 s","Sightseeing Pass","2002 ","111","63","48",
"8 s","Sightseeing Pass","2003 ","113","49","64",
"8 s","Sightseeing Pass","2004 ","124","67","57",
"8 s","Sightseeing Pass","2005 ","137","63","74",
"8 s","Sightseeing Pass","2006 ","118","72","46",
"8 s","Sightseeing Pass","2007 ","120","65","55",
"8 s","Sightseeing Pass","2008 ","150","71","79",
"8 s","Sightseeing Pass","2009 ","189","89","100",
"8 s","Sightseeing Pass","2010 ","182","102","80",
"8 s","Sightseeing Pass","2011 ","269","140","129",
"8 s","Sightseeing Pass","2012 ","314","150","164",
"8 s","Sightseeing Pass","2013 ","270","142","128",
"8 s","Sightseeing Pass","2014 ","291","144","147",
"8 s","Sightseeing Pass","2015 ","248","120","128",
"8 s","Sightseeing Pass","2016 ","223","115","108",
"8 s","Sightseeing Pass","2017 ","170","86","84",
"8 s","Sightseeing Pass","2018 ","217","99","118",
"8 s","Sightseeing Pass","2019 ","192","97","95",
"8 s","Short-term Business","2000 ","2","0","2",
"8 s","Short-term Business","2001 ","2","0","2",
"8 s","Short-term Business","2002 ","1","0","1",
"8 s","Short-term Business","2003 ","2","2","0",
"8 s","Short-term Business","2004 ","2","1","1",
"8 s","Short-term Business","2005 ","1","0","1",
"8 s","Short-term Business","2006 ","1","1","0",
"8 s","Short-term Business","2007 ","2","0","2",
"8 s","Short-term Business","2008 ","0","0","0",
"8 s","Short-term Business","2009 ","0","0","0",
"8 s","Short-term Business","2010 ","1","1","0",
"8 s","Short-term Visitors","2000 ","71","39","32",
"8 s","Short-term Visitors","2001 ","84","47","37",
"8 s","Short-term Visitors","2002 ","73","37","36",
"8 s","Short-term Visitors","2003 ","74","46","28",
"8 s","Short-term Visitors","2004 ","66","39","27",
"8 s","Short-term Visitors","2005 ","79","42","37",
"8 s","Short-term Visitors","2006 ","68","31","37",
"8 s","Short-term Visitors","2007 ","80","35","45",
"8 s","Short-term Visitors","2008 ","122","59","63",
"8 s","Short-term Visitors","2009 ","76","36","40",
"8 s","Short-term Visitors","2010 ","98","50","48",
"8 s","Short-term Visitors","2011 ","118","59","59",
"8 s","Short-term Visitors","2012 ","167","80","87",
"8 s","Short-term Visitors","2013 ","187","87","100",
"8 s","Short-term Visitors","2014 ","201","96","105",
"8 s","Short-term Visitors","2015 ","277","128","149",
"8 s","Short-term Visitors","2016 ","312","167","145",
"8 s","Short-term Visitors","2017 ","265","134","131",
"8 s","Short-term Visitors","2018 ","254","119","135",
"8 s","Short-term Visitors","2019 ","227","91","136",
"8 s","Short-term Employment","2000 ","0","0","0",
"8 s","Short-term Employment","2001 ","0","0","0",
"8 s","Short-term Employment","2002 ","0","0","0",
"8 s","Short-term Employment","2003 ","0","0","0",
"8 s","Short-term Employment","2004 ","0","0","0",
"8 s","Short-term Employment","2005 ","0","0","0",
"8 s","Short-term Employment","2006 ","1","1","0",
"8 s","Short-term Employment","2007 ","2","0","2",
"8 s","Short-term Employment","2008 ","0","0","0",
"8 s","Short-term Employment","2009 ","0","0","0",
"8 s","Short-term Employment","2010 ","0","0","0",
"8 s","Job Seeking","2000 ","0","0","0",
"8 s","Job Seeking","2001 ","0","0","0",
"8 s","Job Seeking","2002 ","0","0","0",
"8 s","Job Seeking","2003 ","0","0","0",
"8 s","Job Seeking","2004 ","0","0","0",
"8 s","Job Seeking","2005 ","0","0","0",
"8 s","Job Seeking","2006 ","0","0","0",
"8 s","Job Seeking","2007 ","0","0","0",
"8 s","Job Seeking","2008 ","0","0","0",
"8 s","Job Seeking","2009 ","0","0","0",
"8 s","Job Seeking","2010 ","0","0","0",
"8 s","study","2000 ","0","0","0",
"8 s","study","2001 ","0","0","0",
"8 s","study","2002 ","1","1","0",
"8 s","study","2003 ","0","0","0",
"8 s","study","2004 ","1","1","0",
"8 s","study","2005 ","0","0","0",
"8 s","study","2006 ","0","0","0",
"8 s","study","2007 ","0","0","0",
"8 s","study","2008 ","0","0","0",
"8 s","study","2009 ","0","0","0",
"8 s","study","2010 ","0","0","0",
"8 s","General Trainees","2000 ","0","0","0",
"8 s","General Trainees","2001 ","1","0","1",
"8 s","General Trainees","2002 ","0","0","0",
"8 s","General Trainees","2003 ","0","0","0",
"8 s","General Trainees","2004 ","0","0","0",
"8 s","General Trainees","2005 ","0","0","0",
"8 s","General Trainees","2006 ","0","0","0",
"8 s","General Trainees","2007 ","0","0","0",
"8 s","General Trainees","2008 ","0","0","0",
"8 s","General Trainees","2009 ","0","0","0",
"8 s","General Trainees","2010 ","0","0","0",
"8 s","General Trainees","2011 ","1","","1",
"8 s","General Trainees","2014 ","1","1","0",
"8 s","General Trainees","2016 ","1","1","0",
"8 s","General Trainees","2017 ","1","0","1",
"8 s","General Trainees","2018 ","1","0","1",
"8 s","General Trainees","2019 ","1","1","0",
"8 s","Religious Activities","2000 ","0","0","0",
"8 s","Religious Activities","2001 ","0","0","0",
"8 s","Religious Activities","2002 ","0","0","0",
"8 s","Religious Activities","2003 ","0","0","0",
"8 s","Religious Activities","2004 ","0","0","0",
"8 s","Religious Activities","2005 ","0","0","0",
"8 s","Religious Activities","2006 ","1","1","0",
"8 s","Religious Activities","2007 ","0","0","0",
"8 s","Religious Activities","2008 ","1","1","0",
"8 s","Religious Activities","2009 ","0","0","0",
"8 s","Religious Activities","2010 ","0","0","0",
"8 s","Investors","2000 ","0","0","0",
"8 s","Investors","2001 ","0","0","0",
"8 s","Investors","2002 ","0","0","0",
"8 s","Investors","2003 ","0","0","0",
"8 s","Investors","2004 ","0","0","0",
"8 s","Investors","2005 ","0","0","0",
"8 s","Investors","2006 ","1","1","0",
"8 s","Investors","2007 ","0","0","0",
"8 s","Investors","2008 ","0","0","0",
"8 s","Investors","2009 ","0","0","0",
"8 s","Investors","2010 ","0","0","0",
"8 s","Trade and Business","2000 ","0","0","0",
"8 s","Trade and Business","2001 ","0","0","0",
"8 s","Trade and Business","2002 ","0","0","0",
"8 s","Trade and Business","2003 ","0","0","0",
"8 s","Trade and Business","2004 ","0","0","0",
"8 s","Trade and Business","2005 ","0","0","0",
"8 s","Trade and Business","2006 ","0","0","0",
"8 s","Trade and Business","2007 ","0","0","0",
"8 s","Trade and Business","2008 ","0","0","0",
"8 s","Trade and Business","2009 ","0","0","0",
"8 s","Trade and Business","2010 ","0","0","0",
"8 s","Research","2000 ","0","0","0",
"8 s","Research","2001 ","0","0","0",
"8 s","Research","2002 ","0","0","0",
"8 s","Research","2003 ","0","0","0",
"8 s","Research","2004 ","0","0","0",
"8 s","Research","2005 ","0","0","0",
"8 s","Research","2006 ","1","1","0",
"8 s","Research","2007 ","0","0","0",
"8 s","Research","2008 ","0","0","0",
"8 s","Research","2009 ","0","0","0",
"8 s","Research","2010 ","0","0","0",
"8 s","Art and Entertainment","2000 ","0","0","0",
"8 s","Art and Entertainment","2001 ","0","0","0",
"8 s","Art and Entertainment","2002 ","0","0","0",
"8 s","Art and Entertainment","2003 ","0","0","0",
"8 s","Art and Entertainment","2004 ","2","0","2",
"8 s","Art and Entertainment","2005 ","1","0","1",
"8 s","Art and Entertainment","2006 ","2","0","2",
"8 s","Art and Entertainment","2007 ","1","0","1",
"8 s","Art and Entertainment","2008 ","1","1","0",
"8 s","Art and Entertainment","2009 ","1","0","1",
"8 s","Art and Entertainment","2010 ","0","0","0",
"8 s","Art and Entertainment","2011 ","1","1","",
"8 s","Art and Entertainment","2014 ","1","0","1",
"8 s","Art and Entertainment","2015 ","2","2","0",
"8 s","Art and Entertainment","2017 ","1","1","0",
"8 s","Art and Entertainment","2019 ","1","0","1",
"8 s","Unskilled Employment","2000 ","0","0","0",
"8 s","Unskilled Employment","2001 ","0","0","0",
"8 s","Unskilled Employment","2002 ","0","0","0",
"8 s","Unskilled Employment","2003 ","0","0","0",
"8 s","Unskilled Employment","2004 ","0","0","0",
"8 s","Unskilled Employment","2005 ","0","0","0",
"8 s","Unskilled Employment","2006 ","0","0","0",
"8 s","Unskilled Employment","2007 ","1","1","0",
"8 s","Unskilled Employment","2008 ","0","0","0",
"8 s","Unskilled Employment","2009 ","0","0","0",
"8 s","Unskilled Employment","2010 ","0","0","0",
"8 s","Visiting and Joining Family","2000 ","50","28","22",
"8 s","Visiting and Joining Family","2001 ","58","28","30",
"8 s","Visiting and Joining Family","2002 ","59","26","33",
"8 s","Visiting and Joining Family","2003 ","62","28","34",
"8 s","Visiting and Joining Family","2004 ","52","21","31",
"8 s","Visiting and Joining Family","2005 ","51","24","27",
"8 s","Visiting and Joining Family","2006 ","47","25","22",
"8 s","Visiting and Joining Family","2007 ","59","30","29",
"8 s","Visiting and Joining Family","2008 ","63","26","37",
"8 s","Visiting and Joining Family","2009 ","63","35","28",
"8 s","Visiting and Joining Family","2010 ","99","50","49",
"8 s","Visiting and Joining Family","2011 ","29","13","16",
"8 s","Visiting and Joining Family","2012 ","12","8","4",
"8 s","Visiting and Joining Family","2013 ","13","8","5",
"8 s","Visiting and Joining Family","2014 ","27","16","11",
"8 s","Visiting and Joining Family","2015 ","25","12","13",
"8 s","Visiting and Joining Family","2016 ","111","60","51",
"8 s","Visiting and Joining Family","2017 ","134","67","67",
"8 s","Visiting and Joining Family","2018 ","165","74","91",
"8 s","Visiting and Joining Family","2019 ","198","108","90",
"8 s","Overseas Koreans","2000 ","8","5","3",
"8 s","Overseas Koreans","2001 ","9","4","5",
"8 s","Overseas Koreans","2002 ","5","2","3",
"8 s","Overseas Koreans","2003 ","5","3","2",
"8 s","Overseas Koreans","2004 ","4","0","4",
"8 s","Overseas Koreans","2005 ","4","2","2",
"8 s","Overseas Koreans","2006 ","9","6","3",
"8 s","Overseas Koreans","2007 ","4","2","2",
"8 s","Overseas Koreans","2008 ","3","2","1",
"8 s","Overseas Koreans","2009 ","5","2","3",
"8 s","Overseas Koreans","2010 ","7","2","5",
"8 s","Overseas Koreans","2011 ","11","8","3",
"8 s","Overseas Koreans","2012 ","11","5","6",
"8 s","Overseas Koreans","2013 ","10","6","4",
"8 s","Overseas Koreans","2014 ","5","3","2",
"8 s","Overseas Koreans","2015 ","13","8","5",
"8 s","Overseas Koreans","2016 ","13","9","4",
"8 s","Overseas Koreans","2017 ","10","7","3",
"8 s","Overseas Koreans","2018 ","23","8","15",
"8 s","Overseas Koreans","2019 ","20","10","10",
"8 s","Permanent Residence","2000 ","0","0","0",
"8 s","Permanent Residence","2001 ","0","0","0",
"8 s","Permanent Residence","2002 ","0","0","0",
"8 s","Permanent Residence","2003 ","1","1","0",
"8 s","Permanent Residence","2004 ","0","0","0",
"8 s","Permanent Residence","2005 ","4","4","0",
"8 s","Permanent Residence","2006 ","2","2","0",
"8 s","Permanent Residence","2007 ","1","1","0",
"8 s","Permanent Residence","2008 ","1","0","1",
"8 s","Permanent Residence","2009 ","3","3","0",
"8 s","Permanent Residence","2010 ","2","2","0",
"8 s","Permanent Residence","2011 ","1","1","",
"8 s","Permanent Residence","2012 ","1","1","",
"8 s","Permanent Residence","2013 ","1","1","0",
"8 s","Permanent Residence","2015 ","3","1","2",
"8 s","Permanent Residence","2016 ","4","2","2",
"8 s","Permanent Residence","2017 ","2","1","1",
"8 s","Permanent Residence","2018 ","1","1","0",
"8 s","Permanent Residence","2019 ","7","4","3",
"9 s","Total","2000 ","345","167","178",
"9 s","Total","2001 ","317","171","146",
"9 s","Total","2002 ","372","185","187",
"9 s","Total","2003 ","335","177","158",
"9 s","Total","2004 ","333","171","162",
"9 s","Total","2005 ","382","187","195",
"9 s","Total","2006 ","341","179","162",
"9 s","Total","2007 ","348","175","173",
"9 s","Total","2008 ","383","204","179",
"9 s","Total","2009 ","403","204","199",
"9 s","Total","2010 ","446","219","227",
"9 s","Total","2011 ","517","274","243",
"9 s","Total","2012 ","541","271","270",
"9 s","Total","2013 ","591","303","288",
"9 s","Total","2014 ","669","311","358",
"9 s","Total","2015 ","639","321","318",
"9 s","Total","2016 ","759","365","394",
"9 s","Total","2017 ","800","397","403",
"9 s","Total","2018 ","796","408","388",
"9 s","Total","2019 ","768","398","370",
"9 s","Sightseeing Pass","2000 ","89","44","45",
"9 s","Sightseeing Pass","2001 ","89","52","37",
"9 s","Sightseeing Pass","2002 ","107","58","49",
"9 s","Sightseeing Pass","2003 ","115","67","48",
"9 s","Sightseeing Pass","2004 ","104","54","50",
"9 s","Sightseeing Pass","2005 ","117","63","54",
"9 s","Sightseeing Pass","2006 ","110","56","54",
"9 s","Sightseeing Pass","2007 ","93","42","51",
"9 s","Sightseeing Pass","2008 ","121","73","48",
"9 s","Sightseeing Pass","2009 ","168","90","78",
"9 s","Sightseeing Pass","2010 ","181","92","89",
"9 s","Sightseeing Pass","2011 ","246","132","114",
"9 s","Sightseeing Pass","2012 ","268","140","128",
"9 s","Sightseeing Pass","2013 ","267","138","129",
"9 s","Sightseeing Pass","2014 ","288","132","156",
"9 s","Sightseeing Pass","2015 ","217","109","108",
"9 s","Sightseeing Pass","2016 ","197","89","108",
"9 s","Sightseeing Pass","2017 ","211","104","107",
"9 s","Sightseeing Pass","2018 ","206","93","113",
"9 s","Sightseeing Pass","2019 ","166","101","65",
"9 s","Short-term Business","2000 ","7","7","0",
"9 s","Short-term Business","2001 ","8","3","5",
"9 s","Short-term Business","2002 ","1","0","1",
"9 s","Short-term Business","2003 ","5","1","4",
"9 s","Short-term Business","2004 ","2","1","1",
"9 s","Short-term Business","2005 ","1","1","0",
"9 s","Short-term Business","2006 ","2","1","1",
"9 s","Short-term Business","2007 ","1","1","0",
"9 s","Short-term Business","2008 ","1","1","0",
"9 s","Short-term Business","2009 ","0","0","0",
"9 s","Short-term Business","2010 ","1","0","1",
"9 s","Short-term Visitors","2000 ","76","40","36",
"9 s","Short-term Visitors","2001 ","74","41","33",
"9 s","Short-term Visitors","2002 ","75","34","41",
"9 s","Short-term Visitors","2003 ","61","30","31",
"9 s","Short-term Visitors","2004 ","58","29","29",
"9 s","Short-term Visitors","2005 ","67","28","39",
"9 s","Short-term Visitors","2006 ","64","31","33",
"9 s","Short-term Visitors","2007 ","84","45","39",
"9 s","Short-term Visitors","2008 ","93","50","43",
"9 s","Short-term Visitors","2009 ","76","33","43",
"9 s","Short-term Visitors","2010 ","75","31","44",
"9 s","Short-term Visitors","2011 ","102","55","47",
"9 s","Short-term Visitors","2012 ","148","73","75",
"9 s","Short-term Visitors","2013 ","173","93","80",
"9 s","Short-term Visitors","2014 ","196","96","100",
"9 s","Short-term Visitors","2015 ","259","117","142",
"9 s","Short-term Visitors","2016 ","313","150","163",
"9 s","Short-term Visitors","2017 ","305","161","144",
"9 s","Short-term Visitors","2018 ","236","115","121",
"9 s","Short-term Visitors","2019 ","228","119","109",
"9 s","Short-term Employment","2000 ","0","0","0",
"9 s","Short-term Employment","2001 ","0","0","0",
"9 s","Short-term Employment","2002 ","0","0","0",
"9 s","Short-term Employment","2003 ","1","0","1",
"9 s","Short-term Employment","2004 ","2","1","1",
"9 s","Short-term Employment","2005 ","0","0","0",
"9 s","Short-term Employment","2006 ","0","0","0",
"9 s","Short-term Employment","2007 ","2","0","2",
"9 s","Short-term Employment","2008 ","0","0","0",
"9 s","Short-term Employment","2009 ","1","1","0",
"9 s","Short-term Employment","2010 ","0","0","0",
"9 s","Job Seeking","2000 ","0","0","0",
"9 s","Job Seeking","2001 ","0","0","0",
"9 s","Job Seeking","2002 ","0","0","0",
"9 s","Job Seeking","2003 ","0","0","0",
"9 s","Job Seeking","2004 ","0","0","0",
"9 s","Job Seeking","2005 ","0","0","0",
"9 s","Job Seeking","2006 ","0","0","0",
"9 s","Job Seeking","2007 ","0","0","0",
"9 s","Job Seeking","2008 ","0","0","0",
"9 s","Job Seeking","2009 ","0","0","0",
"9 s","Job Seeking","2010 ","0","0","0",
"9 s","study","2000 ","0","0","0",
"9 s","study","2001 ","0","0","0",
"9 s","study","2002 ","0","0","0",
"9 s","study","2003 ","0","0","0",
"9 s","study","2004 ","0","0","0",
"9 s","study","2005 ","0","0","0",
"9 s","study","2006 ","0","0","0",
"9 s","study","2007 ","0","0","0",
"9 s","study","2008 ","0","0","0",
"9 s","study","2009 ","0","0","0",
"9 s","study","2010 ","0","0","0",
"9 s","General Trainees","2000 ","0","0","0",
"9 s","General Trainees","2001 ","0","0","0",
"9 s","General Trainees","2002 ","0","0","0",
"9 s","General Trainees","2003 ","0","0","0",
"9 s","General Trainees","2004 ","0","0","0",
"9 s","General Trainees","2005 ","0","0","0",
"9 s","General Trainees","2006 ","1","0","1",
"9 s","General Trainees","2007 ","3","2","1",
"9 s","General Trainees","2008 ","1","0","1",
"9 s","General Trainees","2009 ","0","0","0",
"9 s","General Trainees","2010 ","2","1","1",
"9 s","General Trainees","2011 ","1","","1",
"9 s","General Trainees","2013 ","2","2","0",
"9 s","General Trainees","2014 ","1","0","1",
"9 s","General Trainees","2015 ","3","2","1",
"9 s","General Trainees","2017 ","1","0","1",
"9 s","General Trainees","2018 ","3","1","2",
"9 s","General Trainees","2019 ","2","0","2",
"9 s","Religious Activities","2000 ","0","0","0",
"9 s","Religious Activities","2001 ","0","0","0",
"9 s","Religious Activities","2002 ","0","0","0",
"9 s","Religious Activities","2003 ","0","0","0",
"9 s","Religious Activities","2004 ","0","0","0",
"9 s","Religious Activities","2005 ","0","0","0",
"9 s","Religious Activities","2006 ","0","0","0",
"9 s","Religious Activities","2007 ","0","0","0",
"9 s","Religious Activities","2008 ","1","1","0",
"9 s","Religious Activities","2009 ","0","0","0",
"9 s","Religious Activities","2010 ","0","0","0",
"9 s","Investors","2000 ","0","0","0",
"9 s","Investors","2001 ","0","0","0",
"9 s","Investors","2002 ","0","0","0",
"9 s","Investors","2003 ","0","0","0",
"9 s","Investors","2004 ","0","0","0",
"9 s","Investors","2005 ","0","0","0",
"9 s","Investors","2006 ","0","0","0",
"9 s","Investors","2007 ","0","0","0",
"9 s","Investors","2008 ","0","0","0",
"9 s","Investors","2009 ","0","0","0",
"9 s","Investors","2010 ","0","0","0",
"9 s","Trade and Business","2000 ","0","0","0",
"9 s","Trade and Business","2001 ","0","0","0",
"9 s","Trade and Business","2002 ","0","0","0",
"9 s","Trade and Business","2003 ","0","0","0",
"9 s","Trade and Business","2004 ","0","0","0",
"9 s","Trade and Business","2005 ","0","0","0",
"9 s","Trade and Business","2006 ","0","0","0",
"9 s","Trade and Business","2007 ","0","0","0",
"9 s","Trade and Business","2008 ","0","0","0",
"9 s","Trade and Business","2009 ","0","0","0",
"9 s","Trade and Business","2010 ","0","0","0",
"9 s","Research","2000 ","0","0","0",
"9 s","Research","2001 ","0","0","0",
"9 s","Research","2002 ","0","0","0",
"9 s","Research","2003 ","0","0","0",
"9 s","Research","2004 ","0","0","0",
"9 s","Research","2005 ","0","0","0",
"9 s","Research","2006 ","0","0","0",
"9 s","Research","2007 ","0","0","0",
"9 s","Research","2008 ","0","0","0",
"9 s","Research","2009 ","0","0","0",
"9 s","Research","2010 ","0","0","0",
"9 s","Art and Entertainment","2000 ","1","1","0",
"9 s","Art and Entertainment","2001 ","0","0","0",
"9 s","Art and Entertainment","2002 ","1","1","0",
"9 s","Art and Entertainment","2003 ","2","1","1",
"9 s","Art and Entertainment","2004 ","1","0","1",
"9 s","Art and Entertainment","2005 ","2","1","1",
"9 s","Art and Entertainment","2006 ","5","2","3",
"9 s","Art and Entertainment","2007 ","1","0","1",
"9 s","Art and Entertainment","2008 ","3","1","2",
"9 s","Art and Entertainment","2009 ","1","0","1",
"9 s","Art and Entertainment","2010 ","0","0","0",
"9 s","Art and Entertainment","2011 ","6","2","4",
"9 s","Art and Entertainment","2013 ","2","1","1",
"9 s","Art and Entertainment","2016 ","1","1","0",
"9 s","Art and Entertainment","2017 ","1","0","1",
"9 s","Art and Entertainment","2018 ","4","1","3",
"9 s","Art and Entertainment","2019 ","2","1","1",
"9 s","Unskilled Employment","2000 ","0","0","0",
"9 s","Unskilled Employment","2001 ","0","0","0",
"9 s","Unskilled Employment","2002 ","0","0","0",
"9 s","Unskilled Employment","2003 ","0","0","0",
"9 s","Unskilled Employment","2004 ","0","0","0",
"9 s","Unskilled Employment","2005 ","1","1","0",
"9 s","Unskilled Employment","2006 ","0","0","0",
"9 s","Unskilled Employment","2007 ","0","0","0",
"9 s","Unskilled Employment","2008 ","0","0","0",
"9 s","Unskilled Employment","2009 ","0","0","0",
"9 s","Unskilled Employment","2010 ","0","0","0",
"9 s","Visiting and Joining Family","2000 ","54","27","27",
"9 s","Visiting and Joining Family","2001 ","45","30","15",
"9 s","Visiting and Joining Family","2002 ","69","33","36",
"9 s","Visiting and Joining Family","2003 ","53","31","22",
"9 s","Visiting and Joining Family","2004 ","48","23","25",
"9 s","Visiting and Joining Family","2005 ","35","14","21",
"9 s","Visiting and Joining Family","2006 ","43","22","21",
"9 s","Visiting and Joining Family","2007 ","58","23","35",
"9 s","Visiting and Joining Family","2008 ","69","30","39",
"9 s","Visiting and Joining Family","2009 ","72","37","35",
"9 s","Visiting and Joining Family","2010 ","89","44","45",
"9 s","Visiting and Joining Family","2011 ","36","20","16",
"9 s","Visiting and Joining Family","2012 ","8","4","4",
"9 s","Visiting and Joining Family","2013 ","11","9","2",
"9 s","Visiting and Joining Family","2014 ","22","11","11",
"9 s","Visiting and Joining Family","2015 ","29","21","8",
"9 s","Visiting and Joining Family","2016 ","92","39","53",
"9 s","Visiting and Joining Family","2017 ","134","68","66",
"9 s","Visiting and Joining Family","2018 ","156","93","63",
"9 s","Visiting and Joining Family","2019 ","194","91","103",
"9 s","Overseas Koreans","2000 ","3","1","2",
"9 s","Overseas Koreans","2001 ","2","1","1",
"9 s","Overseas Koreans","2002 ","4","2","2",
"9 s","Overseas Koreans","2003 ","6","3","3",
"9 s","Overseas Koreans","2004 ","4","2","2",
"9 s","Overseas Koreans","2005 ","5","4","1",
"9 s","Overseas Koreans","2006 ","7","3","4",
"9 s","Overseas Koreans","2007 ","4","4","0",
"9 s","Overseas Koreans","2008 ","7","5","2",
"9 s","Overseas Koreans","2009 ","3","2","1",
"9 s","Overseas Koreans","2010 ","4","2","2",
"9 s","Overseas Koreans","2011 ","10","6","4",
"9 s","Overseas Koreans","2012 ","12","6","6",
"9 s","Overseas Koreans","2013 ","4","1","3",
"9 s","Overseas Koreans","2014 ","12","7","5",
"9 s","Overseas Koreans","2015 ","12","8","4",
"9 s","Overseas Koreans","2016 ","21","10","11",
"9 s","Overseas Koreans","2017 ","12","7","5",
"9 s","Overseas Koreans","2018 ","13","10","3",
"9 s","Overseas Koreans","2019 ","13","8","5",
"9 s","Permanent Residence","2000 ","0","0","0",
"9 s","Permanent Residence","2001 ","0","0","0",
"9 s","Permanent Residence","2002 ","0","0","0",
"9 s","Permanent Residence","2003 ","0","0","0",
"9 s","Permanent Residence","2004 ","3","1","2",
"9 s","Permanent Residence","2005 ","2","2","0",
"9 s","Permanent Residence","2006 ","0","0","0",
"9 s","Permanent Residence","2007 ","2","1","1",
"9 s","Permanent Residence","2008 ","7","4","3",
"9 s","Permanent Residence","2009 ","2","2","0",
"9 s","Permanent Residence","2010 ","5","4","1",
"9 s","Permanent Residence","2011 ","2","1","1",
"9 s","Permanent Residence","2012 ","1","1","",
"9 s","Permanent Residence","2013 ","4","1","3",
"9 s","Permanent Residence","2015 ","3","3","0",
"9 s","Permanent Residence","2017 ","3","0","3",
"9 s","Permanent Residence","2018 ","1","0","1",
"9 s","Permanent Residence","2019 ","3","1","2",
"9 s","Marriage Immigration","2013 ","1","0","1",
"10 s","Total","2000 ","339","185","154",
"10 s","Total","2001 ","374","181","193",
"10 s","Total","2002 ","356","179","177",
"10 s","Total","2003 ","304","153","151",
"10 s","Total","2004 ","328","161","167",
"10 s","Total","2005 ","420","204","216",
"10 s","Total","2006 ","355","156","199",
"10 s","Total","2007 ","324","164","160",
"10 s","Total","2008 ","317","155","162",
"10 s","Total","2009 ","373","186","187",
"10 s","Total","2010 ","433","211","222",
"10 s","Total","2011 ","501","254","247",
"10 s","Total","2012 ","498","243","255",
"10 s","Total","2013 ","520","251","269",
"10 s","Total","2014 ","545","274","271",
"10 s","Total","2015 ","660","325","335",
"10 s","Total","2016 ","705","342","363",
"10 s","Total","2017 ","731","380","351",
"10 s","Total","2018 ","805","416","389",
"10 s","Total","2019 ","796","383","413",
"10 s","Sightseeing Pass","2000 ","99","55","44",
"10 s","Sightseeing Pass","2001 ","110","58","52",
"10 s","Sightseeing Pass","2002 ","110","57","53",
"10 s","Sightseeing Pass","2003 ","94","48","46",
"10 s","Sightseeing Pass","2004 ","114","51","63",
"10 s","Sightseeing Pass","2005 ","145","68","77",
"10 s","Sightseeing Pass","2006 ","110","54","56",
"10 s","Sightseeing Pass","2007 ","99","44","55",
"10 s","Sightseeing Pass","2008 ","117","57","60",
"10 s","Sightseeing Pass","2009 ","163","82","81",
"10 s","Sightseeing Pass","2010 ","163","82","81",
"10 s","Sightseeing Pass","2011 ","233","119","114",
"10 s","Sightseeing Pass","2012 ","246","125","121",
"10 s","Sightseeing Pass","2013 ","238","123","115",
"10 s","Sightseeing Pass","2014 ","219","116","103",
"10 s","Sightseeing Pass","2015 ","238","110","128",
"10 s","Sightseeing Pass","2016 ","172","81","91",
"10 s","Sightseeing Pass","2017 ","185","96","89",
"10 s","Sightseeing Pass","2018 ","206","100","106",
"10 s","Sightseeing Pass","2019 ","179","88","91",
"10 s","Short-term Business","2000 ","2","2","0",
"10 s","Short-term Business","2001 ","4","3","1",
"10 s","Short-term Business","2002 ","0","0","0",
"10 s","Short-term Business","2003 ","0","0","0",
"10 s","Short-term Business","2004 ","1","1","0",
"10 s","Short-term Business","2005 ","1","1","0",
"10 s","Short-term Business","2006 ","2","2","0",
"10 s","Short-term Business","2007 ","2","2","0",
"10 s","Short-term Business","2008 ","0","0","0",
"10 s","Short-term Business","2009 ","0","0","0",
"10 s","Short-term Business","2010 ","1","1","0",
"10 s","Short-term Visitors","2000 ","84","48","36",
"10 s","Short-term Visitors","2001 ","83","39","44",
"10 s","Short-term Visitors","2002 ","78","38","40",
"10 s","Short-term Visitors","2003 ","69","32","37",
"10 s","Short-term Visitors","2004 ","58","29","29",
"10 s","Short-term Visitors","2005 ","62","32","30",
"10 s","Short-term Visitors","2006 ","70","29","41",
"10 s","Short-term Visitors","2007 ","72","36","36",
"10 s","Short-term Visitors","2008 ","69","34","35",
"10 s","Short-term Visitors","2009 ","55","31","24",
"10 s","Short-term Visitors","2010 ","88","38","50",
"10 s","Short-term Visitors","2011 ","100","47","53",
"10 s","Short-term Visitors","2012 ","138","64","74",
"10 s","Short-term Visitors","2013 ","127","53","74",
"10 s","Short-term Visitors","2014 ","178","90","88",
"10 s","Short-term Visitors","2015 ","270","137","133",
"10 s","Short-term Visitors","2016 ","285","132","153",
"10 s","Short-term Visitors","2017 ","279","146","133",
"10 s","Short-term Visitors","2018 ","252","125","127",
"10 s","Short-term Visitors","2019 ","238","113","125",
"10 s","Short-term Employment","2000 ","0","0","0",
"10 s","Short-term Employment","2001 ","0","0","0",
"10 s","Short-term Employment","2002 ","0","0","0",
"10 s","Short-term Employment","2003 ","0","0","0",
"10 s","Short-term Employment","2004 ","1","0","1",
"10 s","Short-term Employment","2005 ","1","1","0",
"10 s","Short-term Employment","2006 ","2","0","2",
"10 s","Short-term Employment","2007 ","3","1","2",
"10 s","Short-term Employment","2008 ","0","0","0",
"10 s","Short-term Employment","2009 ","0","0","0",
"10 s","Short-term Employment","2010 ","0","0","0",
"10 s","Job Seeking","2000 ","0","0","0",
"10 s","Job Seeking","2001 ","0","0","0",
"10 s","Job Seeking","2002 ","0","0","0",
"10 s","Job Seeking","2003 ","0","0","0",
"10 s","Job Seeking","2004 ","0","0","0",
"10 s","Job Seeking","2005 ","0","0","0",
"10 s","Job Seeking","2006 ","0","0","0",
"10 s","Job Seeking","2007 ","0","0","0",
"10 s","Job Seeking","2008 ","0","0","0",
"10 s","Job Seeking","2009 ","0","0","0",
"10 s","Job Seeking","2010 ","0","0","0",
"10 s","study","2000 ","0","0","0",
"10 s","study","2001 ","0","0","0",
"10 s","study","2002 ","0","0","0",
"10 s","study","2003 ","0","0","0",
"10 s","study","2004 ","0","0","0",
"10 s","study","2005 ","0","0","0",
"10 s","study","2006 ","0","0","0",
"10 s","study","2007 ","0","0","0",
"10 s","study","2008 ","0","0","0",
"10 s","study","2009 ","0","0","0",
"10 s","study","2010 ","0","0","0",
"10 s","General Trainees","2000 ","0","0","0",
"10 s","General Trainees","2001 ","0","0","0",
"10 s","General Trainees","2002 ","0","0","0",
"10 s","General Trainees","2003 ","2","2","0",
"10 s","General Trainees","2004 ","0","0","0",
"10 s","General Trainees","2005 ","0","0","0",
"10 s","General Trainees","2006 ","2","0","2",
"10 s","General Trainees","2007 ","3","2","1",
"10 s","General Trainees","2008 ","0","0","0",
"10 s","General Trainees","2009 ","1","1","0",
"10 s","General Trainees","2010 ","0","0","0",
"10 s","General Trainees","2011 ","1","","1",
"10 s","General Trainees","2013 ","5","1","4",
"10 s","General Trainees","2014 ","1","1","0",
"10 s","General Trainees","2015 ","1","0","1",
"10 s","General Trainees","2016 ","2","0","2",
"10 s","General Trainees","2018 ","1","1","0",
"10 s","General Trainees","2019 ","2","1","1",
"10 s","Religious Activities","2000 ","0","0","0",
"10 s","Religious Activities","2001 ","0","0","0",
"10 s","Religious Activities","2002 ","0","0","0",
"10 s","Religious Activities","2003 ","0","0","0",
"10 s","Religious Activities","2004 ","0","0","0",
"10 s","Religious Activities","2005 ","0","0","0",
"10 s","Religious Activities","2006 ","0","0","0",
"10 s","Religious Activities","2007 ","0","0","0",
"10 s","Religious Activities","2008 ","0","0","0",
"10 s","Religious Activities","2009 ","0","0","0",
"10 s","Religious Activities","2010 ","1","1","0",
"10 s","Investors","2000 ","0","0","0",
"10 s","Investors","2001 ","0","0","0",
"10 s","Investors","2002 ","0","0","0",
"10 s","Investors","2003 ","0","0","0",
"10 s","Investors","2004 ","0","0","0",
"10 s","Investors","2005 ","0","0","0",
"10 s","Investors","2006 ","0","0","0",
"10 s","Investors","2007 ","0","0","0",
"10 s","Investors","2008 ","0","0","0",
"10 s","Investors","2009 ","0","0","0",
"10 s","Investors","2010 ","0","0","0",
"10 s","Trade and Business","2000 ","0","0","0",
"10 s","Trade and Business","2001 ","0","0","0",
"10 s","Trade and Business","2002 ","0","0","0",
"10 s","Trade and Business","2003 ","0","0","0",
"10 s","Trade and Business","2004 ","0","0","0",
"10 s","Trade and Business","2005 ","0","0","0",
"10 s","Trade and Business","2006 ","0","0","0",
"10 s","Trade and Business","2007 ","0","0","0",
"10 s","Trade and Business","2008 ","0","0","0",
"10 s","Trade and Business","2009 ","0","0","0",
"10 s","Trade and Business","2010 ","0","0","0",
"10 s","Trade and Business","2017 ","1","0","1",
"10 s","Research","2000 ","0","0","0",
"10 s","Research","2001 ","0","0","0",
"10 s","Research","2002 ","0","0","0",
"10 s","Research","2003 ","0","0","0",
"10 s","Research","2004 ","2","1","1",
"10 s","Research","2005 ","0","0","0",
"10 s","Research","2006 ","0","0","0",
"10 s","Research","2007 ","0","0","0",
"10 s","Research","2008 ","0","0","0",
"10 s","Research","2009 ","0","0","0",
"10 s","Research","2010 ","0","0","0",
"10 s","Art and Entertainment","2000 ","0","0","0",
"10 s","Art and Entertainment","2001 ","5","0","5",
"10 s","Art and Entertainment","2002 ","3","1","2",
"10 s","Art and Entertainment","2003 ","0","0","0",
"10 s","Art and Entertainment","2004 ","2","0","2",
"10 s","Art and Entertainment","2005 ","5","1","4",
"10 s","Art and Entertainment","2006 ","5","1","4",
"10 s","Art and Entertainment","2007 ","0","0","0",
"10 s","Art and Entertainment","2008 ","3","1","2",
"10 s","Art and Entertainment","2009 ","2","0","2",
"10 s","Art and Entertainment","2010 ","1","0","1",
"10 s","Art and Entertainment","2011 ","9","4","5",
"10 s","Art and Entertainment","2012 ","2","","2",
"10 s","Art and Entertainment","2013 ","1","1","0",
"10 s","Art and Entertainment","2014 ","5","2","3",
"10 s","Art and Entertainment","2015 ","1","1","0",
"10 s","Art and Entertainment","2016 ","4","2","2",
"10 s","Art and Entertainment","2017 ","5","2","3",
"10 s","Art and Entertainment","2018 ","4","3","1",
"10 s","Art and Entertainment","2019 ","3","3","0",
"10 s","Unskilled Employment","2000 ","0","0","0",
"10 s","Unskilled Employment","2001 ","0","0","0",
"10 s","Unskilled Employment","2002 ","0","0","0",
"10 s","Unskilled Employment","2003 ","0","0","0",
"10 s","Unskilled Employment","2004 ","0","0","0",
"10 s","Unskilled Employment","2005 ","1","1","0",
"10 s","Unskilled Employment","2006 ","0","0","0",
"10 s","Unskilled Employment","2007 ","0","0","0",
"10 s","Unskilled Employment","2008 ","0","0","0",
"10 s","Unskilled Employment","2009 ","0","0","0",
"10 s","Unskilled Employment","2010 ","0","0","0",
"10 s","Unskilled Employment","2011 ","1","1","",
"10 s","Visiting and Joining Family","2000 ","35","15","20",
"10 s","Visiting and Joining Family","2001 ","48","17","31",
"10 s","Visiting and Joining Family","2002 ","44","22","22",
"10 s","Visiting and Joining Family","2003 ","38","18","20",
"10 s","Visiting and Joining Family","2004 ","34","17","17",
"10 s","Visiting and Joining Family","2005 ","38","24","14",
"10 s","Visiting and Joining Family","2006 ","63","20","43",
"10 s","Visiting and Joining Family","2007 ","51","26","25",
"10 s","Visiting and Joining Family","2008 ","50","15","35",
"10 s","Visiting and Joining Family","2009 ","61","31","30",
"10 s","Visiting and Joining Family","2010 ","91","41","50",
"10 s","Visiting and Joining Family","2011 ","43","23","20",
"10 s","Visiting and Joining Family","2012 ","10","5","5",
"10 s","Visiting and Joining Family","2013 ","11","3","8",
"10 s","Visiting and Joining Family","2014 ","16","8","8",
"10 s","Visiting and Joining Family","2015 ","28","17","11",
"10 s","Visiting and Joining Family","2016 ","88","43","45",
"10 s","Visiting and Joining Family","2017 ","116","60","56",
"10 s","Visiting and Joining Family","2018 ","161","92","69",
"10 s","Visiting and Joining Family","2019 ","187","89","98",
"10 s","Overseas Koreans","2000 ","7","5","2",
"10 s","Overseas Koreans","2001 ","6","4","2",
"10 s","Overseas Koreans","2002 ","2","2","0",
"10 s","Overseas Koreans","2003 ","5","3","2",
"10 s","Overseas Koreans","2004 ","1","0","1",
"10 s","Overseas Koreans","2005 ","6","1","5",
"10 s","Overseas Koreans","2006 ","7","2","5",
"10 s","Overseas Koreans","2007 ","11","6","5",
"10 s","Overseas Koreans","2008 ","8","7","1",
"10 s","Overseas Koreans","2009 ","3","1","2",
"10 s","Overseas Koreans","2010 ","8","5","3",
"10 s","Overseas Koreans","2011 ","10","6","4",
"10 s","Overseas Koreans","2012 ","11","6","5",
"10 s","Overseas Koreans","2013 ","17","8","9",
"10 s","Overseas Koreans","2014 ","5","1","4",
"10 s","Overseas Koreans","2015 ","9","4","5",
"10 s","Overseas Koreans","2016 ","19","9","10",
"10 s","Overseas Koreans","2017 ","23","13","10",
"10 s","Overseas Koreans","2018 ","20","5","15",
"10 s","Overseas Koreans","2019 ","20","7","13",
"10 s","Permanent Residence","2000 ","0","0","0",
"10 s","Permanent Residence","2001 ","0","0","0",
"10 s","Permanent Residence","2002 ","0","0","0",
"10 s","Permanent Residence","2003 ","2","0","2",
"10 s","Permanent Residence","2004 ","1","1","0",
"10 s","Permanent Residence","2005 ","4","1","3",
"10 s","Permanent Residence","2006 ","5","4","1",
"10 s","Permanent Residence","2007 ","3","1","2",
"10 s","Permanent Residence","2008 ","2","0","2",
"10 s","Permanent Residence","2009 ","4","1","3",
"10 s","Permanent Residence","2010 ","2","1","1",
"10 s","Permanent Residence","2011 ","4","3","1",
"10 s","Permanent Residence","2012 ","4","2","2",
"10 s","Permanent Residence","2013 ","5","3","2",
"10 s","Permanent Residence","2015 ","2","0","2",
"10 s","Permanent Residence","2016 ","1","1","0",
"10 s","Permanent Residence","2018 ","3","2","1",
"10 s","Permanent Residence","2019 ","7","3","4",
"11 s","Total","2000 ","355","185","170",
"11 s","Total","2001 ","368","210","158",
"11 s","Total","2002 ","314","166","148",
"11 s","Total","2003 ","347","184","163",
"11 s","Total","2004 ","339","181","158",
"11 s","Total","2005 ","379","204","175",
"11 s","Total","2006 ","359","183","176",
"11 s","Total","2007 ","352","173","179",
"11 s","Total","2008 ","316","164","152",
"11 s","Total","2009 ","364","158","206",
"11 s","Total","2010 ","397","198","199",
"11 s","Total","2011 ","463","233","230",
"11 s","Total","2012 ","501","238","263",
"11 s","Total","2013 ","484","233","251",
"11 s","Total","2014 ","535","254","281",
"11 s","Total","2015 ","563","281","282",
"11 s","Total","2016 ","589","300","289",
"11 s","Total","2017 ","593","303","290",
"11 s","Total","2018 ","680","323","357",
"11 s","Total","2019 ","767","411","356",
"11 s","Sightseeing Pass","2000 ","106","61","45",
"11 s","Sightseeing Pass","2001 ","104","56","48",
"11 s","Sightseeing Pass","2002 ","85","41","44",
"11 s","Sightseeing Pass","2003 ","112","63","49",
"11 s","Sightseeing Pass","2004 ","109","54","55",
"11 s","Sightseeing Pass","2005 ","133","65","68",
"11 s","Sightseeing Pass","2006 ","106","50","56",
"11 s","Sightseeing Pass","2007 ","112","48","64",
"11 s","Sightseeing Pass","2008 ","98","47","51",
"11 s","Sightseeing Pass","2009 ","147","66","81",
"11 s","Sightseeing Pass","2010 ","156","84","72",
"11 s","Sightseeing Pass","2011 ","186","95","91",
"11 s","Sightseeing Pass","2012 ","233","106","127",
"11 s","Sightseeing Pass","2013 ","202","98","104",
"11 s","Sightseeing Pass","2014 ","230","118","112",
"11 s","Sightseeing Pass","2015 ","206","112","94",
"11 s","Sightseeing Pass","2016 ","164","84","80",
"11 s","Sightseeing Pass","2017 ","158","73","85",
"11 s","Sightseeing Pass","2018 ","161","80","81",
"11 s","Sightseeing Pass","2019 ","155","73","82",
"11 s","Short-term Business","2000 ","4","1","3",
"11 s","Short-term Business","2001 ","4","3","1",
"11 s","Short-term Business","2002 ","1","1","0",
"11 s","Short-term Business","2003 ","5","1","4",
"11 s","Short-term Business","2004 ","2","2","0",
"11 s","Short-term Business","2005 ","2","1","1",
"11 s","Short-term Business","2006 ","0","0","0",
"11 s","Short-term Business","2007 ","2","1","1",
"11 s","Short-term Business","2008 ","2","1","1",
"11 s","Short-term Business","2009 ","1","1","0",
"11 s","Short-term Business","2010 ","0","0","0",
"11 s","Short-term Business","2011 ","1","","1",
"11 s","Short-term Visitors","2000 ","75","36","39",
"11 s","Short-term Visitors","2001 ","78","35","43",
"11 s","Short-term Visitors","2002 ","58","37","21",
"11 s","Short-term Visitors","2003 ","66","38","28",
"11 s","Short-term Visitors","2004 ","66","35","31",
"11 s","Short-term Visitors","2005 ","67","36","31",
"11 s","Short-term Visitors","2006 ","76","36","40",
"11 s","Short-term Visitors","2007 ","73","38","35",
"11 s","Short-term Visitors","2008 ","71","38","33",
"11 s","Short-term Visitors","2009 ","70","29","41",
"11 s","Short-term Visitors","2010 ","71","37","34",
"11 s","Short-term Visitors","2011 ","107","48","59",
"11 s","Short-term Visitors","2012 ","159","78","81",
"11 s","Short-term Visitors","2013 ","134","58","76",
"11 s","Short-term Visitors","2014 ","161","69","92",
"11 s","Short-term Visitors","2015 ","217","106","111",
"11 s","Short-term Visitors","2016 ","245","116","129",
"11 s","Short-term Visitors","2017 ","200","95","105",
"11 s","Short-term Visitors","2018 ","240","106","134",
"11 s","Short-term Visitors","2019 ","254","141","113",
"11 s","Short-term Employment","2000 ","0","0","0",
"11 s","Short-term Employment","2001 ","0","0","0",
"11 s","Short-term Employment","2002 ","1","0","1",
"11 s","Short-term Employment","2003 ","3","0","3",
"11 s","Short-term Employment","2004 ","5","4","1",
"11 s","Short-term Employment","2005 ","1","1","0",
"11 s","Short-term Employment","2006 ","1","1","0",
"11 s","Short-term Employment","2007 ","3","0","3",
"11 s","Short-term Employment","2008 ","2","0","2",
"11 s","Short-term Employment","2009 ","0","0","0",
"11 s","Short-term Employment","2010 ","0","0","0",
"11 s","Job Seeking","2000 ","0","0","0",
"11 s","Job Seeking","2001 ","0","0","0",
"11 s","Job Seeking","2002 ","0","0","0",
"11 s","Job Seeking","2003 ","0","0","0",
"11 s","Job Seeking","2004 ","0","0","0",
"11 s","Job Seeking","2005 ","0","0","0",
"11 s","Job Seeking","2006 ","0","0","0",
"11 s","Job Seeking","2007 ","0","0","0",
"11 s","Job Seeking","2008 ","0","0","0",
"11 s","Job Seeking","2009 ","0","0","0",
"11 s","Job Seeking","2010 ","0","0","0",
"11 s","study","2000 ","0","0","0",
"11 s","study","2001 ","0","0","0",
"11 s","study","2002 ","0","0","0",
"11 s","study","2003 ","0","0","0",
"11 s","study","2004 ","0","0","0",
"11 s","study","2005 ","0","0","0",
"11 s","study","2006 ","0","0","0",
"11 s","study","2007 ","0","0","0",
"11 s","study","2008 ","0","0","0",
"11 s","study","2009 ","0","0","0",
"11 s","study","2010 ","0","0","0",
"11 s","General Trainees","2000 ","0","0","0",
"11 s","General Trainees","2001 ","0","0","0",
"11 s","General Trainees","2002 ","1","0","1",
"11 s","General Trainees","2003 ","0","0","0",
"11 s","General Trainees","2004 ","0","0","0",
"11 s","General Trainees","2005 ","1","1","0",
"11 s","General Trainees","2006 ","1","1","0",
"11 s","General Trainees","2007 ","1","1","0",
"11 s","General Trainees","2008 ","2","1","1",
"11 s","General Trainees","2009 ","0","0","0",
"11 s","General Trainees","2010 ","2","1","1",
"11 s","General Trainees","2013 ","2","1","1",
"11 s","General Trainees","2014 ","1","1","0",
"11 s","General Trainees","2015 ","1","0","1",
"11 s","General Trainees","2016 ","1","1","0",
"11 s","General Trainees","2017 ","3","3","0",
"11 s","General Trainees","2018 ","1","1","0",
"11 s","General Trainees","2019 ","6","3","3",
"11 s","Religious Activities","2000 ","0","0","0",
"11 s","Religious Activities","2001 ","0","0","0",
"11 s","Religious Activities","2002 ","0","0","0",
"11 s","Religious Activities","2003 ","0","0","0",
"11 s","Religious Activities","2004 ","0","0","0",
"11 s","Religious Activities","2005 ","0","0","0",
"11 s","Religious Activities","2006 ","0","0","0",
"11 s","Religious Activities","2007 ","0","0","0",
"11 s","Religious Activities","2008 ","0","0","0",
"11 s","Religious Activities","2009 ","0","0","0",
"11 s","Religious Activities","2010 ","1","1","0",
"11 s","Investors","2000 ","0","0","0",
"11 s","Investors","2001 ","0","0","0",
"11 s","Investors","2002 ","0","0","0",
"11 s","Investors","2003 ","0","0","0",
"11 s","Investors","2004 ","0","0","0",
"11 s","Investors","2005 ","0","0","0",
"11 s","Investors","2006 ","0","0","0",
"11 s","Investors","2007 ","0","0","0",
"11 s","Investors","2008 ","0","0","0",
"11 s","Investors","2009 ","0","0","0",
"11 s","Investors","2010 ","0","0","0",
"11 s","Trade and Business","2000 ","0","0","0",
"11 s","Trade and Business","2001 ","0","0","0",
"11 s","Trade and Business","2002 ","0","0","0",
"11 s","Trade and Business","2003 ","0","0","0",
"11 s","Trade and Business","2004 ","0","0","0",
"11 s","Trade and Business","2005 ","0","0","0",
"11 s","Trade and Business","2006 ","1","1","0",
"11 s","Trade and Business","2007 ","0","0","0",
"11 s","Trade and Business","2008 ","0","0","0",
"11 s","Trade and Business","2009 ","0","0","0",
"11 s","Trade and Business","2010 ","0","0","0",
"11 s","Research","2000 ","0","0","0",
"11 s","Research","2001 ","0","0","0",
"11 s","Research","2002 ","0","0","0",
"11 s","Research","2003 ","0","0","0",
"11 s","Research","2004 ","0","0","0",
"11 s","Research","2005 ","0","0","0",
"11 s","Research","2006 ","0","0","0",
"11 s","Research","2007 ","0","0","0",
"11 s","Research","2008 ","0","0","0",
"11 s","Research","2009 ","0","0","0",
"11 s","Research","2010 ","0","0","0",
"11 s","Art and Entertainment","2000 ","0","0","0",
"11 s","Art and Entertainment","2001 ","10","2","8",
"11 s","Art and Entertainment","2002 ","3","0","3",
"11 s","Art and Entertainment","2003 ","3","3","0",
"11 s","Art and Entertainment","2004 ","6","3","3",
"11 s","Art and Entertainment","2005 ","9","4","5",
"11 s","Art and Entertainment","2006 ","6","4","2",
"11 s","Art and Entertainment","2007 ","6","4","2",
"11 s","Art and Entertainment","2008 ","4","0","4",
"11 s","Art and Entertainment","2009 ","7","1","6",
"11 s","Art and Entertainment","2010 ","5","2","3",
"11 s","Art and Entertainment","2011 ","13","8","5",
"11 s","Art and Entertainment","2012 ","4","","4",
"11 s","Art and Entertainment","2013 ","3","0","3",
"11 s","Art and Entertainment","2014 ","7","2","5",
"11 s","Art and Entertainment","2015 ","6","2","4",
"11 s","Art and Entertainment","2016 ","3","3","0",
"11 s","Art and Entertainment","2017 ","5","1","4",
"11 s","Art and Entertainment","2018 ","7","2","5",
"11 s","Art and Entertainment","2019 ","8","5","3",
"11 s","Unskilled Employment","2000 ","0","0","0",
"11 s","Unskilled Employment","2001 ","0","0","0",
"11 s","Unskilled Employment","2002 ","0","0","0",
"11 s","Unskilled Employment","2003 ","0","0","0",
"11 s","Unskilled Employment","2004 ","1","1","0",
"11 s","Unskilled Employment","2005 ","0","0","0",
"11 s","Unskilled Employment","2006 ","0","0","0",
"11 s","Unskilled Employment","2007 ","0","0","0",
"11 s","Unskilled Employment","2008 ","0","0","0",
"11 s","Unskilled Employment","2009 ","2","2","0",
"11 s","Unskilled Employment","2010 ","0","0","0",
"11 s","Visiting and Joining Family","2000 ","43","15","28",
"11 s","Visiting and Joining Family","2001 ","43","31","12",
"11 s","Visiting and Joining Family","2002 ","48","27","21",
"11 s","Visiting and Joining Family","2003 ","43","19","24",
"11 s","Visiting and Joining Family","2004 ","48","22","26",
"11 s","Visiting and Joining Family","2005 ","49","26","23",
"11 s","Visiting and Joining Family","2006 ","63","34","29",
"11 s","Visiting and Joining Family","2007 ","65","35","30",
"11 s","Visiting and Joining Family","2008 ","57","32","25",
"11 s","Visiting and Joining Family","2009 ","67","26","41",
"11 s","Visiting and Joining Family","2010 ","85","47","38",
"11 s","Visiting and Joining Family","2011 ","43","17","26",
"11 s","Visiting and Joining Family","2012 ","13","8","5",
"11 s","Visiting and Joining Family","2013 ","6","5","1",
"11 s","Visiting and Joining Family","2014 ","18","8","10",
"11 s","Visiting and Joining Family","2015 ","22","6","16",
"11 s","Visiting and Joining Family","2016 ","66","33","33",
"11 s","Visiting and Joining Family","2017 ","105","62","43",
"11 s","Visiting and Joining Family","2018 ","128","65","63",
"11 s","Visiting and Joining Family","2019 ","185","93","92",
"11 s","Overseas Koreans","2000 ","4","3","1",
"11 s","Overseas Koreans","2001 ","2","2","0",
"11 s","Overseas Koreans","2002 ","9","4","5",
"11 s","Overseas Koreans","2003 ","7","2","5",
"11 s","Overseas Koreans","2004 ","6","2","4",
"11 s","Overseas Koreans","2005 ","8","6","2",
"11 s","Overseas Koreans","2006 ","4","3","1",
"11 s","Overseas Koreans","2007 ","1","1","0",
"11 s","Overseas Koreans","2008 ","9","3","6",
"11 s","Overseas Koreans","2009 ","1","1","0",
"11 s","Overseas Koreans","2010 ","4","2","2",
"11 s","Overseas Koreans","2011 ","11","7","4",
"11 s","Overseas Koreans","2012 ","12","8","4",
"11 s","Overseas Koreans","2013 ","12","10","2",
"11 s","Overseas Koreans","2014 ","7","1","6",
"11 s","Overseas Koreans","2015 ","10","7","3",
"11 s","Overseas Koreans","2016 ","11","5","6",
"11 s","Overseas Koreans","2017 ","11","6","5",
"11 s","Overseas Koreans","2018 ","17","11","6",
"11 s","Overseas Koreans","2019 ","18","10","8",
"11 s","Permanent Residence","2000 ","0","0","0",
"11 s","Permanent Residence","2001 ","0","0","0",
"11 s","Permanent Residence","2002 ","0","0","0",
"11 s","Permanent Residence","2003 ","1","1","0",
"11 s","Permanent Residence","2004 ","0","0","0",
"11 s","Permanent Residence","2005 ","3","1","2",
"11 s","Permanent Residence","2006 ","5","3","2",
"11 s","Permanent Residence","2007 ","3","2","1",
"11 s","Permanent Residence","2008 ","7","5","2",
"11 s","Permanent Residence","2009 ","5","4","1",
"11 s","Permanent Residence","2010 ","3","2","1",
"11 s","Permanent Residence","2011 ","7","5","2",
"11 s","Permanent Residence","2012 ","1","1","",
"11 s","Permanent Residence","2013 ","5","4","1",
"11 s","Permanent Residence","2014 ","6","3","3",
"11 s","Permanent Residence","2015 ","1","0","1",
"11 s","Permanent Residence","2016 ","1","1","0",
"11 s","Permanent Residence","2017 ","4","3","1",
"11 s","Permanent Residence","2018 ","2","2","0",
"11 s","Permanent Residence","2019 ","1","1","0",
"12 s","Total","2000 ","365","206","159",
"12 s","Total","2001 ","372","197","175",
"12 s","Total","2002 ","357","192","165",
"12 s","Total","2003 ","363","182","181",
"12 s","Total","2004 ","364","180","184",
"12 s","Total","2005 ","400","196","204",
"12 s","Total","2006 ","395","199","196",
"12 s","Total","2007 ","364","166","198",
"12 s","Total","2008 ","321","156","165",
"12 s","Total","2009 ","352","167","185",
"12 s","Total","2010 ","380","187","193",
"12 s","Total","2011 ","527","229","298",
"12 s","Total","2012 ","518","269","249",
"12 s","Total","2013 ","507","271","236",
"12 s","Total","2014 ","531","280","251",
"12 s","Total","2015 ","483","233","250",
"12 s","Total","2016 ","563","244","319",
"12 s","Total","2017 ","590","305","285",
"12 s","Total","2018 ","666","335","331",
"12 s","Total","2019 ","732","344","388",
"12 s","Sightseeing Pass","2000 ","95","45","50",
"12 s","Sightseeing Pass","2001 ","93","60","33",
"12 s","Sightseeing Pass","2002 ","114","65","49",
"12 s","Sightseeing Pass","2003 ","105","45","60",
"12 s","Sightseeing Pass","2004 ","132","69","63",
"12 s","Sightseeing Pass","2005 ","111","64","47",
"12 s","Sightseeing Pass","2006 ","118","59","59",
"12 s","Sightseeing Pass","2007 ","102","40","62",
"12 s","Sightseeing Pass","2008 ","130","68","62",
"12 s","Sightseeing Pass","2009 ","163","82","81",
"12 s","Sightseeing Pass","2010 ","165","75","90",
"12 s","Sightseeing Pass","2011 ","216","93","123",
"12 s","Sightseeing Pass","2012 ","258","143","115",
"12 s","Sightseeing Pass","2013 ","221","123","98",
"12 s","Sightseeing Pass","2014 ","207","107","100",
"12 s","Sightseeing Pass","2015 ","171","88","83",
"12 s","Sightseeing Pass","2016 ","157","78","79",
"12 s","Sightseeing Pass","2017 ","124","72","52",
"12 s","Sightseeing Pass","2018 ","148","67","81",
"12 s","Sightseeing Pass","2019 ","149","80","69",
"12 s","Short-term Business","2000 ","3","3","0",
"12 s","Short-term Business","2001 ","3","1","2",
"12 s","Short-term Business","2002 ","1","1","0",
"12 s","Short-term Business","2003 ","1","1","0",
"12 s","Short-term Business","2004 ","0","0","0",
"12 s","Short-term Business","2005 ","2","1","1",
"12 s","Short-term Business","2006 ","0","0","0",
"12 s","Short-term Business","2007 ","3","1","2",
"12 s","Short-term Business","2008 ","0","0","0",
"12 s","Short-term Business","2009 ","0","0","0",
"12 s","Short-term Business","2010 ","2","2","0",
"12 s","Short-term Visitors","2000 ","110","58","52",
"12 s","Short-term Visitors","2001 ","121","51","70",
"12 s","Short-term Visitors","2002 ","87","38","49",
"12 s","Short-term Visitors","2003 ","70","38","32",
"12 s","Short-term Visitors","2004 ","62","34","28",
"12 s","Short-term Visitors","2005 ","71","34","37",
"12 s","Short-term Visitors","2006 ","67","37","30",
"12 s","Short-term Visitors","2007 ","64","31","33",
"12 s","Short-term Visitors","2008 ","75","30","45",
"12 s","Short-term Visitors","2009 ","61","28","33",
"12 s","Short-term Visitors","2010 ","60","34","26",
"12 s","Short-term Visitors","2011 ","122","50","72",
"12 s","Short-term Visitors","2012 ","158","82","76",
"12 s","Short-term Visitors","2013 ","147","76","71",
"12 s","Short-term Visitors","2014 ","189","95","94",
"12 s","Short-term Visitors","2015 ","203","95","108",
"12 s","Short-term Visitors","2016 ","226","89","137",
"12 s","Short-term Visitors","2017 ","240","123","117",
"12 s","Short-term Visitors","2018 ","242","116","126",
"12 s","Short-term Visitors","2019 ","250","116","134",
"12 s","Short-term Employment","2000 ","1","0","1",
"12 s","Short-term Employment","2001 ","0","0","0",
"12 s","Short-term Employment","2002 ","1","1","0",
"12 s","Short-term Employment","2003 ","2","1","1",
"12 s","Short-term Employment","2004 ","6","2","4",
"12 s","Short-term Employment","2005 ","2","1","1",
"12 s","Short-term Employment","2006 ","1","1","0",
"12 s","Short-term Employment","2007 ","2","2","0",
"12 s","Short-term Employment","2008 ","3","0","3",
"12 s","Short-term Employment","2009 ","0","0","0",
"12 s","Short-term Employment","2010 ","1","0","1",
"12 s","Job Seeking","2000 ","0","0","0",
"12 s","Job Seeking","2001 ","0","0","0",
"12 s","Job Seeking","2002 ","0","0","0",
"12 s","Job Seeking","2003 ","0","0","0",
"12 s","Job Seeking","2004 ","0","0","0",
"12 s","Job Seeking","2005 ","0","0","0",
"12 s","Job Seeking","2006 ","0","0","0",
"12 s","Job Seeking","2007 ","0","0","0",
"12 s","Job Seeking","2008 ","0","0","0",
"12 s","Job Seeking","2009 ","0","0","0",
"12 s","Job Seeking","2010 ","0","0","0",
"12 s","study","2000 ","0","0","0",
"12 s","study","2001 ","1","0","1",
"12 s","study","2002 ","0","0","0",
"12 s","study","2003 ","1","0","1",
"12 s","study","2004 ","0","0","0",
"12 s","study","2005 ","1","1","0",
"12 s","study","2006 ","0","0","0",
"12 s","study","2007 ","0","0","0",
"12 s","study","2008 ","0","0","0",
"12 s","study","2009 ","0","0","0",
"12 s","study","2010 ","0","0","0",
"12 s","General Trainees","2000 ","0","0","0",
"12 s","General Trainees","2001 ","0","0","0",
"12 s","General Trainees","2002 ","0","0","0",
"12 s","General Trainees","2003 ","23","11","12",
"12 s","General Trainees","2004 ","24","11","13",
"12 s","General Trainees","2005 ","27","12","15",
"12 s","General Trainees","2006 ","38","16","22",
"12 s","General Trainees","2007 ","39","18","21",
"12 s","General Trainees","2008 ","1","1","0",
"12 s","General Trainees","2009 ","2","1","1",
"12 s","General Trainees","2010 ","0","0","0",
"12 s","General Trainees","2011 ","2","1","1",
"12 s","General Trainees","2013 ","1","0","1",
"12 s","General Trainees","2014 ","3","3","0",
"12 s","General Trainees","2015 ","1","1","0",
"12 s","General Trainees","2016 ","1","1","0",
"12 s","General Trainees","2017 ","1","0","1",
"12 s","General Trainees","2018 ","3","2","1",
"12 s","General Trainees","2019 ","2","1","1",
"12 s","Religious Activities","2000 ","0","0","0",
"12 s","Religious Activities","2001 ","1","1","0",
"12 s","Religious Activities","2002 ","0","0","0",
"12 s","Religious Activities","2003 ","0","0","0",
"12 s","Religious Activities","2004 ","0","0","0",
"12 s","Religious Activities","2005 ","0","0","0",
"12 s","Religious Activities","2006 ","0","0","0",
"12 s","Religious Activities","2007 ","0","0","0",
"12 s","Religious Activities","2008 ","0","0","0",
"12 s","Religious Activities","2009 ","0","0","0",
"12 s","Religious Activities","2010 ","0","0","0",
"12 s","Investors","2000 ","0","0","0",
"12 s","Investors","2001 ","0","0","0",
"12 s","Investors","2002 ","0","0","0",
"12 s","Investors","2003 ","0","0","0",
"12 s","Investors","2004 ","0","0","0",
"12 s","Investors","2005 ","1","1","0",
"12 s","Investors","2006 ","0","0","0",
"12 s","Investors","2007 ","0","0","0",
"12 s","Investors","2008 ","0","0","0",
"12 s","Investors","2009 ","0","0","0",
"12 s","Investors","2010 ","0","0","0",
"12 s","Trade and Business","2000 ","0","0","0",
"12 s","Trade and Business","2001 ","0","0","0",
"12 s","Trade and Business","2002 ","0","0","0",
"12 s","Trade and Business","2003 ","0","0","0",
"12 s","Trade and Business","2004 ","0","0","0",
"12 s","Trade and Business","2005 ","0","0","0",
"12 s","Trade and Business","2006 ","0","0","0",
"12 s","Trade and Business","2007 ","0","0","0",
"12 s","Trade and Business","2008 ","0","0","0",
"12 s","Trade and Business","2009 ","0","0","0",
"12 s","Trade and Business","2010 ","0","0","0",
"12 s","Research","2000 ","0","0","0",
"12 s","Research","2001 ","0","0","0",
"12 s","Research","2002 ","0","0","0",
"12 s","Research","2003 ","0","0","0",
"12 s","Research","2004 ","0","0","0",
"12 s","Research","2005 ","1","0","1",
"12 s","Research","2006 ","0","0","0",
"12 s","Research","2007 ","0","0","0",
"12 s","Research","2008 ","0","0","0",
"12 s","Research","2009 ","0","0","0",
"12 s","Research","2010 ","0","0","0",
"12 s","Art and Entertainment","2000 ","3","2","1",
"12 s","Art and Entertainment","2001 ","13","7","6",
"12 s","Art and Entertainment","2002 ","4","1","3",
"12 s","Art and Entertainment","2003 ","1","1","0",
"12 s","Art and Entertainment","2004 ","10","4","6",
"12 s","Art and Entertainment","2005 ","12","2","10",
"12 s","Art and Entertainment","2006 ","12","4","8",
"12 s","Art and Entertainment","2007 ","5","2","3",
"12 s","Art and Entertainment","2008 ","10","3","7",
"12 s","Art and Entertainment","2009 ","6","1","5",
"12 s","Art and Entertainment","2010 ","3","0","3",
"12 s","Art and Entertainment","2011 ","12","5","7",
"12 s","Art and Entertainment","2012 ","5","3","2",
"12 s","Art and Entertainment","2013 ","6","1","5",
"12 s","Art and Entertainment","2014 ","14","9","5",
"12 s","Art and Entertainment","2015 ","12","6","6",
"12 s","Art and Entertainment","2016 ","4","3","1",
"12 s","Art and Entertainment","2017 ","6","4","2",
"12 s","Art and Entertainment","2018 ","12","9","3",
"12 s","Art and Entertainment","2019 ","14","5","9",
"12 s","Unskilled Employment","2000 ","0","0","0",
"12 s","Unskilled Employment","2001 ","0","0","0",
"12 s","Unskilled Employment","2002 ","0","0","0",
"12 s","Unskilled Employment","2003 ","0","0","0",
"12 s","Unskilled Employment","2004 ","0","0","0",
"12 s","Unskilled Employment","2005 ","0","0","0",
"12 s","Unskilled Employment","2006 ","1","1","0",
"12 s","Unskilled Employment","2007 ","0","0","0",
"12 s","Unskilled Employment","2008 ","0","0","0",
"12 s","Unskilled Employment","2009 ","0","0","0",
"12 s","Unskilled Employment","2010 ","1","1","0",
"12 s","Unskilled Employment","2011 ","1","1","",
"12 s","Visiting and Joining Family","2000 ","42","26","16",
"12 s","Visiting and Joining Family","2001 ","42","24","18",
"12 s","Visiting and Joining Family","2002 ","45","29","16",
"12 s","Visiting and Joining Family","2003 ","65","28","37",
"12 s","Visiting and Joining Family","2004 ","47","21","26",
"12 s","Visiting and Joining Family","2005 ","45","23","22",
"12 s","Visiting and Joining Family","2006 ","69","29","40",
"12 s","Visiting and Joining Family","2007 ","67","34","33",
"12 s","Visiting and Joining Family","2008 ","47","23","24",
"12 s","Visiting and Joining Family","2009 ","59","25","34",
"12 s","Visiting and Joining Family","2010 ","65","33","32",
"12 s","Visiting and Joining Family","2011 ","53","19","34",
"12 s","Visiting and Joining Family","2012 ","13","7","6",
"12 s","Visiting and Joining Family","2013 ","9","5","4",
"12 s","Visiting and Joining Family","2014 ","16","7","9",
"12 s","Visiting and Joining Family","2015 ","16","8","8",
"12 s","Visiting and Joining Family","2016 ","68","30","38",
"12 s","Visiting and Joining Family","2017 ","98","48","50",
"12 s","Visiting and Joining Family","2018 ","118","72","46",
"12 s","Visiting and Joining Family","2019 ","169","85","84",
"12 s","Overseas Koreans","2000 ","3","0","3",
"12 s","Overseas Koreans","2001 ","2","1","1",
"12 s","Overseas Koreans","2002 ","6","2","4",
"12 s","Overseas Koreans","2003 ","4","3","1",
"12 s","Overseas Koreans","2004 ","3","1","2",
"12 s","Overseas Koreans","2005 ","7","2","5",
"12 s","Overseas Koreans","2006 ","3","2","1",
"12 s","Overseas Koreans","2007 ","6","2","4",
"12 s","Overseas Koreans","2008 ","5","5","0",
"12 s","Overseas Koreans","2009 ","5","2","3",
"12 s","Overseas Koreans","2010 ","8","2","6",
"12 s","Overseas Koreans","2011 ","5","2","3",
"12 s","Overseas Koreans","2012 ","10","6","4",
"12 s","Overseas Koreans","2013 ","15","6","9",
"12 s","Overseas Koreans","2014 ","17","10","7",
"12 s","Overseas Koreans","2015 ","13","6","7",
"12 s","Overseas Koreans","2016 ","13","6","7",
"12 s","Overseas Koreans","2017 ","25","8","17",
"12 s","Overseas Koreans","2018 ","25","15","10",
"12 s","Overseas Koreans","2019 ","21","11","10",
"12 s","Permanent Residence","2000 ","0","0","0",
"12 s","Permanent Residence","2001 ","0","0","0",
"12 s","Permanent Residence","2002 ","0","0","0",
"12 s","Permanent Residence","2003 ","2","2","0",
"12 s","Permanent Residence","2004 ","1","1","0",
"12 s","Permanent Residence","2005 ","0","0","0",
"12 s","Permanent Residence","2006 ","2","0","2",
"12 s","Permanent Residence","2007 ","7","4","3",
"12 s","Permanent Residence","2008 ","5","2","3",
"12 s","Permanent Residence","2009 ","5","2","3",
"12 s","Permanent Residence","2010 ","8","2","6",
"12 s","Permanent Residence","2011 ","4","2","2",
"12 s","Permanent Residence","2012 ","2","1","1",
"12 s","Permanent Residence","2013 ","4","2","2",
"12 s","Permanent Residence","2014 ","3","3","0",
"12 s","Permanent Residence","2015 ","3","2","1",
"12 s","Permanent Residence","2016 ","2","0","2",
"12 s","Permanent Residence","2017 ","3","1","2",
"12 s","Permanent Residence","2018 ","3","1","2",
"12 s","Permanent Residence","2019 ","1","1","0",
"13 s","Total","2000 ","320","178","142",
"13 s","Total","2001 ","352","198","154",
"13 s","Total","2002 ","350","183","167",
"13 s","Total","2003 ","337","160","177",
"13 s","Total","2004 ","339","166","173",
"13 s","Total","2005 ","401","198","203",
"13 s","Total","2006 ","341","175","166",
"13 s","Total","2007 ","298","140","158",
"13 s","Total","2008 ","322","161","161",
"13 s","Total","2009 ","316","149","167",
"13 s","Total","2010 ","327","159","168",
"13 s","Total","2011 ","393","189","204",
"13 s","Total","2012 ","447","233","214",
"13 s","Total","2013 ","502","244","258",
"13 s","Total","2014 ","577","286","291",
"13 s","Total","2015 ","554","271","283",
"13 s","Total","2016 ","561","285","276",
"13 s","Total","2017 ","563","290","273",
"13 s","Total","2018 ","582","283","299",
"13 s","Total","2019 ","665","310","355",
"13 s","Sightseeing Pass","2000 ","77","40","37",
"13 s","Sightseeing Pass","2001 ","76","37","39",
"13 s","Sightseeing Pass","2002 ","102","58","44",
"13 s","Sightseeing Pass","2003 ","85","35","50",
"13 s","Sightseeing Pass","2004 ","98","50","48",
"13 s","Sightseeing Pass","2005 ","101","59","42",
"13 s","Sightseeing Pass","2006 ","95","52","43",
"13 s","Sightseeing Pass","2007 ","79","40","39",
"13 s","Sightseeing Pass","2008 ","87","39","48",
"13 s","Sightseeing Pass","2009 ","110","55","55",
"13 s","Sightseeing Pass","2010 ","118","53","65",
"13 s","Sightseeing Pass","2011 ","146","75","71",
"13 s","Sightseeing Pass","2012 ","172","98","74",
"13 s","Sightseeing Pass","2013 ","173","86","87",
"13 s","Sightseeing Pass","2014 ","181","85","96",
"13 s","Sightseeing Pass","2015 ","194","94","100",
"13 s","Sightseeing Pass","2016 ","151","84","67",
"13 s","Sightseeing Pass","2017 ","135","66","69",
"13 s","Sightseeing Pass","2018 ","135","71","64",
"13 s","Sightseeing Pass","2019 ","138","64","74",
"13 s","Short-term Business","2000 ","4","1","3",
"13 s","Short-term Business","2001 ","4","2","2",
"13 s","Short-term Business","2002 ","1","1","0",
"13 s","Short-term Business","2003 ","0","0","0",
"13 s","Short-term Business","2004 ","1","0","1",
"13 s","Short-term Business","2005 ","2","2","0",
"13 s","Short-term Business","2006 ","2","2","0",
"13 s","Short-term Business","2007 ","1","0","1",
"13 s","Short-term Business","2008 ","2","2","0",
"13 s","Short-term Business","2009 ","1","0","1",
"13 s","Short-term Business","2010 ","0","0","0",
"13 s","Short-term Visitors","2000 ","96","56","40",
"13 s","Short-term Visitors","2001 ","115","64","51",
"13 s","Short-term Visitors","2002 ","91","48","43",
"13 s","Short-term Visitors","2003 ","81","46","35",
"13 s","Short-term Visitors","2004 ","73","37","36",
"13 s","Short-term Visitors","2005 ","76","36","40",
"13 s","Short-term Visitors","2006 ","74","38","36",
"13 s","Short-term Visitors","2007 ","73","30","43",
"13 s","Short-term Visitors","2008 ","87","46","41",
"13 s","Short-term Visitors","2009 ","62","25","37",
"13 s","Short-term Visitors","2010 ","59","32","27",
"13 s","Short-term Visitors","2011 ","101","52","49",
"13 s","Short-term Visitors","2012 ","174","79","95",
"13 s","Short-term Visitors","2013 ","175","84","91",
"13 s","Short-term Visitors","2014 ","228","114","114",
"13 s","Short-term Visitors","2015 ","231","109","122",
"13 s","Short-term Visitors","2016 ","252","115","137",
"13 s","Short-term Visitors","2017 ","220","118","102",
"13 s","Short-term Visitors","2018 ","231","100","131",
"13 s","Short-term Visitors","2019 ","251","110","141",
"13 s","Short-term Employment","2000 ","1","0","1",
"13 s","Short-term Employment","2001 ","1","0","1",
"13 s","Short-term Employment","2002 ","3","1","2",
"13 s","Short-term Employment","2003 ","5","1","4",
"13 s","Short-term Employment","2004 ","8","2","6",
"13 s","Short-term Employment","2005 ","3","3","0",
"13 s","Short-term Employment","2006 ","4","3","1",
"13 s","Short-term Employment","2007 ","3","2","1",
"13 s","Short-term Employment","2008 ","1","1","0",
"13 s","Short-term Employment","2009 ","0","0","0",
"13 s","Short-term Employment","2010 ","0","0","0",
"13 s","Job Seeking","2000 ","0","0","0",
"13 s","Job Seeking","2001 ","0","0","0",
"13 s","Job Seeking","2002 ","0","0","0",
"13 s","Job Seeking","2003 ","0","0","0",
"13 s","Job Seeking","2004 ","0","0","0",
"13 s","Job Seeking","2005 ","0","0","0",
"13 s","Job Seeking","2006 ","0","0","0",
"13 s","Job Seeking","2007 ","0","0","0",
"13 s","Job Seeking","2008 ","0","0","0",
"13 s","Job Seeking","2009 ","0","0","0",
"13 s","Job Seeking","2010 ","0","0","0",
"13 s","study","2000 ","1","0","1",
"13 s","study","2001 ","0","0","0",
"13 s","study","2002 ","0","0","0",
"13 s","study","2003 ","1","0","1",
"13 s","study","2004 ","0","0","0",
"13 s","study","2005 ","0","0","0",
"13 s","study","2006 ","0","0","0",
"13 s","study","2007 ","0","0","0",
"13 s","study","2008 ","0","0","0",
"13 s","study","2009 ","0","0","0",
"13 s","study","2010 ","0","0","0",
"13 s","General Trainees","2000 ","0","0","0",
"13 s","General Trainees","2001 ","0","0","0",
"13 s","General Trainees","2002 ","0","0","0",
"13 s","General Trainees","2003 ","1","1","0",
"13 s","General Trainees","2004 ","2","1","1",
"13 s","General Trainees","2005 ","0","0","0",
"13 s","General Trainees","2006 ","5","5","0",
"13 s","General Trainees","2007 ","7","2","5",
"13 s","General Trainees","2008 ","1","0","1",
"13 s","General Trainees","2009 ","0","0","0",
"13 s","General Trainees","2010 ","5","1","4",
"13 s","General Trainees","2011 ","5","3","2",
"13 s","General Trainees","2014 ","4","3","1",
"13 s","General Trainees","2015 ","1","0","1",
"13 s","General Trainees","2016 ","1","1","0",
"13 s","General Trainees","2017 ","1","1","0",
"13 s","General Trainees","2018 ","2","2","0",
"13 s","General Trainees","2019 ","2","1","1",
"13 s","Religious Activities","2000 ","0","0","0",
"13 s","Religious Activities","2001 ","0","0","0",
"13 s","Religious Activities","2002 ","1","0","1",
"13 s","Religious Activities","2003 ","0","0","0",
"13 s","Religious Activities","2004 ","0","0","0",
"13 s","Religious Activities","2005 ","0","0","0",
"13 s","Religious Activities","2006 ","0","0","0",
"13 s","Religious Activities","2007 ","0","0","0",
"13 s","Religious Activities","2008 ","0","0","0",
"13 s","Religious Activities","2009 ","0","0","0",
"13 s","Religious Activities","2010 ","2","2","0",
"13 s","Investors","2000 ","0","0","0",
"13 s","Investors","2001 ","1","1","0",
"13 s","Investors","2002 ","0","0","0",
"13 s","Investors","2003 ","0","0","0",
"13 s","Investors","2004 ","0","0","0",
"13 s","Investors","2005 ","0","0","0",
"13 s","Investors","2006 ","0","0","0",
"13 s","Investors","2007 ","0","0","0",
"13 s","Investors","2008 ","0","0","0",
"13 s","Investors","2009 ","0","0","0",
"13 s","Investors","2010 ","0","0","0",
"13 s","Trade and Business","2000 ","0","0","0",
"13 s","Trade and Business","2001 ","0","0","0",
"13 s","Trade and Business","2002 ","1","1","0",
"13 s","Trade and Business","2003 ","0","0","0",
"13 s","Trade and Business","2004 ","0","0","0",
"13 s","Trade and Business","2005 ","0","0","0",
"13 s","Trade and Business","2006 ","0","0","0",
"13 s","Trade and Business","2007 ","0","0","0",
"13 s","Trade and Business","2008 ","0","0","0",
"13 s","Trade and Business","2009 ","0","0","0",
"13 s","Trade and Business","2010 ","0","0","0",
"13 s","Research","2000 ","0","0","0",
"13 s","Research","2001 ","0","0","0",
"13 s","Research","2002 ","0","0","0",
"13 s","Research","2003 ","0","0","0",
"13 s","Research","2004 ","1","0","1",
"13 s","Research","2005 ","0","0","0",
"13 s","Research","2006 ","0","0","0",
"13 s","Research","2007 ","0","0","0",
"13 s","Research","2008 ","0","0","0",
"13 s","Research","2009 ","0","0","0",
"13 s","Research","2010 ","0","0","0",
"13 s","Art and Entertainment","2000 ","4","2","2",
"13 s","Art and Entertainment","2001 ","13","7","6",
"13 s","Art and Entertainment","2002 ","8","3","5",
"13 s","Art and Entertainment","2003 ","9","3","6",
"13 s","Art and Entertainment","2004 ","10","3","7",
"13 s","Art and Entertainment","2005 ","24","9","15",
"13 s","Art and Entertainment","2006 ","10","1","9",
"13 s","Art and Entertainment","2007 ","6","2","4",
"13 s","Art and Entertainment","2008 ","8","1","7",
"13 s","Art and Entertainment","2009 ","7","2","5",
"13 s","Art and Entertainment","2010 ","6","4","2",
"13 s","Art and Entertainment","2011 ","16","8","8",
"13 s","Art and Entertainment","2012 ","7","3","4",
"13 s","Art and Entertainment","2013 ","27","11","16",
"13 s","Art and Entertainment","2014 ","30","16","14",
"13 s","Art and Entertainment","2015 ","20","11","9",
"13 s","Art and Entertainment","2016 ","5","1","4",
"13 s","Art and Entertainment","2017 ","10","7","3",
"13 s","Art and Entertainment","2018 ","2","1","1",
"13 s","Art and Entertainment","2019 ","7","2","5",
"13 s","Unskilled Employment","2000 ","0","0","0",
"13 s","Unskilled Employment","2001 ","0","0","0",
"13 s","Unskilled Employment","2002 ","0","0","0",
"13 s","Unskilled Employment","2003 ","0","0","0",
"13 s","Unskilled Employment","2004 ","0","0","0",
"13 s","Unskilled Employment","2005 ","1","0","1",
"13 s","Unskilled Employment","2006 ","0","0","0",
"13 s","Unskilled Employment","2007 ","0","0","0",
"13 s","Unskilled Employment","2008 ","0","0","0",
"13 s","Unskilled Employment","2009 ","0","0","0",
"13 s","Unskilled Employment","2010 ","0","0","0",
"13 s","Visiting and Joining Family","2000 ","28","12","16",
"13 s","Visiting and Joining Family","2001 ","34","18","16",
"13 s","Visiting and Joining Family","2002 ","42","20","22",
"13 s","Visiting and Joining Family","2003 ","41","15","26",
"13 s","Visiting and Joining Family","2004 ","51","26","25",
"13 s","Visiting and Joining Family","2005 ","55","24","31",
"13 s","Visiting and Joining Family","2006 ","62","28","34",
"13 s","Visiting and Joining Family","2007 ","59","23","36",
"13 s","Visiting and Joining Family","2008 ","69","33","36",
"13 s","Visiting and Joining Family","2009 ","73","33","40",
"13 s","Visiting and Joining Family","2010 ","78","39","39",
"13 s","Visiting and Joining Family","2011 ","45","16","29",
"13 s","Visiting and Joining Family","2012 ","14","8","6",
"13 s","Visiting and Joining Family","2013 ","5","4","1",
"13 s","Visiting and Joining Family","2014 ","19","5","14",
"13 s","Visiting and Joining Family","2015 ","26","12","14",
"13 s","Visiting and Joining Family","2016 ","57","28","29",
"13 s","Visiting and Joining Family","2017 ","93","47","46",
"13 s","Visiting and Joining Family","2018 ","93","51","42",
"13 s","Visiting and Joining Family","2019 ","148","71","77",
"13 s","Overseas Koreans","2000 ","1","1","0",
"13 s","Overseas Koreans","2001 ","4","2","2",
"13 s","Overseas Koreans","2002 ","4","1","3",
"13 s","Overseas Koreans","2003 ","6","3","3",
"13 s","Overseas Koreans","2004 ","2","1","1",
"13 s","Overseas Koreans","2005 ","7","4","3",
"13 s","Overseas Koreans","2006 ","7","3","4",
"13 s","Overseas Koreans","2007 ","6","4","2",
"13 s","Overseas Koreans","2008 ","5","4","1",
"13 s","Overseas Koreans","2009 ","7","4","3",
"13 s","Overseas Koreans","2010 ","13","5","8",
"13 s","Overseas Koreans","2011 ","11","6","5",
"13 s","Overseas Koreans","2012 ","11","8","3",
"13 s","Overseas Koreans","2013 ","15","8","7",
"13 s","Overseas Koreans","2014 ","7","5","2",
"13 s","Overseas Koreans","2015 ","14","8","6",
"13 s","Overseas Koreans","2016 ","12","9","3",
"13 s","Overseas Koreans","2017 ","14","7","7",
"13 s","Overseas Koreans","2018 ","16","8","8",
"13 s","Overseas Koreans","2019 ","15","8","7",
"13 s","Permanent Residence","2000 ","0","0","0",
"13 s","Permanent Residence","2001 ","0","0","0",
"13 s","Permanent Residence","2002 ","0","0","0",
"13 s","Permanent Residence","2003 ","0","0","0",
"13 s","Permanent Residence","2004 ","4","4","0",
"13 s","Permanent Residence","2005 ","3","0","3",
"13 s","Permanent Residence","2006 ","6","2","4",
"13 s","Permanent Residence","2007 ","5","4","1",
"13 s","Permanent Residence","2008 ","8","6","2",
"13 s","Permanent Residence","2009 ","1","0","1",
"13 s","Permanent Residence","2010 ","3","2","1",
"13 s","Permanent Residence","2011 ","3","1","2",
"13 s","Permanent Residence","2012 ","2","1","1",
"13 s","Permanent Residence","2014 ","3","1","2",
"13 s","Permanent Residence","2016 ","4","3","1",
"13 s","Permanent Residence","2017 ","1","0","1",
"13 s","Permanent Residence","2018 ","2","1","1",
"13 s","Permanent Residence","2019 ","2","1","1",
"14 s","Total","2000 ","346","224","122",
"14 s","Total","2001 ","354","196","158",
"14 s","Total","2002 ","335","167","168",
"14 s","Total","2003 ","319","166","153",
"14 s","Total","2004 ","325","167","158",
"14 s","Total","2005 ","390","194","196",
"14 s","Total","2006 ","347","166","181",
"14 s","Total","2007 ","322","150","172",
"14 s","Total","2008 ","325","167","158",
"14 s","Total","2009 ","340","156","184",
"14 s","Total","2010 ","367","184","183",
"14 s","Total","2011 ","479","249","230",
"14 s","Total","2012 ","497","254","243",
"14 s","Total","2013 ","544","276","268",
"14 s","Total","2014 ","572","306","266",
"14 s","Total","2015 ","586","302","284",
"14 s","Total","2016 ","560","273","287",
"14 s","Total","2017 ","537","263","274",
"14 s","Total","2018 ","569","295","274",
"14 s","Total","2019 ","634","313","321",
"14 s","Sightseeing Pass","2000 ","78","47","31",
"14 s","Sightseeing Pass","2001 ","81","39","42",
"14 s","Sightseeing Pass","2002 ","100","52","48",
"14 s","Sightseeing Pass","2003 ","71","34","37",
"14 s","Sightseeing Pass","2004 ","102","47","55",
"14 s","Sightseeing Pass","2005 ","97","55","42",
"14 s","Sightseeing Pass","2006 ","95","47","48",
"14 s","Sightseeing Pass","2007 ","74","34","40",
"14 s","Sightseeing Pass","2008 ","73","43","30",
"14 s","Sightseeing Pass","2009 ","112","60","52",
"14 s","Sightseeing Pass","2010 ","93","46","47",
"14 s","Sightseeing Pass","2011 ","141","82","59",
"14 s","Sightseeing Pass","2012 ","153","68","85",
"14 s","Sightseeing Pass","2013 ","162","87","75",
"14 s","Sightseeing Pass","2014 ","169","89","80",
"14 s","Sightseeing Pass","2015 ","142","70","72",
"14 s","Sightseeing Pass","2016 ","137","66","71",
"14 s","Sightseeing Pass","2017 ","97","48","49",
"14 s","Sightseeing Pass","2018 ","126","70","56",
"14 s","Sightseeing Pass","2019 ","115","62","53",
"14 s","Short-term Business","2000 ","3","1","2",
"14 s","Short-term Business","2001 ","15","12","3",
"14 s","Short-term Business","2002 ","0","0","0",
"14 s","Short-term Business","2003 ","0","0","0",
"14 s","Short-term Business","2004 ","0","0","0",
"14 s","Short-term Business","2005 ","4","3","1",
"14 s","Short-term Business","2006 ","1","1","0",
"14 s","Short-term Business","2007 ","1","1","0",
"14 s","Short-term Business","2008 ","0","0","0",
"14 s","Short-term Business","2009 ","0","0","0",
"14 s","Short-term Business","2010 ","0","0","0",
"14 s","Short-term Business","2011 ","133","63","70",
"14 s","Short-term Visitors","2000 ","82","41","41",
"14 s","Short-term Visitors","2001 ","125","64","61",
"14 s","Short-term Visitors","2002 ","93","49","44",
"14 s","Short-term Visitors","2003 ","86","48","38",
"14 s","Short-term Visitors","2004 ","61","33","28",
"14 s","Short-term Visitors","2005 ","58","30","28",
"14 s","Short-term Visitors","2006 ","56","27","29",
"14 s","Short-term Visitors","2007 ","68","30","38",
"14 s","Short-term Visitors","2008 ","88","42","46",
"14 s","Short-term Visitors","2009 ","48","24","24",
"14 s","Short-term Visitors","2010 ","69","34","35",
"14 s","Short-term Visitors","2012 ","207","118","89",
"14 s","Short-term Visitors","2013 ","244","119","125",
"14 s","Short-term Visitors","2014 ","260","132","128",
"14 s","Short-term Visitors","2015 ","308","156","152",
"14 s","Short-term Visitors","2016 ","252","126","126",
"14 s","Short-term Visitors","2017 ","241","114","127",
"14 s","Short-term Visitors","2018 ","225","113","112",
"14 s","Short-term Visitors","2019 ","269","131","138",
"14 s","Short-term Employment","2000 ","0","0","0",
"14 s","Short-term Employment","2001 ","2","0","2",
"14 s","Short-term Employment","2002 ","4","1","3",
"14 s","Short-term Employment","2003 ","8","3","5",
"14 s","Short-term Employment","2004 ","12","5","7",
"14 s","Short-term Employment","2005 ","5","2","3",
"14 s","Short-term Employment","2006 ","4","2","2",
"14 s","Short-term Employment","2007 ","3","1","2",
"14 s","Short-term Employment","2008 ","1","1","0",
"14 s","Short-term Employment","2009 ","1","0","1",
"14 s","Short-term Employment","2010 ","0","0","0",
"14 s","Short-term Employment","2019 ","1","0","1",
"14 s","Job Seeking","2000 ","0","0","0",
"14 s","Job Seeking","2001 ","0","0","0",
"14 s","Job Seeking","2002 ","0","0","0",
"14 s","Job Seeking","2003 ","0","0","0",
"14 s","Job Seeking","2004 ","0","0","0",
"14 s","Job Seeking","2005 ","0","0","0",
"14 s","Job Seeking","2006 ","0","0","0",
"14 s","Job Seeking","2007 ","0","0","0",
"14 s","Job Seeking","2008 ","0","0","0",
"14 s","Job Seeking","2009 ","0","0","0",
"14 s","Job Seeking","2010 ","0","0","0",
"14 s","study","2000 ","0","0","0",
"14 s","study","2001 ","0","0","0",
"14 s","study","2002 ","0","0","0",
"14 s","study","2003 ","0","0","0",
"14 s","study","2004 ","1","0","1",
"14 s","study","2005 ","0","0","0",
"14 s","study","2006 ","0","0","0",
"14 s","study","2007 ","0","0","0",
"14 s","study","2008 ","1","1","0",
"14 s","study","2009 ","1","1","0",
"14 s","study","2010 ","0","0","0",
"14 s","study","2012 ","1","","1",
"14 s","study","2018 ","1","1","0",
"14 s","study","2019 ","1","0","1",
"14 s","General Trainees","2000 ","1","1","0",
"14 s","General Trainees","2001 ","0","0","0",
"14 s","General Trainees","2002 ","2","2","0",
"14 s","General Trainees","2003 ","2","1","1",
"14 s","General Trainees","2004 ","3","3","0",
"14 s","General Trainees","2005 ","4","3","1",
"14 s","General Trainees","2006 ","2","1","1",
"14 s","General Trainees","2007 ","3","3","0",
"14 s","General Trainees","2008 ","5","2","3",
"14 s","General Trainees","2009 ","4","3","1",
"14 s","General Trainees","2010 ","8","6","2",
"14 s","General Trainees","2011 ","5","2","3",
"14 s","General Trainees","2013 ","4","4","0",
"14 s","General Trainees","2014 ","5","2","3",
"14 s","General Trainees","2015 ","4","3","1",
"14 s","General Trainees","2016 ","4","3","1",
"14 s","General Trainees","2017 ","6","3","3",
"14 s","General Trainees","2018 ","5","2","3",
"14 s","General Trainees","2019 ","7","2","5",
"14 s","Religious Activities","2000 ","0","0","0",
"14 s","Religious Activities","2001 ","0","0","0",
"14 s","Religious Activities","2002 ","0","0","0",
"14 s","Religious Activities","2003 ","0","0","0",
"14 s","Religious Activities","2004 ","0","0","0",
"14 s","Religious Activities","2005 ","0","0","0",
"14 s","Religious Activities","2006 ","1","0","1",
"14 s","Religious Activities","2007 ","0","0","0",
"14 s","Religious Activities","2008 ","0","0","0",
"14 s","Religious Activities","2009 ","0","0","0",
"14 s","Religious Activities","2010 ","1","1","0",
"14 s","Investors","2000 ","0","0","0",
"14 s","Investors","2001 ","0","0","0",
"14 s","Investors","2002 ","0","0","0",
"14 s","Investors","2003 ","0","0","0",
"14 s","Investors","2004 ","0","0","0",
"14 s","Investors","2005 ","0","0","0",
"14 s","Investors","2006 ","0","0","0",
"14 s","Investors","2007 ","0","0","0",
"14 s","Investors","2008 ","0","0","0",
"14 s","Investors","2009 ","0","0","0",
"14 s","Investors","2010 ","0","0","0",
"14 s","Trade and Business","2000 ","0","0","0",
"14 s","Trade and Business","2001 ","0","0","0",
"14 s","Trade and Business","2002 ","0","0","0",
"14 s","Trade and Business","2003 ","0","0","0",
"14 s","Trade and Business","2004 ","0","0","0",
"14 s","Trade and Business","2005 ","0","0","0",
"14 s","Trade and Business","2006 ","0","0","0",
"14 s","Trade and Business","2007 ","0","0","0",
"14 s","Trade and Business","2008 ","0","0","0",
"14 s","Trade and Business","2009 ","0","0","0",
"14 s","Trade and Business","2010 ","0","0","0",
"14 s","Research","2000 ","0","0","0",
"14 s","Research","2001 ","0","0","0",
"14 s","Research","2002 ","0","0","0",
"14 s","Research","2003 ","1","1","0",
"14 s","Research","2004 ","1","0","1",
"14 s","Research","2005 ","0","0","0",
"14 s","Research","2006 ","0","0","0",
"14 s","Research","2007 ","0","0","0",
"14 s","Research","2008 ","0","0","0",
"14 s","Research","2009 ","0","0","0",
"14 s","Research","2010 ","0","0","0",
"14 s","Art and Entertainment","2000 ","4","2","2",
"14 s","Art and Entertainment","2001 ","7","3","4",
"14 s","Art and Entertainment","2002 ","8","2","6",
"14 s","Art and Entertainment","2003 ","8","3","5",
"14 s","Art and Entertainment","2004 ","14","6","8",
"14 s","Art and Entertainment","2005 ","26","7","19",
"14 s","Art and Entertainment","2006 ","29","6","23",
"14 s","Art and Entertainment","2007 ","8","4","4",
"14 s","Art and Entertainment","2008 ","19","7","12",
"14 s","Art and Entertainment","2009 ","11","2","9",
"14 s","Art and Entertainment","2010 ","12","8","4",
"14 s","Art and Entertainment","2012 ","12","7","5",
"14 s","Art and Entertainment","2013 ","15","4","11",
"14 s","Art and Entertainment","2014 ","20","14","6",
"14 s","Art and Entertainment","2015 ","20","14","6",
"14 s","Art and Entertainment","2016 ","12","9","3",
"14 s","Art and Entertainment","2017 ","11","6","5",
"14 s","Art and Entertainment","2018 ","13","7","6",
"14 s","Art and Entertainment","2019 ","5","0","5",
"14 s","Unskilled Employment","2000 ","0","0","0",
"14 s","Unskilled Employment","2001 ","0","0","0",
"14 s","Unskilled Employment","2002 ","0","0","0",
"14 s","Unskilled Employment","2003 ","0","0","0",
"14 s","Unskilled Employment","2004 ","0","0","0",
"14 s","Unskilled Employment","2005 ","0","0","0",
"14 s","Unskilled Employment","2006 ","1","1","0",
"14 s","Unskilled Employment","2007 ","0","0","0",
"14 s","Unskilled Employment","2008 ","0","0","0",
"14 s","Unskilled Employment","2009 ","0","0","0",
"14 s","Unskilled Employment","2010 ","0","0","0",
"14 s","Unskilled Employment","2012 ","1","1","",
"14 s","Visiting and Joining Family","2000 ","27","14","13",
"14 s","Visiting and Joining Family","2001 ","27","15","12",
"14 s","Visiting and Joining Family","2002 ","35","19","16",
"14 s","Visiting and Joining Family","2003 ","44","19","25",
"14 s","Visiting and Joining Family","2004 ","46","19","27",
"14 s","Visiting and Joining Family","2005 ","71","38","33",
"14 s","Visiting and Joining Family","2006 ","86","42","44",
"14 s","Visiting and Joining Family","2007 ","97","46","51",
"14 s","Visiting and Joining Family","2008 ","84","39","45",
"14 s","Visiting and Joining Family","2009 ","108","41","67",
"14 s","Visiting and Joining Family","2010 ","106","50","56",
"14 s","Visiting and Joining Family","2011 ","58","34","24",
"14 s","Visiting and Joining Family","2012 ","31","16","15",
"14 s","Visiting and Joining Family","2013 ","13","6","7",
"14 s","Visiting and Joining Family","2014 ","28","17","11",
"14 s","Visiting and Joining Family","2015 ","28","14","14",
"14 s","Visiting and Joining Family","2016 ","50","19","31",
"14 s","Visiting and Joining Family","2017 ","81","37","44",
"14 s","Visiting and Joining Family","2018 ","76","38","38",
"14 s","Visiting and Joining Family","2019 ","127","60","67",
"14 s","Overseas Koreans","2000 ","4","2","2",
"14 s","Overseas Koreans","2001 ","3","1","2",
"14 s","Overseas Koreans","2002 ","4","2","2",
"14 s","Overseas Koreans","2003 ","0","0","0",
"14 s","Overseas Koreans","2004 ","2","1","1",
"14 s","Overseas Koreans","2005 ","6","3","3",
"14 s","Overseas Koreans","2006 ","5","3","2",
"14 s","Overseas Koreans","2007 ","6","2","4",
"14 s","Overseas Koreans","2008 ","2","1","1",
"14 s","Overseas Koreans","2009 ","4","2","2",
"14 s","Overseas Koreans","2010 ","13","4","9",
"14 s","Overseas Koreans","2011 ","12","6","6",
"14 s","Overseas Koreans","2012 ","17","13","4",
"14 s","Overseas Koreans","2013 ","13","8","5",
"14 s","Overseas Koreans","2014 ","11","6","5",
"14 s","Overseas Koreans","2015 ","15","7","8",
"14 s","Overseas Koreans","2016 ","14","5","9",
"14 s","Overseas Koreans","2017 ","14","7","7",
"14 s","Overseas Koreans","2018 ","22","10","12",
"14 s","Overseas Koreans","2019 ","14","10","4",
"14 s","Permanent Residence","2000 ","0","0","0",
"14 s","Permanent Residence","2001 ","0","0","0",
"14 s","Permanent Residence","2002 ","0","0","0",
"14 s","Permanent Residence","2003 ","1","1","0",
"14 s","Permanent Residence","2004 ","1","1","0",
"14 s","Permanent Residence","2005 ","5","4","1",
"14 s","Permanent Residence","2006 ","4","1","3",
"14 s","Permanent Residence","2007 ","8","4","4",
"14 s","Permanent Residence","2008 ","7","3","4",
"14 s","Permanent Residence","2009 ","6","1","5",
"14 s","Permanent Residence","2010 ","7","4","3",
"14 s","Permanent Residence","2011 ","4","2","2",
"14 s","Permanent Residence","2012 ","7","3","4",
"14 s","Permanent Residence","2013 ","3","2","1",
"14 s","Permanent Residence","2014 ","6","4","2",
"14 s","Permanent Residence","2015 ","4","1","3",
"14 s","Permanent Residence","2016 ","6","4","2",
"14 s","Permanent Residence","2017 ","2","1","1",
"14 s","Permanent Residence","2018 ","2","0","2",
"14 s","Permanent Residence","2019 ","2","0","2",
"15 s","Total","2000 ","403","241","162",
"15 s","Total","2001 ","417","238","179",
"15 s","Total","2002 ","368","209","159",
"15 s","Total","2003 ","359","199","160",
"15 s","Total","2004 ","377","203","174",
"15 s","Total","2005 ","466","230","236",
"15 s","Total","2006 ","397","196","201",
"15 s","Total","2007 ","425","219","206",
"15 s","Total","2008 ","403","200","203",
"15 s","Total","2009 ","400","221","179",
"15 s","Total","2010 ","480","244","236",
"15 s","Total","2011 ","580","293","287",
"15 s","Total","2012 ","615","314","301",
"15 s","Total","2013 ","613","309","304",
"15 s","Total","2014 ","657","365","292",
"15 s","Total","2015 ","648","360","288",
"15 s","Total","2016 ","694","375","319",
"15 s","Total","2017 ","643","344","299",
"15 s","Total","2018 ","674","329","345",
"15 s","Total","2019 ","711","335","376",
"15 s","Sightseeing Pass","2000 ","89","41","48",
"15 s","Sightseeing Pass","2001 ","119","63","56",
"15 s","Sightseeing Pass","2002 ","94","56","38",
"15 s","Sightseeing Pass","2003 ","75","37","38",
"15 s","Sightseeing Pass","2004 ","99","48","51",
"15 s","Sightseeing Pass","2005 ","90","46","44",
"15 s","Sightseeing Pass","2006 ","63","32","31",
"15 s","Sightseeing Pass","2007 ","68","41","27",
"15 s","Sightseeing Pass","2008 ","84","43","41",
"15 s","Sightseeing Pass","2009 ","104","59","45",
"15 s","Sightseeing Pass","2010 ","116","63","53",
"15 s","Sightseeing Pass","2011 ","147","72","75",
"15 s","Sightseeing Pass","2012 ","165","80","85",
"15 s","Sightseeing Pass","2013 ","142","76","66",
"15 s","Sightseeing Pass","2014 ","131","72","59",
"15 s","Sightseeing Pass","2015 ","126","71","55",
"15 s","Sightseeing Pass","2016 ","123","73","50",
"15 s","Sightseeing Pass","2017 ","105","43","62",
"15 s","Sightseeing Pass","2018 ","122","61","61",
"15 s","Sightseeing Pass","2019 ","106","45","61",
"15 s","Short-term Business","2000 ","7","4","3",
"15 s","Short-term Business","2001 ","7","4","3",
"15 s","Short-term Business","2002 ","2","0","2",
"15 s","Short-term Business","2003 ","1","1","0",
"15 s","Short-term Business","2004 ","0","0","0",
"15 s","Short-term Business","2005 ","2","2","0",
"15 s","Short-term Business","2006 ","3","2","1",
"15 s","Short-term Business","2007 ","2","1","1",
"15 s","Short-term Business","2008 ","1","1","0",
"15 s","Short-term Business","2009 ","0","0","0",
"15 s","Short-term Business","2010 ","2","1","1",
"15 s","Short-term Business","2011 ","3","2","1",
"15 s","Short-term Visitors","2000 ","121","66","55",
"15 s","Short-term Visitors","2001 ","162","96","66",
"15 s","Short-term Visitors","2002 ","120","75","45",
"15 s","Short-term Visitors","2003 ","101","62","39",
"15 s","Short-term Visitors","2004 ","65","40","25",
"15 s","Short-term Visitors","2005 ","95","46","49",
"15 s","Short-term Visitors","2006 ","78","45","33",
"15 s","Short-term Visitors","2007 ","93","45","48",
"15 s","Short-term Visitors","2008 ","116","60","56",
"15 s","Short-term Visitors","2009 ","71","42","29",
"15 s","Short-term Visitors","2010 ","72","37","35",
"15 s","Short-term Visitors","2011 ","160","91","69",
"15 s","Short-term Visitors","2012 ","265","142","123",
"15 s","Short-term Visitors","2013 ","280","143","137",
"15 s","Short-term Visitors","2014 ","322","180","142",
"15 s","Short-term Visitors","2015 ","341","174","167",
"15 s","Short-term Visitors","2016 ","354","195","159",
"15 s","Short-term Visitors","2017 ","297","173","124",
"15 s","Short-term Visitors","2018 ","250","116","134",
"15 s","Short-term Visitors","2019 ","254","131","123",
"15 s","Short-term Employment","2000 ","1","0","1",
"15 s","Short-term Employment","2001 ","5","0","5",
"15 s","Short-term Employment","2002 ","3","0","3",
"15 s","Short-term Employment","2003 ","11","2","9",
"15 s","Short-term Employment","2004 ","13","5","8",
"15 s","Short-term Employment","2005 ","16","5","11",
"15 s","Short-term Employment","2006 ","5","3","2",
"15 s","Short-term Employment","2007 ","9","5","4",
"15 s","Short-term Employment","2008 ","6","3","3",
"15 s","Short-term Employment","2009 ","1","1","0",
"15 s","Short-term Employment","2010 ","1","0","1",
"15 s","Short-term Employment","2011 ","2","0","2",
"15 s","Short-term Employment","2012 ","6","4","2",
"15 s","Short-term Employment","2014 ","1","0","1",
"15 s","Short-term Employment","2017 ","2","0","2",
"15 s","Short-term Employment","2019 ","1","0","1",
"15 s","Job Seeking","2000 ","0","0","0",
"15 s","Job Seeking","2001 ","0","0","0",
"15 s","Job Seeking","2002 ","0","0","0",
"15 s","Job Seeking","2003 ","0","0","0",
"15 s","Job Seeking","2004 ","0","0","0",
"15 s","Job Seeking","2005 ","0","0","0",
"15 s","Job Seeking","2006 ","0","0","0",
"15 s","Job Seeking","2007 ","0","0","0",
"15 s","Job Seeking","2008 ","0","0","0",
"15 s","Job Seeking","2009 ","0","0","0",
"15 s","Job Seeking","2010 ","0","0","0",
"15 s","study","2000 ","2","2","0",
"15 s","study","2001 ","2","2","0",
"15 s","study","2002 ","1","0","1",
"15 s","study","2003 ","1","1","0",
"15 s","study","2004 ","1","1","0",
"15 s","study","2005 ","5","4","1",
"15 s","study","2006 ","2","1","1",
"15 s","study","2007 ","5","2","3",
"15 s","study","2008 ","2","2","0",
"15 s","study","2009 ","2","1","1",
"15 s","study","2010 ","1","0","1",
"15 s","study","2011 ","1","1","0",
"15 s","study","2012 ","2","","2",
"15 s","study","2013 ","1","0","1",
"15 s","study","2016 ","1","0","1",
"15 s","study","2017 ","1","0","1",
"15 s","study","2018 ","1","0","1",
"15 s","General Trainees","2000 ","2","2","0",
"15 s","General Trainees","2001 ","0","0","0",
"15 s","General Trainees","2002 ","3","1","2",
"15 s","General Trainees","2003 ","4","1","3",
"15 s","General Trainees","2004 ","8","3","5",
"15 s","General Trainees","2005 ","7","4","3",
"15 s","General Trainees","2006 ","9","5","4",
"15 s","General Trainees","2007 ","16","11","5",
"15 s","General Trainees","2008 ","14","9","5",
"15 s","General Trainees","2009 ","12","7","5",
"15 s","General Trainees","2010 ","25","10","15",
"15 s","General Trainees","2011 ","31","15","16",
"15 s","General Trainees","2013 ","25","11","14",
"15 s","General Trainees","2014 ","31","12","19",
"15 s","General Trainees","2015 ","32","17","15",
"15 s","General Trainees","2016 ","41","15","26",
"15 s","General Trainees","2017 ","30","7","23",
"15 s","General Trainees","2018 ","42","13","29",
"15 s","General Trainees","2019 ","44","9","35",
"15 s","Religious Activities","2000 ","2","2","0",
"15 s","Religious Activities","2001 ","0","0","0",
"15 s","Religious Activities","2002 ","0","0","0",
"15 s","Religious Activities","2003 ","0","0","0",
"15 s","Religious Activities","2004 ","0","0","0",
"15 s","Religious Activities","2005 ","0","0","0",
"15 s","Religious Activities","2006 ","1","1","0",
"15 s","Religious Activities","2007 ","0","0","0",
"15 s","Religious Activities","2008 ","0","0","0",
"15 s","Religious Activities","2009 ","0","0","0",
"15 s","Religious Activities","2010 ","0","0","0",
"15 s","Religious Activities","2012 ","1","1","",
"15 s","Religious Activities","2017 ","1","0","1",
"15 s","Investors","2000 ","0","0","0",
"15 s","Investors","2001 ","0","0","0",
"15 s","Investors","2002 ","0","0","0",
"15 s","Investors","2003 ","0","0","0",
"15 s","Investors","2004 ","0","0","0",
"15 s","Investors","2005 ","0","0","0",
"15 s","Investors","2006 ","0","0","0",
"15 s","Investors","2007 ","0","0","0",
"15 s","Investors","2008 ","0","0","0",
"15 s","Investors","2009 ","0","0","0",
"15 s","Investors","2010 ","0","0","0",
"15 s","Trade and Business","2000 ","0","0","0",
"15 s","Trade and Business","2001 ","0","0","0",
"15 s","Trade and Business","2002 ","0","0","0",
"15 s","Trade and Business","2003 ","0","0","0",
"15 s","Trade and Business","2004 ","0","0","0",
"15 s","Trade and Business","2005 ","1","1","0",
"15 s","Trade and Business","2006 ","0","0","0",
"15 s","Trade and Business","2007 ","0","0","0",
"15 s","Trade and Business","2008 ","0","0","0",
"15 s","Trade and Business","2009 ","0","0","0",
"15 s","Trade and Business","2010 ","0","0","0",
"15 s","Research","2000 ","0","0","0",
"15 s","Research","2001 ","0","0","0",
"15 s","Research","2002 ","0","0","0",
"15 s","Research","2003 ","0","0","0",
"15 s","Research","2004 ","1","1","0",
"15 s","Research","2005 ","0","0","0",
"15 s","Research","2006 ","0","0","0",
"15 s","Research","2007 ","0","0","0",
"15 s","Research","2008 ","1","1","0",
"15 s","Research","2009 ","0","0","0",
"15 s","Research","2010 ","0","0","0",
"15 s","Art and Entertainment","2000 ","5","3","2",
"15 s","Art and Entertainment","2001 ","7","3","4",
"15 s","Art and Entertainment","2002 ","9","1","8",
"15 s","Art and Entertainment","2003 ","10","4","6",
"15 s","Art and Entertainment","2004 ","15","6","9",
"15 s","Art and Entertainment","2005 ","42","18","24",
"15 s","Art and Entertainment","2006 ","26","7","19",
"15 s","Art and Entertainment","2007 ","19","7","12",
"15 s","Art and Entertainment","2008 ","14","5","9",
"15 s","Art and Entertainment","2009 ","7","2","5",
"15 s","Art and Entertainment","2010 ","19","10","9",
"15 s","Art and Entertainment","2011 ","19","11","8",
"15 s","Art and Entertainment","2012 ","14","7","7",
"15 s","Art and Entertainment","2013 ","20","7","13",
"15 s","Art and Entertainment","2014 ","20","11","9",
"15 s","Art and Entertainment","2015 ","17","14","3",
"15 s","Art and Entertainment","2016 ","11","9","2",
"15 s","Art and Entertainment","2017 ","11","5","6",
"15 s","Art and Entertainment","2018 ","13","6","7",
"15 s","Art and Entertainment","2019 ","14","6","8",
"15 s","Unskilled Employment","2000 ","0","0","0",
"15 s","Unskilled Employment","2001 ","0","0","0",
"15 s","Unskilled Employment","2002 ","0","0","0",
"15 s","Unskilled Employment","2003 ","0","0","0",
"15 s","Unskilled Employment","2004 ","0","0","0",
"15 s","Unskilled Employment","2005 ","2","1","1",
"15 s","Unskilled Employment","2006 ","0","0","0",
"15 s","Unskilled Employment","2007 ","0","0","0",
"15 s","Unskilled Employment","2008 ","0","0","0",
"15 s","Unskilled Employment","2009 ","0","0","0",
"15 s","Unskilled Employment","2010 ","0","0","0",
"15 s","Visiting and Joining Family","2000 ","20","9","11",
"15 s","Visiting and Joining Family","2001 ","20","10","10",
"15 s","Visiting and Joining Family","2002 ","45","23","22",
"15 s","Visiting and Joining Family","2003 ","52","26","26",
"15 s","Visiting and Joining Family","2004 ","67","32","35",
"15 s","Visiting and Joining Family","2005 ","104","43","61",
"15 s","Visiting and Joining Family","2006 ","123","57","66",
"15 s","Visiting and Joining Family","2007 ","148","66","82",
"15 s","Visiting and Joining Family","2008 ","101","45","56",
"15 s","Visiting and Joining Family","2009 ","135","67","68",
"15 s","Visiting and Joining Family","2010 ","180","89","91",
"15 s","Visiting and Joining Family","2011 ","90","37","53",
"15 s","Visiting and Joining Family","2012 ","32","16","16",
"15 s","Visiting and Joining Family","2013 ","26","11","15",
"15 s","Visiting and Joining Family","2014 ","36","20","16",
"15 s","Visiting and Joining Family","2015 ","29","18","11",
"15 s","Visiting and Joining Family","2016 ","51","26","25",
"15 s","Visiting and Joining Family","2017 ","61","39","22",
"15 s","Visiting and Joining Family","2018 ","79","41","38",
"15 s","Visiting and Joining Family","2019 ","126","50","76",
"15 s","Overseas Koreans","2000 ","4","1","3",
"15 s","Overseas Koreans","2001 ","4","3","1",
"15 s","Overseas Koreans","2002 ","5","4","1",
"15 s","Overseas Koreans","2003 ","8","6","2",
"15 s","Overseas Koreans","2004 ","4","4","0",
"15 s","Overseas Koreans","2005 ","2","2","0",
"15 s","Overseas Koreans","2006 ","2","1","1",
"15 s","Overseas Koreans","2007 ","4","3","1",
"15 s","Overseas Koreans","2008 ","3","1","2",
"15 s","Overseas Koreans","2009 ","8","5","3",
"15 s","Overseas Koreans","2010 ","8","3","5",
"15 s","Overseas Koreans","2011 ","14","5","9",
"15 s","Overseas Koreans","2012 ","14","5","9",
"15 s","Overseas Koreans","2013 ","12","6","6",
"15 s","Overseas Koreans","2014 ","9","6","3",
"15 s","Overseas Koreans","2015 ","8","5","3",
"15 s","Overseas Koreans","2016 ","15","8","7",
"15 s","Overseas Koreans","2017 ","19","8","11",
"15 s","Overseas Koreans","2018 ","13","8","5",
"15 s","Overseas Koreans","2019 ","11","5","6",
"15 s","Permanent Residence","2000 ","0","0","0",
"15 s","Permanent Residence","2001 ","0","0","0",
"15 s","Permanent Residence","2002 ","0","0","0",
"15 s","Permanent Residence","2003 ","1","0","1",
"15 s","Permanent Residence","2004 ","1","0","1",
"15 s","Permanent Residence","2005 ","3","3","0",
"15 s","Permanent Residence","2006 ","4","0","4",
"15 s","Permanent Residence","2007 ","3","3","0",
"15 s","Permanent Residence","2008 ","8","4","4",
"15 s","Permanent Residence","2009 ","4","3","1",
"15 s","Permanent Residence","2010 ","8","5","3",
"15 s","Permanent Residence","2011 ","7","6","1",
"15 s","Permanent Residence","2012 ","7","4","3",
"15 s","Permanent Residence","2013 ","2","0","2",
"15 s","Permanent Residence","2014 ","4","3","1",
"15 s","Permanent Residence","2015 ","5","3","2",
"15 s","Permanent Residence","2016 ","1","1","0",
"15 s","Permanent Residence","2017 ","4","2","2",
"15 s","Permanent Residence","2018 ","1","0","1",
"15 s","Permanent Residence","2019 ","1","1","0",
"16 s","Total","2000 ","459","253","206",
"16 s","Total","2001 ","395","219","176",
"16 s","Total","2002 ","472","244","228",
"16 s","Total","2003 ","434","225","209",
"16 s","Total","2004 ","457","254","203",
"16 s","Total","2005 ","585","270","315",
"16 s","Total","2006 ","655","333","322",
"16 s","Total","2007 ","652","355","297",
"16 s","Total","2008 ","665","341","324",
"16 s","Total","2009 ","551","272","279",
"16 s","Total","2010 ","675","327","348",
"16 s","Total","2011 ","807","403","404",
"16 s","Total","2012 ","878","448","430",
"16 s","Total","2013 ","813","414","399",
"16 s","Total","2014 ","908","517","391",
"16 s","Total","2015 ","885","461","424",
"16 s","Total","2016 ","953","473","480",
"16 s","Total","2017 ","941","511","430",
"16 s","Total","2018 ","1038","534","504",
"16 s","Total","2019 ","894","451","443",
"16 s","Sightseeing Pass","2000 ","90","34","56",
"16 s","Sightseeing Pass","2001 ","95","56","39",
"16 s","Sightseeing Pass","2002 ","104","61","43",
"16 s","Sightseeing Pass","2003 ","61","35","26",
"16 s","Sightseeing Pass","2004 ","85","47","38",
"16 s","Sightseeing Pass","2005 ","92","46","46",
"16 s","Sightseeing Pass","2006 ","84","43","41",
"16 s","Sightseeing Pass","2007 ","89","49","40",
"16 s","Sightseeing Pass","2008 ","83","37","46",
"16 s","Sightseeing Pass","2009 ","102","45","57",
"16 s","Sightseeing Pass","2010 ","89","39","50",
"16 s","Sightseeing Pass","2011 ","132","65","67",
"16 s","Sightseeing Pass","2012 ","139","60","79",
"16 s","Sightseeing Pass","2013 ","130","62","68",
"16 s","Sightseeing Pass","2014 ","131","82","49",
"16 s","Sightseeing Pass","2015 ","133","69","64",
"16 s","Sightseeing Pass","2016 ","109","51","58",
"16 s","Sightseeing Pass","2017 ","99","54","45",
"16 s","Sightseeing Pass","2018 ","140","97","43",
"16 s","Sightseeing Pass","2019 ","90","40","50",
"16 s","Short-term Business","2000 ","2","1","1",
"16 s","Short-term Business","2001 ","3","1","2",
"16 s","Short-term Business","2002 ","6","5","1",
"16 s","Short-term Business","2003 ","5","4","1",
"16 s","Short-term Business","2004 ","6","6","0",
"16 s","Short-term Business","2005 ","3","1","2",
"16 s","Short-term Business","2006 ","3","1","2",
"16 s","Short-term Business","2007 ","6","2","4",
"16 s","Short-term Business","2008 ","5","3","2",
"16 s","Short-term Business","2009 ","3","2","1",
"16 s","Short-term Business","2010 ","1","0","1",
"16 s","Short-term Business","2011 ","4","4","",
"16 s","Short-term Visitors","2000 ","113","71","42",
"16 s","Short-term Visitors","2001 ","143","89","54",
"16 s","Short-term Visitors","2002 ","156","87","69",
"16 s","Short-term Visitors","2003 ","91","47","44",
"16 s","Short-term Visitors","2004 ","92","56","36",
"16 s","Short-term Visitors","2005 ","104","48","56",
"16 s","Short-term Visitors","2006 ","136","70","66",
"16 s","Short-term Visitors","2007 ","147","89","58",
"16 s","Short-term Visitors","2008 ","188","98","90",
"16 s","Short-term Visitors","2009 ","98","45","53",
"16 s","Short-term Visitors","2010 ","101","49","52",
"16 s","Short-term Visitors","2011 ","240","132","108",
"16 s","Short-term Visitors","2012 ","403","229","174",
"16 s","Short-term Visitors","2013 ","387","207","180",
"16 s","Short-term Visitors","2014 ","358","213","145",
"16 s","Short-term Visitors","2015 ","401","229","172",
"16 s","Short-term Visitors","2016 ","403","222","181",
"16 s","Short-term Visitors","2017 ","315","179","136",
"16 s","Short-term Visitors","2018 ","277","143","134",
"16 s","Short-term Visitors","2019 ","256","133","123",
"16 s","Short-term Employment","2000 ","3","1","2",
"16 s","Short-term Employment","2001 ","3","0","3",
"16 s","Short-term Employment","2002 ","10","2","8",
"16 s","Short-term Employment","2003 ","29","14","15",
"16 s","Short-term Employment","2004 ","11","3","8",
"16 s","Short-term Employment","2005 ","12","3","9",
"16 s","Short-term Employment","2006 ","14","7","7",
"16 s","Short-term Employment","2007 ","8","2","6",
"16 s","Short-term Employment","2008 ","12","3","9",
"16 s","Short-term Employment","2009 ","0","0","0",
"16 s","Short-term Employment","2010 ","0","0","0",
"16 s","Short-term Employment","2012 ","4","3","1",
"16 s","Short-term Employment","2018 ","2","0","2",
"16 s","Job Seeking","2000 ","0","0","0",
"16 s","Job Seeking","2001 ","0","0","0",
"16 s","Job Seeking","2002 ","0","0","0",
"16 s","Job Seeking","2003 ","0","0","0",
"16 s","Job Seeking","2004 ","0","0","0",
"16 s","Job Seeking","2005 ","0","0","0",
"16 s","Job Seeking","2006 ","0","0","0",
"16 s","Job Seeking","2007 ","0","0","0",
"16 s","Job Seeking","2008 ","0","0","0",
"16 s","Job Seeking","2009 ","0","0","0",
"16 s","Job Seeking","2010 ","0","0","0",
"16 s","study","2000 ","3","2","1",
"16 s","study","2001 ","2","0","2",
"16 s","study","2002 ","5","4","1",
"16 s","study","2003 ","5","5","0",
"16 s","study","2004 ","9","7","2",
"16 s","study","2005 ","23","12","11",
"16 s","study","2006 ","34","21","13",
"16 s","study","2007 ","32","17","15",
"16 s","study","2008 ","21","9","12",
"16 s","study","2009 ","33","17","16",
"16 s","study","2010 ","19","6","13",
"16 s","study","2011 ","8","2","6",
"16 s","study","2012 ","12","4","8",
"16 s","study","2013 ","10","5","5",
"16 s","study","2014 ","18","10","8",
"16 s","study","2015 ","12","3","9",
"16 s","study","2016 ","19","7","12",
"16 s","study","2017 ","12","4","8",
"16 s","study","2018 ","25","7","18",
"16 s","study","2019 ","28","11","17",
"16 s","General Trainees","2000 ","8","3","5",
"16 s","General Trainees","2001 ","7","2","5",
"16 s","General Trainees","2002 ","7","4","3",
"16 s","General Trainees","2003 ","15","10","5",
"16 s","General Trainees","2004 ","29","15","14",
"16 s","General Trainees","2005 ","35","17","18",
"16 s","General Trainees","2006 ","54","24","30",
"16 s","General Trainees","2007 ","73","37","36",
"16 s","General Trainees","2008 ","76","40","36",
"16 s","General Trainees","2009 ","76","35","41",
"16 s","General Trainees","2010 ","92","38","54",
"16 s","General Trainees","2011 ","124","55","69",
"16 s","General Trainees","2013 ","90","36","54",
"16 s","General Trainees","2014 ","109","38","71",
"16 s","General Trainees","2015 ","128","41","87",
"16 s","General Trainees","2016 ","172","59","113",
"16 s","General Trainees","2017 ","153","60","93",
"16 s","General Trainees","2018 ","189","60","129",
"16 s","General Trainees","2019 ","104","31","73",
"16 s","Religious Activities","2000 ","1","0","1",
"16 s","Religious Activities","2001 ","3","1","2",
"16 s","Religious Activities","2002 ","2","0","2",
"16 s","Religious Activities","2003 ","0","0","0",
"16 s","Religious Activities","2004 ","0","0","0",
"16 s","Religious Activities","2005 ","0","0","0",
"16 s","Religious Activities","2006 ","1","1","0",
"16 s","Religious Activities","2007 ","1","1","0",
"16 s","Religious Activities","2008 ","0","0","0",
"16 s","Religious Activities","2009 ","0","0","0",
"16 s","Religious Activities","2010 ","2","2","0",
"16 s","Religious Activities","2012 ","1","","1",
"16 s","Religious Activities","2014 ","1","1","0",
"16 s","Religious Activities","2016 ","2","0","2",
"16 s","Investors","2000 ","0","0","0",
"16 s","Investors","2001 ","0","0","0",
"16 s","Investors","2002 ","0","0","0",
"16 s","Investors","2003 ","0","0","0",
"16 s","Investors","2004 ","0","0","0",
"16 s","Investors","2005 ","0","0","0",
"16 s","Investors","2006 ","0","0","0",
"16 s","Investors","2007 ","0","0","0",
"16 s","Investors","2008 ","0","0","0",
"16 s","Investors","2009 ","0","0","0",
"16 s","Investors","2010 ","0","0","0",
"16 s","Trade and Business","2000 ","0","0","0",
"16 s","Trade and Business","2001 ","0","0","0",
"16 s","Trade and Business","2002 ","0","0","0",
"16 s","Trade and Business","2003 ","0","0","0",
"16 s","Trade and Business","2004 ","0","0","0",
"16 s","Trade and Business","2005 ","0","0","0",
"16 s","Trade and Business","2006 ","0","0","0",
"16 s","Trade and Business","2007 ","0","0","0",
"16 s","Trade and Business","2008 ","0","0","0",
"16 s","Trade and Business","2009 ","0","0","0",
"16 s","Trade and Business","2010 ","0","0","0",
"16 s","Research","2000 ","0","0","0",
"16 s","Research","2001 ","0","0","0",
"16 s","Research","2002 ","0","0","0",
"16 s","Research","2003 ","0","0","0",
"16 s","Research","2004 ","0","0","0",
"16 s","Research","2005 ","0","0","0",
"16 s","Research","2006 ","0","0","0",
"16 s","Research","2007 ","0","0","0",
"16 s","Research","2008 ","0","0","0",
"16 s","Research","2009 ","0","0","0",
"16 s","Research","2010 ","0","0","0",
"16 s","Art and Entertainment","2000 ","11","5","6",
"16 s","Art and Entertainment","2001 ","9","1","8",
"16 s","Art and Entertainment","2002 ","9","3","6",
"16 s","Art and Entertainment","2003 ","10","2","8",
"16 s","Art and Entertainment","2004 ","29","13","16",
"16 s","Art and Entertainment","2005 ","54","18","36",
"16 s","Art and Entertainment","2006 ","29","11","18",
"16 s","Art and Entertainment","2007 ","18","7","11",
"16 s","Art and Entertainment","2008 ","20","7","13",
"16 s","Art and Entertainment","2009 ","15","8","7",
"16 s","Art and Entertainment","2010 ","9","2","7",
"16 s","Art and Entertainment","2011 ","20","10","10",
"16 s","Art and Entertainment","2012 ","15","11","4",
"16 s","Art and Entertainment","2013 ","23","9","14",
"16 s","Art and Entertainment","2014 ","23","12","11",
"16 s","Art and Entertainment","2015 ","27","18","9",
"16 s","Art and Entertainment","2016 ","20","9","11",
"16 s","Art and Entertainment","2017 ","18","11","7",
"16 s","Art and Entertainment","2018 ","14","8","6",
"16 s","Art and Entertainment","2019 ","17","10","7",
"16 s","Unskilled Employment","2000 ","0","0","0",
"16 s","Unskilled Employment","2001 ","0","0","0",
"16 s","Unskilled Employment","2002 ","0","0","0",
"16 s","Unskilled Employment","2003 ","2","2","0",
"16 s","Unskilled Employment","2004 ","0","0","0",
"16 s","Unskilled Employment","2005 ","6","6","0",
"16 s","Unskilled Employment","2006 ","2","2","0",
"16 s","Unskilled Employment","2007 ","1","1","0",
"16 s","Unskilled Employment","2008 ","0","0","0",
"16 s","Unskilled Employment","2009 ","0","0","0",
"16 s","Unskilled Employment","2010 ","0","0","0",
"16 s","Visiting and Joining Family","2000 ","23","10","13",
"16 s","Visiting and Joining Family","2001 ","18","7","11",
"16 s","Visiting and Joining Family","2002 ","31","15","16",
"16 s","Visiting and Joining Family","2003 ","59","26","33",
"16 s","Visiting and Joining Family","2004 ","77","34","43",
"16 s","Visiting and Joining Family","2005 ","136","63","73",
"16 s","Visiting and Joining Family","2006 ","211","103","108",
"16 s","Visiting and Joining Family","2007 ","210","109","101",
"16 s","Visiting and Joining Family","2008 ","193","107","86",
"16 s","Visiting and Joining Family","2009 ","157","84","73",
"16 s","Visiting and Joining Family","2010 ","272","140","132",
"16 s","Visiting and Joining Family","2011 ","134","58","76",
"16 s","Visiting and Joining Family","2012 ","44","21","23",
"16 s","Visiting and Joining Family","2013 ","44","24","20",
"16 s","Visiting and Joining Family","2014 ","62","37","25",
"16 s","Visiting and Joining Family","2015 ","53","32","21",
"16 s","Visiting and Joining Family","2016 ","71","44","27",
"16 s","Visiting and Joining Family","2017 ","76","38","38",
"16 s","Visiting and Joining Family","2018 ","107","58","49",
"16 s","Visiting and Joining Family","2019 ","149","72","77",
"16 s","Overseas Koreans","2000 ","1","1","0",
"16 s","Overseas Koreans","2001 ","4","3","1",
"16 s","Overseas Koreans","2002 ","6","5","1",
"16 s","Overseas Koreans","2003 ","7","5","2",
"16 s","Overseas Koreans","2004 ","4","2","2",
"16 s","Overseas Koreans","2005 ","6","4","2",
"16 s","Overseas Koreans","2006 ","6","3","3",
"16 s","Overseas Koreans","2007 ","8","3","5",
"16 s","Overseas Koreans","2008 ","4","3","1",
"16 s","Overseas Koreans","2009 ","11","6","5",
"16 s","Overseas Koreans","2010 ","10","4","6",
"16 s","Overseas Koreans","2011 ","16","10","6",
"16 s","Overseas Koreans","2012 ","16","9","7",
"16 s","Overseas Koreans","2013 ","17","7","10",
"16 s","Overseas Koreans","2014 ","15","7","8",
"16 s","Overseas Koreans","2015 ","14","10","4",
"16 s","Overseas Koreans","2016 ","21","10","11",
"16 s","Overseas Koreans","2017 ","23","12","11",
"16 s","Overseas Koreans","2018 ","23","12","11",
"16 s","Overseas Koreans","2019 ","23","13","10",
"16 s","Permanent Residence","2000 ","0","0","0",
"16 s","Permanent Residence","2001 ","0","0","0",
"16 s","Permanent Residence","2002 ","0","0","0",
"16 s","Permanent Residence","2003 ","1","1","0",
"16 s","Permanent Residence","2004 ","5","3","2",
"16 s","Permanent Residence","2005 ","2","1","1",
"16 s","Permanent Residence","2006 ","2","2","0",
"16 s","Permanent Residence","2007 ","6","5","1",
"16 s","Permanent Residence","2008 ","6","3","3",
"16 s","Permanent Residence","2009 ","4","2","2",
"16 s","Permanent Residence","2010 ","4","1","3",
"16 s","Permanent Residence","2011 ","14","10","4",
"16 s","Permanent Residence","2012 ","4","3","1",
"16 s","Permanent Residence","2013 ","5","4","1",
"16 s","Permanent Residence","2014 ","4","2","2",
"16 s","Permanent Residence","2016 ","2","2","0",
"16 s","Permanent Residence","2017 ","3","1","2",
"16 s","Permanent Residence","2019 ","2","1","1",
"16 s","Marriage Immigration","2012 ","1","","1",
"16 s","Marriage Immigration","2019 ","1","0","1",
"17 s","Total","2000 ","616","306","310",
"17 s","Total","2001 ","567","294","273",
"17 s","Total","2002 ","739","355","384",
"17 s","Total","2003 ","673","316","357",
"17 s","Total","2004 ","936","458","478",
"17 s","Total","2005 ","1103","473","630",
"17 s","Total","2006 ","1621","705","916",
"17 s","Total","2007 ","1627","821","806",
"17 s","Total","2008 ","1355","656","699",
"17 s","Total","2009 ","1006","475","531",
"17 s","Total","2010 ","1253","658","595",
"17 s","Total","2011 ","1450","743","707",
"17 s","Total","2012 ","1487","748","739",
"17 s","Total","2013 ","1469","721","748",
"17 s","Total","2014 ","1675","786","889",
"17 s","Total","2015 ","1759","802","957",
"17 s","Total","2016 ","2303","1058","1245",
"17 s","Total","2017 ","2677","1233","1444",
"17 s","Total","2018 ","2874","1311","1563",
"17 s","Total","2019 ","2402","1160","1242",
"17 s","Sightseeing Pass","2000 ","82","54","28",
"17 s","Sightseeing Pass","2001 ","100","62","38",
"17 s","Sightseeing Pass","2002 ","114","64","50",
"17 s","Sightseeing Pass","2003 ","73","47","26",
"17 s","Sightseeing Pass","2004 ","97","53","44",
"17 s","Sightseeing Pass","2005 ","107","50","57",
"17 s","Sightseeing Pass","2006 ","75","45","30",
"17 s","Sightseeing Pass","2007 ","76","38","38",
"17 s","Sightseeing Pass","2008 ","74","34","40",
"17 s","Sightseeing Pass","2009 ","97","46","51",
"17 s","Sightseeing Pass","2010 ","129","76","53",
"17 s","Sightseeing Pass","2011 ","142","63","79",
"17 s","Sightseeing Pass","2012 ","149","74","75",
"17 s","Sightseeing Pass","2013 ","138","68","70",
"17 s","Sightseeing Pass","2014 ","128","60","68",
"17 s","Sightseeing Pass","2015 ","120","66","54",
"17 s","Sightseeing Pass","2016 ","127","71","56",
"17 s","Sightseeing Pass","2017 ","106","62","44",
"17 s","Sightseeing Pass","2018 ","137","67","70",
"17 s","Sightseeing Pass","2019 ","79","50","29",
"17 s","Short-term Business","2000 ","15","11","4",
"17 s","Short-term Business","2001 ","20","13","7",
"17 s","Short-term Business","2002 ","21","12","9",
"17 s","Short-term Business","2003 ","15","6","9",
"17 s","Short-term Business","2004 ","17","7","10",
"17 s","Short-term Business","2005 ","16","5","11",
"17 s","Short-term Business","2006 ","34","16","18",
"17 s","Short-term Business","2007 ","41","17","24",
"17 s","Short-term Business","2008 ","13","11","2",
"17 s","Short-term Business","2009 ","6","4","2",
"17 s","Short-term Business","2010 ","7","7","0",
"17 s","Short-term Business","2011 ","9","9","",
"17 s","Short-term Visitors","2000 ","138","76","62",
"17 s","Short-term Visitors","2001 ","143","84","59",
"17 s","Short-term Visitors","2002 ","221","134","87",
"17 s","Short-term Visitors","2003 ","165","95","70",
"17 s","Short-term Visitors","2004 ","190","119","71",
"17 s","Short-term Visitors","2005 ","177","84","93",
"17 s","Short-term Visitors","2006 ","235","119","116",
"17 s","Short-term Visitors","2007 ","253","143","110",
"17 s","Short-term Visitors","2008 ","302","141","161",
"17 s","Short-term Visitors","2009 ","124","67","57",
"17 s","Short-term Visitors","2010 ","151","73","78",
"17 s","Short-term Visitors","2011 ","306","157","149",
"17 s","Short-term Visitors","2012 ","506","288","218",
"17 s","Short-term Visitors","2013 ","501","285","216",
"17 s","Short-term Visitors","2014 ","451","246","205",
"17 s","Short-term Visitors","2015 ","490","264","226",
"17 s","Short-term Visitors","2016 ","429","239","190",
"17 s","Short-term Visitors","2017 ","346","199","147",
"17 s","Short-term Visitors","2018 ","330","162","168",
"17 s","Short-term Visitors","2019 ","321","179","142",
"17 s","Short-term Employment","2000 ","1","1","0",
"17 s","Short-term Employment","2001 ","1","0","1",
"17 s","Short-term Employment","2002 ","13","1","12",
"17 s","Short-term Employment","2003 ","16","5","11",
"17 s","Short-term Employment","2004 ","14","6","8",
"17 s","Short-term Employment","2005 ","13","4","9",
"17 s","Short-term Employment","2006 ","15","6","9",
"17 s","Short-term Employment","2007 ","15","5","10",
"17 s","Short-term Employment","2008 ","4","1","3",
"17 s","Short-term Employment","2009 ","3","1","2",
"17 s","Short-term Employment","2010 ","2","0","2",
"17 s","Short-term Employment","2011 ","4","1","3",
"17 s","Short-term Employment","2012 ","6","1","5",
"17 s","Short-term Employment","2014 ","1","0","1",
"17 s","Short-term Employment","2015 ","1","0","1",
"17 s","Short-term Employment","2017 ","1","0","1",
"17 s","Job Seeking","2000 ","0","0","0",
"17 s","Job Seeking","2001 ","0","0","0",
"17 s","Job Seeking","2002 ","0","0","0",
"17 s","Job Seeking","2003 ","0","0","0",
"17 s","Job Seeking","2004 ","0","0","0",
"17 s","Job Seeking","2005 ","0","0","0",
"17 s","Job Seeking","2006 ","0","0","0",
"17 s","Job Seeking","2007 ","0","0","0",
"17 s","Job Seeking","2008 ","0","0","0",
"17 s","Job Seeking","2009 ","0","0","0",
"17 s","Job Seeking","2010 ","0","0","0",
"17 s","study","2000 ","5","4","1",
"17 s","study","2001 ","10","4","6",
"17 s","study","2002 ","21","8","13",
"17 s","study","2003 ","49","26","23",
"17 s","study","2004 ","122","62","60",
"17 s","study","2005 ","156","73","83",
"17 s","study","2006 ","247","139","108",
"17 s","study","2007 ","196","95","101",
"17 s","study","2008 ","113","49","64",
"17 s","study","2009 ","114","46","68",
"17 s","study","2010 ","101","34","67",
"17 s","study","2011 ","81","33","48",
"17 s","study","2012 ","85","33","52",
"17 s","study","2013 ","122","56","66",
"17 s","study","2014 ","121","47","74",
"17 s","study","2015 ","195","58","137",
"17 s","study","2016 ","199","61","138",
"17 s","study","2017 ","233","75","158",
"17 s","study","2018 ","264","94","170",
"17 s","study","2019 ","361","189","172",
"17 s","General Trainees","2000 ","26","9","17",
"17 s","General Trainees","2001 ","43","25","18",
"17 s","General Trainees","2002 ","46","30","16",
"17 s","General Trainees","2003 ","40","16","24",
"17 s","General Trainees","2004 ","101","51","50",
"17 s","General Trainees","2005 ","178","91","87",
"17 s","General Trainees","2006 ","285","145","140",
"17 s","General Trainees","2007 ","507","251","256",
"17 s","General Trainees","2008 ","407","216","191",
"17 s","General Trainees","2009 ","331","148","183",
"17 s","General Trainees","2010 ","404","191","213",
"17 s","General Trainees","2011 ","477","225","252",
"17 s","General Trainees","2012 ","450","206","244",
"17 s","General Trainees","2013 ","435","171","264",
"17 s","General Trainees","2014 ","586","212","374",
"17 s","General Trainees","2015 ","683","248","435",
"17 s","General Trainees","2016 ","1247","520","727",
"17 s","General Trainees","2017 ","1408","518","890",
"17 s","General Trainees","2018 ","1502","613","889",
"17 s","General Trainees","2019 ","1162","473","689",
"17 s","Religious Activities","2000 ","4","3","1",
"17 s","Religious Activities","2001 ","1","0","1",
"17 s","Religious Activities","2002 ","1","0","1",
"17 s","Religious Activities","2003 ","2","0","2",
"17 s","Religious Activities","2004 ","1","1","0",
"17 s","Religious Activities","2005 ","2","0","2",
"17 s","Religious Activities","2006 ","6","3","3",
"17 s","Religious Activities","2007 ","0","0","0",
"17 s","Religious Activities","2008 ","2","1","1",
"17 s","Religious Activities","2009 ","1","1","0",
"17 s","Religious Activities","2010 ","0","0","0",
"17 s","Religious Activities","2012 ","7","4","3",
"17 s","Religious Activities","2014 ","1","0","1",
"17 s","Religious Activities","2015 ","1","1","0",
"17 s","Religious Activities","2016 ","2","0","2",
"17 s","Religious Activities","2017 ","5","0","5",
"17 s","Religious Activities","2018 ","1","0","1",
"17 s","Religious Activities","2019 ","2","0","2",
"17 s","Investors","2000 ","0","0","0",
"17 s","Investors","2001 ","0","0","0",
"17 s","Investors","2002 ","0","0","0",
"17 s","Investors","2003 ","0","0","0",
"17 s","Investors","2004 ","0","0","0",
"17 s","Investors","2005 ","0","0","0",
"17 s","Investors","2006 ","0","0","0",
"17 s","Investors","2007 ","0","0","0",
"17 s","Investors","2008 ","0","0","0",
"17 s","Investors","2009 ","0","0","0",
"17 s","Investors","2010 ","0","0","0",
"17 s","Trade and Business","2000 ","0","0","0",
"17 s","Trade and Business","2001 ","0","0","0",
"17 s","Trade and Business","2002 ","1","0","1",
"17 s","Trade and Business","2003 ","0","0","0",
"17 s","Trade and Business","2004 ","0","0","0",
"17 s","Trade and Business","2005 ","0","0","0",
"17 s","Trade and Business","2006 ","0","0","0",
"17 s","Trade and Business","2007 ","0","0","0",
"17 s","Trade and Business","2008 ","0","0","0",
"17 s","Trade and Business","2009 ","0","0","0",
"17 s","Trade and Business","2010 ","0","0","0",
"17 s","Research","2000 ","0","0","0",
"17 s","Research","2001 ","0","0","0",
"17 s","Research","2002 ","0","0","0",
"17 s","Research","2003 ","0","0","0",
"17 s","Research","2004 ","0","0","0",
"17 s","Research","2005 ","2","1","1",
"17 s","Research","2006 ","0","0","0",
"17 s","Research","2007 ","0","0","0",
"17 s","Research","2008 ","0","0","0",
"17 s","Research","2009 ","0","0","0",
"17 s","Research","2010 ","0","0","0",
"17 s","Art and Entertainment","2000 ","14","5","9",
"17 s","Art and Entertainment","2001 ","17","8","9",
"17 s","Art and Entertainment","2002 ","11","5","6",
"17 s","Art and Entertainment","2003 ","10","7","3",
"17 s","Art and Entertainment","2004 ","28","15","13",
"17 s","Art and Entertainment","2005 ","37","12","25",
"17 s","Art and Entertainment","2006 ","42","11","31",
"17 s","Art and Entertainment","2007 ","24","8","16",
"17 s","Art and Entertainment","2008 ","29","10","19",
"17 s","Art and Entertainment","2009 ","14","5","9",
"17 s","Art and Entertainment","2010 ","15","11","4",
"17 s","Art and Entertainment","2011 ","32","21","11",
"17 s","Art and Entertainment","2012 ","21","8","13",
"17 s","Art and Entertainment","2013 ","30","19","11",
"17 s","Art and Entertainment","2014 ","23","13","10",
"17 s","Art and Entertainment","2015 ","21","12","9",
"17 s","Art and Entertainment","2016 ","18","10","8",
"17 s","Art and Entertainment","2017 ","18","10","8",
"17 s","Art and Entertainment","2018 ","9","3","6",
"17 s","Art and Entertainment","2019 ","14","3","11",
"17 s","Unskilled Employment","2000 ","0","0","0",
"17 s","Unskilled Employment","2001 ","0","0","0",
"17 s","Unskilled Employment","2002 ","0","0","0",
"17 s","Unskilled Employment","2003 ","0","0","0",
"17 s","Unskilled Employment","2004 ","1","0","1",
"17 s","Unskilled Employment","2005 ","1","1","0",
"17 s","Unskilled Employment","2006 ","2","2","0",
"17 s","Unskilled Employment","2007 ","0","0","0",
"17 s","Unskilled Employment","2008 ","1","1","0",
"17 s","Unskilled Employment","2009 ","0","0","0",
"17 s","Unskilled Employment","2010 ","0","0","0",
"17 s","Visiting and Joining Family","2000 ","8","4","4",
"17 s","Visiting and Joining Family","2001 ","15","9","6",
"17 s","Visiting and Joining Family","2002 ","33","15","18",
"17 s","Visiting and Joining Family","2003 ","51","18","33",
"17 s","Visiting and Joining Family","2004 ","101","56","45",
"17 s","Visiting and Joining Family","2005 ","182","92","90",
"17 s","Visiting and Joining Family","2006 ","307","159","148",
"17 s","Visiting and Joining Family","2007 ","387","217","170",
"17 s","Visiting and Joining Family","2008 ","284","143","141",
"17 s","Visiting and Joining Family","2009 ","226","131","95",
"17 s","Visiting and Joining Family","2010 ","320","205","115",
"17 s","Visiting and Joining Family","2011 ","200","122","78",
"17 s","Visiting and Joining Family","2012 ","73","35","38",
"17 s","Visiting and Joining Family","2013 ","48","24","24",
"17 s","Visiting and Joining Family","2014 ","53","27","26",
"17 s","Visiting and Joining Family","2015 ","51","34","17",
"17 s","Visiting and Joining Family","2016 ","72","43","29",
"17 s","Visiting and Joining Family","2017 ","72","43","29",
"17 s","Visiting and Joining Family","2018 ","91","45","46",
"17 s","Visiting and Joining Family","2019 ","90","45","45",
"17 s","Overseas Koreans","2000 ","4","2","2",
"17 s","Overseas Koreans","2001 ","5","4","1",
"17 s","Overseas Koreans","2002 ","2","1","1",
"17 s","Overseas Koreans","2003 ","5","1","4",
"17 s","Overseas Koreans","2004 ","5","5","0",
"17 s","Overseas Koreans","2005 ","4","1","3",
"17 s","Overseas Koreans","2006 ","5","1","4",
"17 s","Overseas Koreans","2007 ","9","5","4",
"17 s","Overseas Koreans","2008 ","8","6","2",
"17 s","Overseas Koreans","2009 ","6","4","2",
"17 s","Overseas Koreans","2010 ","19","7","12",
"17 s","Overseas Koreans","2011 ","29","19","10",
"17 s","Overseas Koreans","2012 ","26","11","15",
"17 s","Overseas Koreans","2013 ","22","9","13",
"17 s","Overseas Koreans","2014 ","26","13","13",
"17 s","Overseas Koreans","2015 ","26","18","8",
"17 s","Overseas Koreans","2016 ","23","15","8",
"17 s","Overseas Koreans","2017 ","25","15","10",
"17 s","Overseas Koreans","2018 ","48","21","27",
"17 s","Overseas Koreans","2019 ","26","11","15",
"17 s","Permanent Residence","2000 ","0","0","0",
"17 s","Permanent Residence","2001 ","0","0","0",
"17 s","Permanent Residence","2002 ","0","0","0",
"17 s","Permanent Residence","2003 ","1","1","0",
"17 s","Permanent Residence","2004 ","2","0","2",
"17 s","Permanent Residence","2005 ","2","2","0",
"17 s","Permanent Residence","2006 ","8","5","3",
"17 s","Permanent Residence","2007 ","7","4","3",
"17 s","Permanent Residence","2008 ","6","1","5",
"17 s","Permanent Residence","2009 ","7","3","4",
"17 s","Permanent Residence","2010 ","5","2","3",
"17 s","Permanent Residence","2011 ","10","8","2",
"17 s","Permanent Residence","2012 ","3","2","1",
"17 s","Permanent Residence","2013 ","4","2","2",
"17 s","Permanent Residence","2014 ","4","3","1",
"17 s","Permanent Residence","2015 ","5","2","3",
"17 s","Permanent Residence","2016 ","1","1","0",
"17 s","Permanent Residence","2017 ","2","1","1",
"17 s","Permanent Residence","2019 ","3","3","0",
"17 s","Marriage Immigration","2012 ","11","","11",
"17 s","Marriage Immigration","2013 ","4","0","4",
"17 s","Marriage Immigration","2014 ","3","0","3",
"17 s","Marriage Immigration","2015 ","1","0","1",
"17 s","Marriage Immigration","2018 ","1","0","1",
"18 s","Total","2000 ","1699","662","1037",
"18 s","Total","2001 ","1683","669","1014",
"18 s","Total","2002 ","2031","835","1196",
"18 s","Total","2003 ","1863","722","1141",
"18 s","Total","2004 ","2278","895","1383",
"18 s","Total","2005 ","3248","1223","2025",
"18 s","Total","2006 ","5675","2044","3631",
"18 s","Total","2007 ","5982","2249","3733",
"18 s","Total","2008 ","5776","2187","3589",
"18 s","Total","2009 ","4439","1382","3057",
"18 s","Total","2010 ","4719","1579","3140",
"18 s","Total","2011 ","4595","1850","2745",
"18 s","Total","2012 ","4573","1857","2716",
"18 s","Total","2013 ","4613","1812","2801",
"18 s","Total","2014 ","5632","2269","3363",
"18 s","Total","2015 ","5478","2292","3186",
"18 s","Total","2016 ","8402","3536","4866",
"18 s","Total","2017 ","10027","4476","5551",
"18 s","Total","2018 ","13456","5963","7493",
"18 s","Total","2019 ","13699","5734","7965",
"18 s","Sightseeing Pass","2000 ","140","78","62",
"18 s","Sightseeing Pass","2001 ","176","95","81",
"18 s","Sightseeing Pass","2002 ","228","129","99",
"18 s","Sightseeing Pass","2003 ","115","59","56",
"18 s","Sightseeing Pass","2004 ","144","82","62",
"18 s","Sightseeing Pass","2005 ","117","51","66",
"18 s","Sightseeing Pass","2006 ","135","58","77",
"18 s","Sightseeing Pass","2007 ","132","58","74",
"18 s","Sightseeing Pass","2008 ","161","79","82",
"18 s","Sightseeing Pass","2009 ","196","83","113",
"18 s","Sightseeing Pass","2010 ","277","137","140",
"18 s","Sightseeing Pass","2011 ","292","138","154",
"18 s","Sightseeing Pass","2012 ","257","120","137",
"18 s","Sightseeing Pass","2013 ","245","104","141",
"18 s","Sightseeing Pass","2014 ","234","119","115",
"18 s","Sightseeing Pass","2015 ","230","128","102",
"18 s","Sightseeing Pass","2016 ","210","105","105",
"18 s","Sightseeing Pass","2017 ","191","96","95",
"18 s","Sightseeing Pass","2018 ","248","128","120",
"18 s","Sightseeing Pass","2019 ","165","72","93",
"18 s","Short-term Business","2000 ","43","27","16",
"18 s","Short-term Business","2001 ","62","35","27",
"18 s","Short-term Business","2002 ","33","16","17",
"18 s","Short-term Business","2003 ","32","17","15",
"18 s","Short-term Business","2004 ","42","26","16",
"18 s","Short-term Business","2005 ","47","19","28",
"18 s","Short-term Business","2006 ","83","49","34",
"18 s","Short-term Business","2007 ","91","47","44",
"18 s","Short-term Business","2008 ","47","29","18",
"18 s","Short-term Business","2009 ","16","14","2",
"18 s","Short-term Business","2010 ","13","12","1",
"18 s","Short-term Business","2011 ","13","12","1",
"18 s","Short-term Visitors","2000 ","317","187","130",
"18 s","Short-term Visitors","2001 ","297","156","141",
"18 s","Short-term Visitors","2002 ","471","282","189",
"18 s","Short-term Visitors","2003 ","321","178","143",
"18 s","Short-term Visitors","2004 ","304","166","138",
"18 s","Short-term Visitors","2005 ","313","146","167",
"18 s","Short-term Visitors","2006 ","484","242","242",
"18 s","Short-term Visitors","2007 ","520","261","259",
"18 s","Short-term Visitors","2008 ","392","182","210",
"18 s","Short-term Visitors","2009 ","191","79","112",
"18 s","Short-term Visitors","2010 ","237","126","111",
"18 s","Short-term Visitors","2011 ","389","222","167",
"18 s","Short-term Visitors","2012 ","615","356","259",
"18 s","Short-term Visitors","2013 ","645","363","282",
"18 s","Short-term Visitors","2014 ","592","277","315",
"18 s","Short-term Visitors","2015 ","589","278","311",
"18 s","Short-term Visitors","2016 ","469","250","219",
"18 s","Short-term Visitors","2017 ","466","244","222",
"18 s","Short-term Visitors","2018 ","629","339","290",
"18 s","Short-term Visitors","2019 ","547","291","256",
"18 s","Short-term Employment","2000 ","2","0","2",
"18 s","Short-term Employment","2001 ","9","3","6",
"18 s","Short-term Employment","2002 ","13","4","9",
"18 s","Short-term Employment","2003 ","9","3","6",
"18 s","Short-term Employment","2004 ","17","7","10",
"18 s","Short-term Employment","2005 ","14","7","7",
"18 s","Short-term Employment","2006 ","20","10","10",
"18 s","Short-term Employment","2007 ","17","6","11",
"18 s","Short-term Employment","2008 ","7","4","3",
"18 s","Short-term Employment","2009 ","4","0","4",
"18 s","Short-term Employment","2010 ","4","1","3",
"18 s","Short-term Employment","2011 ","4","2","2",
"18 s","Short-term Employment","2012 ","13","5","8",
"18 s","Short-term Employment","2013 ","6","1","5",
"18 s","Short-term Employment","2014 ","3","0","3",
"18 s","Short-term Employment","2015 ","1","0","1",
"18 s","Short-term Employment","2016 ","2","0","2",
"18 s","Short-term Employment","2017 ","5","1","4",
"18 s","Short-term Employment","2018 ","2","2","0",
"18 s","Short-term Employment","2019 ","1","0","1",
"18 s","Job Seeking","2000 ","0","0","0",
"18 s","Job Seeking","2001 ","0","0","0",
"18 s","Job Seeking","2002 ","0","0","0",
"18 s","Job Seeking","2003 ","0","0","0",
"18 s","Job Seeking","2004 ","0","0","0",
"18 s","Job Seeking","2005 ","0","0","0",
"18 s","Job Seeking","2006 ","0","0","0",
"18 s","Job Seeking","2007 ","0","0","0",
"18 s","Job Seeking","2008 ","0","0","0",
"18 s","Job Seeking","2009 ","0","0","0",
"18 s","Job Seeking","2010 ","0","0","0",
"18 s","study","2000 ","41","14","27",
"18 s","study","2001 ","47","17","30",
"18 s","study","2002 ","86","36","50",
"18 s","study","2003 ","204","99","105",
"18 s","study","2004 ","360","182","178",
"18 s","study","2005 ","551","261","290",
"18 s","study","2006 ","1010","510","500",
"18 s","study","2007 ","989","475","514",
"18 s","study","2008 ","724","325","399",
"18 s","study","2009 ","668","278","390",
"18 s","study","2010 ","656","256","400",
"18 s","study","2011 ","518","179","339",
"18 s","study","2012 ","479","145","334",
"18 s","study","2013 ","560","158","402",
"18 s","study","2014 ","800","241","559",
"18 s","study","2015 ","945","306","639",
"18 s","study","2016 ","1166","406","760",
"18 s","study","2017 ","1258","428","830",
"18 s","study","2018 ","1708","665","1043",
"18 s","study","2019 ","2068","833","1235",
"18 s","General Trainees","2000 ","127","57","70",
"18 s","General Trainees","2001 ","145","68","77",
"18 s","General Trainees","2002 ","174","68","106",
"18 s","General Trainees","2003 ","169","84","85",
"18 s","General Trainees","2004 ","305","167","138",
"18 s","General Trainees","2005 ","559","322","237",
"18 s","General Trainees","2006 ","1264","664","600",
"18 s","General Trainees","2007 ","1925","948","977",
"18 s","General Trainees","2008 ","1829","924","905",
"18 s","General Trainees","2009 ","1372","638","734",
"18 s","General Trainees","2010 ","1381","628","753",
"18 s","General Trainees","2011 ","1482","708","774",
"18 s","General Trainees","2012 ","1646","792","854",
"18 s","General Trainees","2013 ","1817","795","1022",
"18 s","General Trainees","2014 ","2637","1062","1575",
"18 s","General Trainees","2015 ","2861","1186","1675",
"18 s","General Trainees","2016 ","5411","2265","3146",
"18 s","General Trainees","2017 ","6416","2865","3551",
"18 s","General Trainees","2018 ","8846","3926","4920",
"18 s","General Trainees","2019 ","9006","3851","5155",
"18 s","Religious Activities","2000 ","3","1","2",
"18 s","Religious Activities","2001 ","7","2","5",
"18 s","Religious Activities","2002 ","1","0","1",
"18 s","Religious Activities","2003 ","3","1","2",
"18 s","Religious Activities","2004 ","2","2","0",
"18 s","Religious Activities","2005 ","5","3","2",
"18 s","Religious Activities","2006 ","4","2","2",
"18 s","Religious Activities","2007 ","1","0","1",
"18 s","Religious Activities","2008 ","4","2","2",
"18 s","Religious Activities","2009 ","1","0","1",
"18 s","Religious Activities","2010 ","7","2","5",
"18 s","Religious Activities","2011 ","4","2","2",
"18 s","Religious Activities","2012 ","40","6","34",
"18 s","Religious Activities","2013 ","70","65","5",
"18 s","Religious Activities","2014 ","111","108","3",
"18 s","Religious Activities","2015 ","69","65","4",
"18 s","Religious Activities","2016 ","90","85","5",
"18 s","Religious Activities","2017 ","71","61","10",
"18 s","Religious Activities","2018 ","53","36","17",
"18 s","Religious Activities","2019 ","40","24","16",
"18 s","Investors","2000 ","1","1","0",
"18 s","Investors","2001 ","4","0","4",
"18 s","Investors","2002 ","0","0","0",
"18 s","Investors","2003 ","0","0","0",
"18 s","Investors","2004 ","0","0","0",
"18 s","Investors","2005 ","0","0","0",
"18 s","Investors","2006 ","1","1","0",
"18 s","Investors","2007 ","1","1","0",
"18 s","Investors","2008 ","0","0","0",
"18 s","Investors","2009 ","0","0","0",
"18 s","Investors","2010 ","0","0","0",
"18 s","Investors","2013 ","1","1","0",
"18 s","Trade and Business","2000 ","0","0","0",
"18 s","Trade and Business","2001 ","0","0","0",
"18 s","Trade and Business","2002 ","0","0","0",
"18 s","Trade and Business","2003 ","0","0","0",
"18 s","Trade and Business","2004 ","0","0","0",
"18 s","Trade and Business","2005 ","0","0","0",
"18 s","Trade and Business","2006 ","0","0","0",
"18 s","Trade and Business","2007 ","0","0","0",
"18 s","Trade and Business","2008 ","0","0","0",
"18 s","Trade and Business","2009 ","0","0","0",
"18 s","Trade and Business","2010 ","0","0","0",
"18 s","Trade and Business","2011 ","1","1","",
"18 s","Trade and Business","2012 ","1","1","",
"18 s","Trade and Business","2013 ","1","0","1",
"18 s","Research","2000 ","0","0","0",
"18 s","Research","2001 ","0","0","0",
"18 s","Research","2002 ","0","0","0",
"18 s","Research","2003 ","0","0","0",
"18 s","Research","2004 ","0","0","0",
"18 s","Research","2005 ","0","0","0",
"18 s","Research","2006 ","1","0","1",
"18 s","Research","2007 ","0","0","0",
"18 s","Research","2008 ","0","0","0",
"18 s","Research","2009 ","0","0","0",
"18 s","Research","2010 ","0","0","0",
"18 s","Art and Entertainment","2000 ","24","5","19",
"18 s","Art and Entertainment","2001 ","26","9","17",
"18 s","Art and Entertainment","2002 ","35","14","21",
"18 s","Art and Entertainment","2003 ","28","12","16",
"18 s","Art and Entertainment","2004 ","39","15","24",
"18 s","Art and Entertainment","2005 ","68","32","36",
"18 s","Art and Entertainment","2006 ","72","25","47",
"18 s","Art and Entertainment","2007 ","43","9","34",
"18 s","Art and Entertainment","2008 ","44","20","24",
"18 s","Art and Entertainment","2009 ","29","7","22",
"18 s","Art and Entertainment","2010 ","38","12","26",
"18 s","Art and Entertainment","2011 ","29","11","18",
"18 s","Art and Entertainment","2012 ","38","18","20",
"18 s","Art and Entertainment","2013 ","47","23","24",
"18 s","Art and Entertainment","2014 ","22","10","12",
"18 s","Art and Entertainment","2015 ","34","21","13",
"18 s","Art and Entertainment","2016 ","39","21","18",
"18 s","Art and Entertainment","2017 ","28","15","13",
"18 s","Art and Entertainment","2018 ","31","16","15",
"18 s","Art and Entertainment","2019 ","41","15","26",
"18 s","Unskilled Employment","2000 ","0","0","0",
"18 s","Unskilled Employment","2001 ","0","0","0",
"18 s","Unskilled Employment","2002 ","0","0","0",
"18 s","Unskilled Employment","2003 ","7","7","0",
"18 s","Unskilled Employment","2004 ","7","7","0",
"18 s","Unskilled Employment","2005 ","127","111","16",
"18 s","Unskilled Employment","2006 ","141","135","6",
"18 s","Unskilled Employment","2007 ","59","42","17",
"18 s","Unskilled Employment","2008 ","189","185","4",
"18 s","Unskilled Employment","2009 ","14","14","0",
"18 s","Unskilled Employment","2010 ","45","42","3",
"18 s","Unskilled Employment","2011 ","328","260","68",
"18 s","Unskilled Employment","2012 ","151","133","18",
"18 s","Unskilled Employment","2013 ","88","76","12",
"18 s","Unskilled Employment","2014 ","62","45","17",
"18 s","Unskilled Employment","2015 ","122","98","24",
"18 s","Unskilled Employment","2016 ","56","53","3",
"18 s","Unskilled Employment","2017 ","36","33","3",
"18 s","Unskilled Employment","2018 ","30","30","0",
"18 s","Unskilled Employment","2019 ","16","14","2",
"18 s","Visiting and Joining Family","2000 ","12","4","8",
"18 s","Visiting and Joining Family","2001 ","18","8","10",
"18 s","Visiting and Joining Family","2002 ","16","5","11",
"18 s","Visiting and Joining Family","2003 ","58","19","39",
"18 s","Visiting and Joining Family","2004 ","79","48","31",
"18 s","Visiting and Joining Family","2005 ","228","104","124",
"18 s","Visiting and Joining Family","2006 ","390","199","191",
"18 s","Visiting and Joining Family","2007 ","481","233","248",
"18 s","Visiting and Joining Family","2008 ","476","247","229",
"18 s","Visiting and Joining Family","2009 ","355","191","164",
"18 s","Visiting and Joining Family","2010 ","456","240","216",
"18 s","Visiting and Joining Family","2011 ","222","125","97",
"18 s","Visiting and Joining Family","2012 ","110","64","46",
"18 s","Visiting and Joining Family","2013 ","82","43","39",
"18 s","Visiting and Joining Family","2014 ","51","22","29",
"18 s","Visiting and Joining Family","2015 ","63","29","34",
"18 s","Visiting and Joining Family","2016 ","52","24","28",
"18 s","Visiting and Joining Family","2017 ","54","29","25",
"18 s","Visiting and Joining Family","2018 ","55","30","25",
"18 s","Visiting and Joining Family","2019 ","64","27","37",
"18 s","Overseas Koreans","2000 ","5","4","1",
"18 s","Overseas Koreans","2001 ","6","1","5",
"18 s","Overseas Koreans","2002 ","6","1","5",
"18 s","Overseas Koreans","2003 ","11","8","3",
"18 s","Overseas Koreans","2004 ","7","3","4",
"18 s","Overseas Koreans","2005 ","8","4","4",
"18 s","Overseas Koreans","2006 ","8","6","2",
"18 s","Overseas Koreans","2007 ","18","7","11",
"18 s","Overseas Koreans","2008 ","17","6","11",
"18 s","Overseas Koreans","2009 ","30","18","12",
"18 s","Overseas Koreans","2010 ","67","34","33",
"18 s","Overseas Koreans","2011 ","74","47","27",
"18 s","Overseas Koreans","2012 ","68","41","27",
"18 s","Overseas Koreans","2013 ","54","27","27",
"18 s","Overseas Koreans","2014 ","70","35","35",
"18 s","Overseas Koreans","2015 ","58","33","25",
"18 s","Overseas Koreans","2016 ","78","36","42",
"18 s","Overseas Koreans","2017 ","95","52","43",
"18 s","Overseas Koreans","2018 ","77","35","42",
"18 s","Overseas Koreans","2019 ","77","30","47",
"18 s","Permanent Residence","2000 ","0","0","0",
"18 s","Permanent Residence","2001 ","0","0","0",
"18 s","Permanent Residence","2002 ","0","0","0",
"18 s","Permanent Residence","2003 ","5","2","3",
"18 s","Permanent Residence","2004 ","2","1","1",
"18 s","Permanent Residence","2005 ","9","5","4",
"18 s","Permanent Residence","2006 ","6","1","5",
"18 s","Permanent Residence","2007 ","3","1","2",
"18 s","Permanent Residence","2008 ","11","6","5",
"18 s","Permanent Residence","2009 ","8","6","2",
"18 s","Permanent Residence","2010 ","11","2","9",
"18 s","Permanent Residence","2011 ","7","5","2",
"18 s","Permanent Residence","2012 ","5","4","1",
"18 s","Permanent Residence","2013 ","13","7","6",
"18 s","Permanent Residence","2014 ","14","7","7",
"18 s","Permanent Residence","2015 ","13","8","5",
"18 s","Permanent Residence","2016 ","10","6","4",
"18 s","Permanent Residence","2017 ","8","6","2",
"18 s","Permanent Residence","2018 ","3","2","1",
"18 s","Permanent Residence","2019 ","5","3","2",
"18 s","Marriage Immigration","2011 ","42","","42",
"18 s","Marriage Immigration","2012 ","784","1","783",
"18 s","Marriage Immigration","2013 ","624","0","624",
"18 s","Marriage Immigration","2014 ","398","0","398",
"18 s","Marriage Immigration","2015 ","181","0","181",
"18 s","Marriage Immigration","2016 ","285","0","285",
"18 s","Marriage Immigration","2017 ","282","0","282",
"18 s","Marriage Immigration","2018 ","373","0","373",
"18 s","Marriage Immigration","2019 ","468","0","468",
"19 s","Total","2000 ","3126","1302","1824",
"19 s","Total","2001 ","3145","1296","1849",
"19 s","Total","2002 ","3505","1454","2051",
"19 s","Total","2003 ","2823","1225","1598",
"19 s","Total","2004 ","3442","1455","1987",
"19 s","Total","2005 ","5306","2320","2986",
"19 s","Total","2006 ","8579","3726","4853",
"19 s","Total","2007 ","10689","4717","5972",
"19 s","Total","2008 ","10547","4935","5612",
"19 s","Total","2009 ","7830","3150","4680",
"19 s","Total","2010 ","7862","3056","4806",
"19 s","Total","2011 ","8005","3773","4232",
"19 s","Total","2012 ","8079","3691","4388",
"19 s","Total","2013 ","7842","3366","4476",
"19 s","Total","2014 ","8518","3443","5075",
"19 s","Total","2015 ","9269","3808","5461",
"19 s","Total","2016 ","11088","4576","6512",
"19 s","Total","2017 ","13232","5901","7331",
"19 s","Total","2018 ","15247","7148","8099",
"19 s","Total","2019 ","14368","6428","7940",
"19 s","Sightseeing Pass","2000 ","172","93","79",
"19 s","Sightseeing Pass","2001 ","255","146","109",
"19 s","Sightseeing Pass","2002 ","304","174","130",
"19 s","Sightseeing Pass","2003 ","156","77","79",
"19 s","Sightseeing Pass","2004 ","176","84","92",
"19 s","Sightseeing Pass","2005 ","148","61","87",
"19 s","Sightseeing Pass","2006 ","193","94","99",
"19 s","Sightseeing Pass","2007 ","199","88","111",
"19 s","Sightseeing Pass","2008 ","270","122","148",
"19 s","Sightseeing Pass","2009 ","365","192","173",
"19 s","Sightseeing Pass","2010 ","523","277","246",
"19 s","Sightseeing Pass","2011 ","415","218","197",
"19 s","Sightseeing Pass","2012 ","382","176","206",
"19 s","Sightseeing Pass","2013 ","302","146","156",
"19 s","Sightseeing Pass","2014 ","297","152","145",
"19 s","Sightseeing Pass","2015 ","373","201","172",
"19 s","Sightseeing Pass","2016 ","300","158","142",
"19 s","Sightseeing Pass","2017 ","247","123","124",
"19 s","Sightseeing Pass","2018 ","297","145","152",
"19 s","Sightseeing Pass","2019 ","193","79","114",
"19 s","Short-term Business","2000 ","83","62","21",
"19 s","Short-term Business","2001 ","133","86","47",
"19 s","Short-term Business","2002 ","91","43","48",
"19 s","Short-term Business","2003 ","60","31","29",
"19 s","Short-term Business","2004 ","54","33","21",
"19 s","Short-term Business","2005 ","62","30","32",
"19 s","Short-term Business","2006 ","118","70","48",
"19 s","Short-term Business","2007 ","151","92","59",
"19 s","Short-term Business","2008 ","96","60","36",
"19 s","Short-term Business","2009 ","37","33","4",
"19 s","Short-term Business","2010 ","22","18","4",
"19 s","Short-term Business","2011 ","16","16","",
"19 s","Short-term Visitors","2000 ","456","238","218",
"19 s","Short-term Visitors","2001 ","375","209","166",
"19 s","Short-term Visitors","2002 ","654","359","295",
"19 s","Short-term Visitors","2003 ","464","251","213",
"19 s","Short-term Visitors","2004 ","417","249","168",
"19 s","Short-term Visitors","2005 ","373","178","195",
"19 s","Short-term Visitors","2006 ","714","392","322",
"19 s","Short-term Visitors","2007 ","698","359","339",
"19 s","Short-term Visitors","2008 ","486","240","246",
"19 s","Short-term Visitors","2009 ","249","115","134",
"19 s","Short-term Visitors","2010 ","327","174","153",
"19 s","Short-term Visitors","2011 ","479","245","234",
"19 s","Short-term Visitors","2012 ","691","401","290",
"19 s","Short-term Visitors","2013 ","721","432","289",
"19 s","Short-term Visitors","2014 ","605","326","279",
"19 s","Short-term Visitors","2015 ","689","363","326",
"19 s","Short-term Visitors","2016 ","532","266","266",
"19 s","Short-term Visitors","2017 ","539","290","249",
"19 s","Short-term Visitors","2018 ","708","433","275",
"19 s","Short-term Visitors","2019 ","534","305","229",
"19 s","Short-term Employment","2000 ","4","1","3",
"19 s","Short-term Employment","2001 ","5","2","3",
"19 s","Short-term Employment","2002 ","11","1","10",
"19 s","Short-term Employment","2003 ","18","7","11",
"19 s","Short-term Employment","2004 ","14","3","11",
"19 s","Short-term Employment","2005 ","13","4","9",
"19 s","Short-term Employment","2006 ","23","12","11",
"19 s","Short-term Employment","2007 ","20","10","10",
"19 s","Short-term Employment","2008 ","23","12","11",
"19 s","Short-term Employment","2009 ","10","2","8",
"19 s","Short-term Employment","2010 ","6","3","3",
"19 s","Short-term Employment","2011 ","9","4","5",
"19 s","Short-term Employment","2012 ","7","3","4",
"19 s","Short-term Employment","2013 ","2","0","2",
"19 s","Short-term Employment","2014 ","5","2","3",
"19 s","Short-term Employment","2015 ","3","2","1",
"19 s","Short-term Employment","2016 ","3","1","2",
"19 s","Short-term Employment","2017 ","9","2","7",
"19 s","Short-term Employment","2018 ","2","2","0",
"19 s","Short-term Employment","2019 ","2","0","2",
"19 s","Job Seeking","2000 ","0","0","0",
"19 s","Job Seeking","2001 ","0","0","0",
"19 s","Job Seeking","2002 ","0","0","0",
"19 s","Job Seeking","2003 ","0","0","0",
"19 s","Job Seeking","2004 ","0","0","0",
"19 s","Job Seeking","2005 ","0","0","0",
"19 s","Job Seeking","2006 ","0","0","0",
"19 s","Job Seeking","2007 ","0","0","0",
"19 s","Job Seeking","2008 ","0","0","0",
"19 s","Job Seeking","2009 ","0","0","0",
"19 s","Job Seeking","2010 ","0","0","0",
"19 s","study","2000 ","76","34","42",
"19 s","study","2001 ","133","50","83",
"19 s","study","2002 ","239","91","148",
"19 s","study","2003 ","322","125","197",
"19 s","study","2004 ","705","322","383",
"19 s","study","2005 ","1126","529","597",
"19 s","study","2006 ","2081","968","1113",
"19 s","study","2007 ","2532","1208","1324",
"19 s","study","2008 ","2032","828","1204",
"19 s","study","2009 ","2106","837","1269",
"19 s","study","2010 ","1943","645","1298",
"19 s","study","2011 ","1481","434","1047",
"19 s","study","2012 ","1460","447","1013",
"19 s","study","2013 ","1929","468","1461",
"19 s","study","2014 ","2578","596","1982",
"19 s","study","2015 ","2846","717","2129",
"19 s","study","2016 ","3466","873","2593",
"19 s","study","2017 ","3855","1022","2833",
"19 s","study","2018 ","4654","1387","3267",
"19 s","study","2019 ","4483","1406","3077",
"19 s","General Trainees","2000 ","75","34","41",
"19 s","General Trainees","2001 ","152","64","88",
"19 s","General Trainees","2002 ","135","79","56",
"19 s","General Trainees","2003 ","197","107","90",
"19 s","General Trainees","2004 ","457","260","197",
"19 s","General Trainees","2005 ","721","371","350",
"19 s","General Trainees","2006 ","1851","1013","838",
"19 s","General Trainees","2007 ","3279","1828","1451",
"19 s","General Trainees","2008 ","3010","1636","1374",
"19 s","General Trainees","2009 ","2135","1115","1020",
"19 s","General Trainees","2010 ","1881","968","913",
"19 s","General Trainees","2011 ","1908","999","909",
"19 s","General Trainees","2012 ","1791","871","920",
"19 s","General Trainees","2013 ","1921","950","971",
"19 s","General Trainees","2014 ","2441","1119","1322",
"19 s","General Trainees","2015 ","2726","1265","1461",
"19 s","General Trainees","2016 ","3959","1931","2028",
"19 s","General Trainees","2017 ","5177","2809","2368",
"19 s","General Trainees","2018 ","5637","3144","2493",
"19 s","General Trainees","2019 ","5509","2892","2617",
"19 s","Religious Activities","2000 ","173","168","5",
"19 s","Religious Activities","2001 ","172","164","8",
"19 s","Religious Activities","2002 ","163","158","5",
"19 s","Religious Activities","2003 ","151","144","7",
"19 s","Religious Activities","2004 ","121","115","6",
"19 s","Religious Activities","2005 ","134","131","3",
"19 s","Religious Activities","2006 ","130","125","5",
"19 s","Religious Activities","2007 ","148","144","4",
"19 s","Religious Activities","2008 ","128","124","4",
"19 s","Religious Activities","2009 ","91","87","4",
"19 s","Religious Activities","2010 ","81","77","4",
"19 s","Religious Activities","2011 ","77","74","3",
"19 s","Religious Activities","2012 ","351","131","220",
"19 s","Religious Activities","2013 ","186","138","48",
"19 s","Religious Activities","2014 ","112","72","40",
"19 s","Religious Activities","2015 ","116","45","71",
"19 s","Religious Activities","2016 ","112","56","56",
"19 s","Religious Activities","2017 ","96","29","67",
"19 s","Religious Activities","2018 ","76","26","50",
"19 s","Religious Activities","2019 ","78","21","57",
"19 s","Investors","2000 ","4","2","2",
"19 s","Investors","2001 ","3","2","1",
"19 s","Investors","2002 ","2","1","1",
"19 s","Investors","2003 ","0","0","0",
"19 s","Investors","2004 ","0","0","0",
"19 s","Investors","2005 ","0","0","0",
"19 s","Investors","2006 ","1","1","0",
"19 s","Investors","2007 ","1","0","1",
"19 s","Investors","2008 ","1","1","0",
"19 s","Investors","2009 ","0","0","0",
"19 s","Investors","2010 ","1","1","0",
"19 s","Investors","2011 ","2","2","",
"19 s","Investors","2018 ","1","1","0",
"19 s","Trade and Business","2000 ","0","0","0",
"19 s","Trade and Business","2001 ","1","0","1",
"19 s","Trade and Business","2002 ","0","0","0",
"19 s","Trade and Business","2003 ","0","0","0",
"19 s","Trade and Business","2004 ","1","1","0",
"19 s","Trade and Business","2005 ","0","0","0",
"19 s","Trade and Business","2006 ","1","1","0",
"19 s","Trade and Business","2007 ","1","0","1",
"19 s","Trade and Business","2008 ","1","1","0",
"19 s","Trade and Business","2009 ","0","0","0",
"19 s","Trade and Business","2010 ","0","0","0",
"19 s","Trade and Business","2011 ","1","1","",
"19 s","Trade and Business","2012 ","1","1","",
"19 s","Trade and Business","2013 ","1","1","0",
"19 s","Trade and Business","2014 ","1","0","1",
"19 s","Research","2000 ","0","0","0",
"19 s","Research","2001 ","0","0","0",
"19 s","Research","2002 ","0","0","0",
"19 s","Research","2003 ","1","0","1",
"19 s","Research","2004 ","1","0","1",
"19 s","Research","2005 ","0","0","0",
"19 s","Research","2006 ","0","0","0",
"19 s","Research","2007 ","1","0","1",
"19 s","Research","2008 ","0","0","0",
"19 s","Research","2009 ","0","0","0",
"19 s","Research","2010 ","0","0","0",
"19 s","Art and Entertainment","2000 ","489","18","471",
"19 s","Art and Entertainment","2001 ","462","24","438",
"19 s","Art and Entertainment","2002 ","330","19","311",
"19 s","Art and Entertainment","2003 ","175","16","159",
"19 s","Art and Entertainment","2004 ","171","20","151",
"19 s","Art and Entertainment","2005 ","292","48","244",
"19 s","Art and Entertainment","2006 ","177","31","146",
"19 s","Art and Entertainment","2007 ","164","25","139",
"19 s","Art and Entertainment","2008 ","153","21","132",
"19 s","Art and Entertainment","2009 ","165","17","148",
"19 s","Art and Entertainment","2010 ","113","22","91",
"19 s","Art and Entertainment","2011 ","67","21","46",
"19 s","Art and Entertainment","2012 ","75","20","55",
"19 s","Art and Entertainment","2013 ","92","16","76",
"19 s","Art and Entertainment","2014 ","110","24","86",
"19 s","Art and Entertainment","2015 ","97","21","76",
"19 s","Art and Entertainment","2016 ","57","23","34",
"19 s","Art and Entertainment","2017 ","33","12","21",
"19 s","Art and Entertainment","2018 ","34","18","16",
"19 s","Art and Entertainment","2019 ","49","24","25",
"19 s","Unskilled Employment","2000 ","0","0","0",
"19 s","Unskilled Employment","2001 ","0","0","0",
"19 s","Unskilled Employment","2002 ","0","0","0",
"19 s","Unskilled Employment","2003 ","5","3","2",
"19 s","Unskilled Employment","2004 ","22","17","5",
"19 s","Unskilled Employment","2005 ","722","609","113",
"19 s","Unskilled Employment","2006 ","608","573","35",
"19 s","Unskilled Employment","2007 ","534","427","107",
"19 s","Unskilled Employment","2008 ","1296","1191","105",
"19 s","Unskilled Employment","2009 ","417","385","32",
"19 s","Unskilled Employment","2010 ","413","376","37",
"19 s","Unskilled Employment","2011 ","1506","1343","163",
"19 s","Unskilled Employment","2012 ","1486","1323","163",
"19 s","Unskilled Employment","2013 ","1062","910","152",
"19 s","Unskilled Employment","2014 ","802","690","112",
"19 s","Unskilled Employment","2015 ","1073","901","172",
"19 s","Unskilled Employment","2016 ","990","829","161",
"19 s","Unskilled Employment","2017 ","790","638","152",
"19 s","Unskilled Employment","2018 ","934","850","84",
"19 s","Unskilled Employment","2019 ","865","795","70",
"19 s","Visiting and Joining Family","2000 ","21","6","15",
"19 s","Visiting and Joining Family","2001 ","18","6","12",
"19 s","Visiting and Joining Family","2002 ","32","6","26",
"19 s","Visiting and Joining Family","2003 ","42","11","31",
"19 s","Visiting and Joining Family","2004 ","88","38","50",
"19 s","Visiting and Joining Family","2005 ","208","102","106",
"19 s","Visiting and Joining Family","2006 ","347","184","163",
"19 s","Visiting and Joining Family","2007 ","541","281","260",
"19 s","Visiting and Joining Family","2008 ","510","299","211",
"19 s","Visiting and Joining Family","2009 ","367","201","166",
"19 s","Visiting and Joining Family","2010 ","572","299","273",
"19 s","Visiting and Joining Family","2011 ","257","143","114",
"19 s","Visiting and Joining Family","2012 ","125","69","56",
"19 s","Visiting and Joining Family","2013 ","87","45","42",
"19 s","Visiting and Joining Family","2014 ","38","21","17",
"19 s","Visiting and Joining Family","2015 ","33","11","22",
"19 s","Visiting and Joining Family","2016 ","28","10","18",
"19 s","Visiting and Joining Family","2017 ","36","11","25",
"19 s","Visiting and Joining Family","2018 ","60","25","35",
"19 s","Visiting and Joining Family","2019 ","48","22","26",
"19 s","Overseas Koreans","2000 ","7","4","3",
"19 s","Overseas Koreans","2001 ","19","11","8",
"19 s","Overseas Koreans","2002 ","23","14","9",
"19 s","Overseas Koreans","2003 ","14","6","8",
"19 s","Overseas Koreans","2004 ","16","8","8",
"19 s","Overseas Koreans","2005 ","13","6","7",
"19 s","Overseas Koreans","2006 ","22","10","12",
"19 s","Overseas Koreans","2007 ","25","8","17",
"19 s","Overseas Koreans","2008 ","37","18","19",
"19 s","Overseas Koreans","2009 ","46","34","12",
"19 s","Overseas Koreans","2010 ","83","44","39",
"19 s","Overseas Koreans","2011 ","122","64","58",
"19 s","Overseas Koreans","2012 ","123","68","55",
"19 s","Overseas Koreans","2013 ","103","53","50",
"19 s","Overseas Koreans","2014 ","106","49","57",
"19 s","Overseas Koreans","2015 ","133","59","74",
"19 s","Overseas Koreans","2016 ","145","62","83",
"19 s","Overseas Koreans","2017 ","123","64","59",
"19 s","Overseas Koreans","2018 ","109","59","50",
"19 s","Overseas Koreans","2019 ","118","67","51",
"19 s","Permanent Residence","2000 ","0","0","0",
"19 s","Permanent Residence","2001 ","0","0","0",
"19 s","Permanent Residence","2002 ","1","1","0",
"19 s","Permanent Residence","2003 ","2","1","1",
"19 s","Permanent Residence","2004 ","4","1","3",
"19 s","Permanent Residence","2005 ","2","0","2",
"19 s","Permanent Residence","2006 ","7","2","5",
"19 s","Permanent Residence","2007 ","4","2","2",
"19 s","Permanent Residence","2008 ","8","5","3",
"19 s","Permanent Residence","2009 ","10","7","3",
"19 s","Permanent Residence","2010 ","13","8","5",
"19 s","Permanent Residence","2011 ","11","5","6",
"19 s","Permanent Residence","2012 ","12","4","8",
"19 s","Permanent Residence","2013 ","14","7","7",
"19 s","Permanent Residence","2014 ","15","9","6",
"19 s","Permanent Residence","2015 ","18","7","11",
"19 s","Permanent Residence","2016 ","14","7","7",
"19 s","Permanent Residence","2017 ","10","4","6",
"19 s","Permanent Residence","2018 ","10","3","7",
"19 s","Permanent Residence","2019 ","6","3","3",
"19 s","Marriage Immigration","2011 ","49","","49",
"19 s","Marriage Immigration","2012 ","1145","","1145",
"19 s","Marriage Immigration","2013 ","981","0","981",
"19 s","Marriage Immigration","2014 ","587","0","587",
"19 s","Marriage Immigration","2015 ","666","0","666",
"19 s","Marriage Immigration","2016 ","739","0","739",
"19 s","Marriage Immigration","2017 ","626","1","625",
"19 s","Marriage Immigration","2018 ","638","1","637",
"19 s","Marriage Immigration","2019 ","712","2","710",
"20 s","Total","2000 ","5335","2565","2770",
"20 s","Total","2001 ","3966","1615","2351",
"20 s","Total","2002 ","4711","2096","2615",
"20 s","Total","2003 ","4696","2317","2379",
"20 s","Total","2004 ","4540","2053","2487",
"20 s","Total","2005 ","7124","3772","3352",
"20 s","Total","2006 ","9362","4599","4763",
"20 s","Total","2007 ","11350","5321","6029",
"20 s","Total","2008 ","12878","6142","6736",
"20 s","Total","2009 ","9122","3699","5423",
"20 s","Total","2010 ","10924","4495","6429",
"20 s","Total","2011 ","11350","5376","5974",
"20 s","Total","2012 ","11678","5597","6081",
"20 s","Total","2013 ","11658","5306","6352",
"20 s","Total","2014 ","12610","5518","7092",
"20 s","Total","2015 ","13366","5749","7617",
"20 s","Total","2016 ","15100","6421","8679",
"20 s","Total","2017 ","16445","7172","9273",
"20 s","Total","2018 ","18986","8706","10280",
"20 s","Total","2019 ","16661","7352","9309",
"20 s","Sightseeing Pass","2000 ","240","127","113",
"20 s","Sightseeing Pass","2001 ","336","197","139",
"20 s","Sightseeing Pass","2002 ","376","210","166",
"20 s","Sightseeing Pass","2003 ","185","87","98",
"20 s","Sightseeing Pass","2004 ","218","98","120",
"20 s","Sightseeing Pass","2005 ","199","87","112",
"20 s","Sightseeing Pass","2006 ","197","97","100",
"20 s","Sightseeing Pass","2007 ","227","106","121",
"20 s","Sightseeing Pass","2008 ","343","176","167",
"20 s","Sightseeing Pass","2009 ","401","192","209",
"20 s","Sightseeing Pass","2010 ","571","293","278",
"20 s","Sightseeing Pass","2011 ","513","225","288",
"20 s","Sightseeing Pass","2012 ","436","204","232",
"20 s","Sightseeing Pass","2013 ","352","163","189",
"20 s","Sightseeing Pass","2014 ","363","183","180",
"20 s","Sightseeing Pass","2015 ","389","206","183",
"20 s","Sightseeing Pass","2016 ","339","165","174",
"20 s","Sightseeing Pass","2017 ","302","124","178",
"20 s","Sightseeing Pass","2018 ","370","196","174",
"20 s","Sightseeing Pass","2019 ","259","105","154",
"20 s","Short-term Business","2000 ","140","104","36",
"20 s","Short-term Business","2001 ","183","114","69",
"20 s","Short-term Business","2002 ","154","93","61",
"20 s","Short-term Business","2003 ","87","36","51",
"20 s","Short-term Business","2004 ","74","47","27",
"20 s","Short-term Business","2005 ","55","32","23",
"20 s","Short-term Business","2006 ","166","110","56",
"20 s","Short-term Business","2007 ","287","190","97",
"20 s","Short-term Business","2008 ","155","113","42",
"20 s","Short-term Business","2009 ","43","34","9",
"20 s","Short-term Business","2010 ","31","30","1",
"20 s","Short-term Business","2011 ","33","31","2",
"20 s","Short-term Visitors","2000 ","562","310","252",
"20 s","Short-term Visitors","2001 ","488","282","206",
"20 s","Short-term Visitors","2002 ","848","498","350",
"20 s","Short-term Visitors","2003 ","642","315","327",
"20 s","Short-term Visitors","2004 ","484","279","205",
"20 s","Short-term Visitors","2005 ","563","289","274",
"20 s","Short-term Visitors","2006 ","823","414","409",
"20 s","Short-term Visitors","2007 ","995","529","466",
"20 s","Short-term Visitors","2008 ","792","393","399",
"20 s","Short-term Visitors","2009 ","377","172","205",
"20 s","Short-term Visitors","2010 ","499","247","252",
"20 s","Short-term Visitors","2011 ","638","358","280",
"20 s","Short-term Visitors","2012 ","882","492","390",
"20 s","Short-term Visitors","2013 ","1081","627","454",
"20 s","Short-term Visitors","2014 ","661","361","300",
"20 s","Short-term Visitors","2015 ","837","463","374",
"20 s","Short-term Visitors","2016 ","524","291","233",
"20 s","Short-term Visitors","2017 ","540","302","238",
"20 s","Short-term Visitors","2018 ","796","496","300",
"20 s","Short-term Visitors","2019 ","596","371","225",
"20 s","Short-term Employment","2000 ","6","4","2",
"20 s","Short-term Employment","2001 ","10","3","7",
"20 s","Short-term Employment","2002 ","13","7","6",
"20 s","Short-term Employment","2003 ","16","6","10",
"20 s","Short-term Employment","2004 ","17","6","11",
"20 s","Short-term Employment","2005 ","10","4","6",
"20 s","Short-term Employment","2006 ","19","9","10",
"20 s","Short-term Employment","2007 ","23","11","12",
"20 s","Short-term Employment","2008 ","36","22","14",
"20 s","Short-term Employment","2009 ","8","2","6",
"20 s","Short-term Employment","2010 ","11","3","8",
"20 s","Short-term Employment","2011 ","7","5","2",
"20 s","Short-term Employment","2012 ","10","5","5",
"20 s","Short-term Employment","2013 ","7","3","4",
"20 s","Short-term Employment","2014 ","3","0","3",
"20 s","Short-term Employment","2015 ","4","2","2",
"20 s","Short-term Employment","2016 ","2","0","2",
"20 s","Short-term Employment","2017 ","5","2","3",
"20 s","Short-term Employment","2018 ","1","1","0",
"20 s","Short-term Employment","2019 ","9","3","6",
"20 s","Job Seeking","2000 ","0","0","0",
"20 s","Job Seeking","2001 ","0","0","0",
"20 s","Job Seeking","2002 ","0","0","0",
"20 s","Job Seeking","2003 ","0","0","0",
"20 s","Job Seeking","2004 ","0","0","0",
"20 s","Job Seeking","2005 ","0","0","0",
"20 s","Job Seeking","2006 ","0","0","0",
"20 s","Job Seeking","2007 ","0","0","0",
"20 s","Job Seeking","2008 ","0","0","0",
"20 s","Job Seeking","2009 ","0","0","0",
"20 s","Job Seeking","2010 ","0","0","0",
"20 s","Job Seeking","2018 ","1","0","1",
"20 s","study","2000 ","181","70","111",
"20 s","study","2001 ","275","95","180",
"20 s","study","2002 ","442","145","297",
"20 s","study","2003 ","604","226","378",
"20 s","study","2004 ","1082","410","672",
"20 s","study","2005 ","1404","586","818",
"20 s","study","2006 ","2288","1032","1256",
"20 s","study","2007 ","3136","1323","1813",
"20 s","study","2008 ","3438","1315","2123",
"20 s","study","2009 ","3326","1144","2182",
"20 s","study","2010 ","3567","1081","2486",
"20 s","study","2011 ","3157","864","2293",
"20 s","study","2012 ","2914","745","2169",
"20 s","study","2013 ","3976","919","3057",
"20 s","study","2014 ","5032","1181","3851",
"20 s","study","2015 ","5598","1292","4306",
"20 s","study","2016 ","6543","1434","5109",
"20 s","study","2017 ","6511","1583","4928",
"20 s","study","2018 ","7539","1965","5574",
"20 s","study","2019 ","7095","1865","5230",
"20 s","General Trainees","2000 ","127","48","79",
"20 s","General Trainees","2001 ","139","56","83",
"20 s","General Trainees","2002 ","154","80","74",
"20 s","General Trainees","2003 ","253","114","139",
"20 s","General Trainees","2004 ","510","263","247",
"20 s","General Trainees","2005 ","514","257","257",
"20 s","General Trainees","2006 ","1355","719","636",
"20 s","General Trainees","2007 ","2610","1472","1138",
"20 s","General Trainees","2008 ","2536","1390","1146",
"20 s","General Trainees","2009 ","1948","1006","942",
"20 s","General Trainees","2010 ","1804","868","936",
"20 s","General Trainees","2011 ","1737","870","867",
"20 s","General Trainees","2012 ","1477","677","800",
"20 s","General Trainees","2013 ","1399","635","764",
"20 s","General Trainees","2014 ","1634","713","921",
"20 s","General Trainees","2015 ","2087","922","1165",
"20 s","General Trainees","2016 ","2770","1397","1373",
"20 s","General Trainees","2017 ","3323","1883","1440",
"20 s","General Trainees","2018 ","3608","2107","1501",
"20 s","General Trainees","2019 ","2885","1556","1329",
"20 s","Religious Activities","2000 ","27","21","6",
"20 s","Religious Activities","2001 ","22","13","9",
"20 s","Religious Activities","2002 ","24","19","5",
"20 s","Religious Activities","2003 ","24","16","8",
"20 s","Religious Activities","2004 ","29","23","6",
"20 s","Religious Activities","2005 ","22","17","5",
"20 s","Religious Activities","2006 ","37","31","6",
"20 s","Religious Activities","2007 ","20","18","2",
"20 s","Religious Activities","2008 ","27","20","7",
"20 s","Religious Activities","2009 ","13","10","3",
"20 s","Religious Activities","2010 ","27","21","6",
"20 s","Religious Activities","2011 ","12","6","6",
"20 s","Religious Activities","2012 ","565","112","453",
"20 s","Religious Activities","2013 ","68","19","49",
"20 s","Religious Activities","2014 ","29","14","15",
"20 s","Religious Activities","2015 ","32","13","19",
"20 s","Religious Activities","2016 ","30","10","20",
"20 s","Religious Activities","2017 ","31","10","21",
"20 s","Religious Activities","2018 ","23","8","15",
"20 s","Religious Activities","2019 ","20","6","14",
"20 s","Investors","2000 ","5","3","2",
"20 s","Investors","2001 ","2","2","0",
"20 s","Investors","2002 ","2","0","2",
"20 s","Investors","2003 ","0","0","0",
"20 s","Investors","2004 ","2","0","2",
"20 s","Investors","2005 ","2","0","2",
"20 s","Investors","2006 ","0","0","0",
"20 s","Investors","2007 ","2","1","1",
"20 s","Investors","2008 ","1","0","1",
"20 s","Investors","2009 ","1","1","0",
"20 s","Investors","2010 ","1","0","1",
"20 s","Investors","2012 ","1","1","",
"20 s","Investors","2017 ","1","1","0",
"20 s","Investors","2018 ","2","0","2",
"20 s","Investors","2019 ","1","1","0",
"20 s","Trade and Business","2000 ","0","0","0",
"20 s","Trade and Business","2001 ","0","0","0",
"20 s","Trade and Business","2002 ","1","1","0",
"20 s","Trade and Business","2003 ","0","0","0",
"20 s","Trade and Business","2004 ","2","2","0",
"20 s","Trade and Business","2005 ","0","0","0",
"20 s","Trade and Business","2006 ","0","0","0",
"20 s","Trade and Business","2007 ","0","0","0",
"20 s","Trade and Business","2008 ","1","1","0",
"20 s","Trade and Business","2009 ","0","0","0",
"20 s","Trade and Business","2010 ","0","0","0",
"20 s","Trade and Business","2011 ","2","2","",
"20 s","Trade and Business","2012 ","6","5","1",
"20 s","Trade and Business","2013 ","1","1","0",
"20 s","Trade and Business","2014 ","1","1","0",
"20 s","Trade and Business","2017 ","2","2","0",
"20 s","Trade and Business","2018 ","1","1","0",
"20 s","Trade and Business","2019 ","1","1","0",
"20 s","Research","2000 ","2","2","0",
"20 s","Research","2001 ","2","0","2",
"20 s","Research","2002 ","2","2","0",
"20 s","Research","2003 ","0","0","0",
"20 s","Research","2004 ","2","2","0",
"20 s","Research","2005 ","0","0","0",
"20 s","Research","2006 ","1","0","1",
"20 s","Research","2007 ","1","0","1",
"20 s","Research","2008 ","0","0","0",
"20 s","Research","2009 ","0","0","0",
"20 s","Research","2010 ","0","0","0",
"20 s","Research","2016 ","1","1","0",
"20 s","Art and Entertainment","2000 ","566","26","540",
"20 s","Art and Entertainment","2001 ","581","27","554",
"20 s","Art and Entertainment","2002 ","356","24","332",
"20 s","Art and Entertainment","2003 ","218","18","200",
"20 s","Art and Entertainment","2004 ","242","28","214",
"20 s","Art and Entertainment","2005 ","319","35","284",
"20 s","Art and Entertainment","2006 ","226","43","183",
"20 s","Art and Entertainment","2007 ","148","37","111",
"20 s","Art and Entertainment","2008 ","192","40","152",
"20 s","Art and Entertainment","2009 ","182","14","168",
"20 s","Art and Entertainment","2010 ","167","33","134",
"20 s","Art and Entertainment","2011 ","102","28","74",
"20 s","Art and Entertainment","2012 ","140","23","117",
"20 s","Art and Entertainment","2013 ","120","21","99",
"20 s","Art and Entertainment","2014 ","142","25","117",
"20 s","Art and Entertainment","2015 ","120","21","99",
"20 s","Art and Entertainment","2016 ","71","22","49",
"20 s","Art and Entertainment","2017 ","51","24","27",
"20 s","Art and Entertainment","2018 ","40","19","21",
"20 s","Art and Entertainment","2019 ","56","25","31",
"20 s","Unskilled Employment","2000 ","0","0","0",
"20 s","Unskilled Employment","2001 ","0","0","0",
"20 s","Unskilled Employment","2002 ","0","0","0",
"20 s","Unskilled Employment","2003 ","11","10","1",
"20 s","Unskilled Employment","2004 ","85","79","6",
"20 s","Unskilled Employment","2005 ","1796","1576","220",
"20 s","Unskilled Employment","2006 ","976","890","86",
"20 s","Unskilled Employment","2007 ","1385","1218","167",
"20 s","Unskilled Employment","2008 ","2395","2107","288",
"20 s","Unskilled Employment","2009 ","916","796","120",
"20 s","Unskilled Employment","2010 ","1618","1418","200",
"20 s","Unskilled Employment","2011 ","2859","2454","405",
"20 s","Unskilled Employment","2012 ","3220","2893","327",
"20 s","Unskilled Employment","2013 ","2756","2460","296",
"20 s","Unskilled Employment","2014 ","2524","2191","333",
"20 s","Unskilled Employment","2015 ","2682","2334","348",
"20 s","Unskilled Employment","2016 ","2775","2432","343",
"20 s","Unskilled Employment","2017 ","2216","1920","296",
"20 s","Unskilled Employment","2018 ","2582","2312","270",
"20 s","Unskilled Employment","2019 ","2352","2136","216",
"20 s","Visiting and Joining Family","2000 ","72","4","68",
"20 s","Visiting and Joining Family","2001 ","111","6","105",
"20 s","Visiting and Joining Family","2002 ","89","7","82",
"20 s","Visiting and Joining Family","2003 ","40","5","35",
"20 s","Visiting and Joining Family","2004 ","28","8","20",
"20 s","Visiting and Joining Family","2005 ","56","25","31",
"20 s","Visiting and Joining Family","2006 ","107","56","51",
"20 s","Visiting and Joining Family","2007 ","122","69","53",
"20 s","Visiting and Joining Family","2008 ","157","83","74",
"20 s","Visiting and Joining Family","2009 ","186","103","83",
"20 s","Visiting and Joining Family","2010 ","351","200","151",
"20 s","Visiting and Joining Family","2011 ","226","135","91",
"20 s","Visiting and Joining Family","2012 ","116","61","55",
"20 s","Visiting and Joining Family","2013 ","84","45","39",
"20 s","Visiting and Joining Family","2014 ","55","26","29",
"20 s","Visiting and Joining Family","2015 ","39","18","21",
"20 s","Visiting and Joining Family","2016 ","62","17","45",
"20 s","Visiting and Joining Family","2017 ","43","16","27",
"20 s","Visiting and Joining Family","2018 ","51","13","38",
"20 s","Visiting and Joining Family","2019 ","65","19","46",
"20 s","Overseas Koreans","2000 ","13","5","8",
"20 s","Overseas Koreans","2001 ","17","9","8",
"20 s","Overseas Koreans","2002 ","23","11","12",
"20 s","Overseas Koreans","2003 ","21","12","9",
"20 s","Overseas Koreans","2004 ","18","12","6",
"20 s","Overseas Koreans","2005 ","21","12","9",
"20 s","Overseas Koreans","2006 ","26","11","15",
"20 s","Overseas Koreans","2007 ","23","14","9",
"20 s","Overseas Koreans","2008 ","44","25","19",
"20 s","Overseas Koreans","2009 ","65","40","25",
"20 s","Overseas Koreans","2010 ","116","61","55",
"20 s","Overseas Koreans","2011 ","162","95","67",
"20 s","Overseas Koreans","2012 ","146","87","59",
"20 s","Overseas Koreans","2013 ","147","79","68",
"20 s","Overseas Koreans","2014 ","182","101","81",
"20 s","Overseas Koreans","2015 ","203","96","107",
"20 s","Overseas Koreans","2016 ","185","96","89",
"20 s","Overseas Koreans","2017 ","211","102","109",
"20 s","Overseas Koreans","2018 ","211","106","105",
"20 s","Overseas Koreans","2019 ","174","102","72",
"20 s","Permanent Residence","2000 ","0","0","0",
"20 s","Permanent Residence","2001 ","0","0","0",
"20 s","Permanent Residence","2002 ","0","0","0",
"20 s","Permanent Residence","2003 ","4","2","2",
"20 s","Permanent Residence","2004 ","10","4","6",
"20 s","Permanent Residence","2005 ","5","2","3",
"20 s","Permanent Residence","2006 ","6","1","5",
"20 s","Permanent Residence","2007 ","10","2","8",
"20 s","Permanent Residence","2008 ","13","6","7",
"20 s","Permanent Residence","2009 ","5","3","2",
"20 s","Permanent Residence","2010 ","12","6","6",
"20 s","Permanent Residence","2011 ","27","15","12",
"20 s","Permanent Residence","2012 ","22","14","8",
"20 s","Permanent Residence","2013 ","24","15","9",
"20 s","Permanent Residence","2014 ","19","13","6",
"20 s","Permanent Residence","2015 ","12","8","4",
"20 s","Permanent Residence","2016 ","20","15","5",
"20 s","Permanent Residence","2017 ","11","6","5",
"20 s","Permanent Residence","2018 ","14","7","7",
"20 s","Permanent Residence","2019 ","16","14","2",
"20 s","Marriage Immigration","2011 ","56","","56",
"20 s","Marriage Immigration","2012 ","1085","1","1084",
"20 s","Marriage Immigration","2013 ","990","0","990",
"20 s","Marriage Immigration","2014 ","578","0","578",
"20 s","Marriage Immigration","2015 ","573","2","571",
"20 s","Marriage Immigration","2016 ","646","1","645",
"20 s","Marriage Immigration","2017 ","615","2","613",
"20 s","Marriage Immigration","2018 ","606","0","606",
"20 s","Marriage Immigration","2019 ","575","2","573",
"21 s","Total","2000 ","6510","3521","2989",
"21 s","Total","2001 ","5454","2532","2922",
"21 s","Total","2002 ","5464","2710","2754",
"21 s","Total","2003 ","6579","3595","2984",
"21 s","Total","2004 ","6364","3425","2939",
"21 s","Total","2005 ","9110","5603","3507",
"21 s","Total","2006 ","10034","5656","4378",
"21 s","Total","2007 ","10427","5003","5424",
"21 s","Total","2008 ","12329","6381","5948",
"21 s","Total","2009 ","8854","3738","5116",
"21 s","Total","2010 ","11216","5019","6197",
"21 s","Total","2011 ","12419","6247","6172",
"21 s","Total","2012 ","12997","6924","6073",
"21 s","Total","2013 ","12558","6398","6160",
"21 s","Total","2014 ","13698","6846","6852",
"21 s","Total","2015 ","13345","6554","6791",
"21 s","Total","2016 ","15022","7314","7708",
"21 s","Total","2017 ","16174","8122","8052",
"21 s","Total","2018 ","18749","9574","9175",
"21 s","Total","2019 ","16567","8186","8381",
"21 s","Sightseeing Pass","2000 ","308","172","136",
"21 s","Sightseeing Pass","2001 ","422","252","170",
"21 s","Sightseeing Pass","2002 ","419","258","161",
"21 s","Sightseeing Pass","2003 ","234","120","114",
"21 s","Sightseeing Pass","2004 ","272","135","137",
"21 s","Sightseeing Pass","2005 ","224","97","127",
"21 s","Sightseeing Pass","2006 ","217","104","113",
"21 s","Sightseeing Pass","2007 ","289","124","165",
"21 s","Sightseeing Pass","2008 ","338","150","188",
"21 s","Sightseeing Pass","2009 ","434","199","235",
"21 s","Sightseeing Pass","2010 ","573","280","293",
"21 s","Sightseeing Pass","2011 ","525","257","268",
"21 s","Sightseeing Pass","2012 ","497","220","277",
"21 s","Sightseeing Pass","2013 ","392","182","210",
"21 s","Sightseeing Pass","2014 ","383","184","199",
"21 s","Sightseeing Pass","2015 ","457","244","213",
"21 s","Sightseeing Pass","2016 ","370","194","176",
"21 s","Sightseeing Pass","2017 ","334","166","168",
"21 s","Sightseeing Pass","2018 ","370","198","172",
"21 s","Sightseeing Pass","2019 ","280","118","162",
"21 s","Short-term Business","2000 ","264","195","69",
"21 s","Short-term Business","2001 ","290","204","86",
"21 s","Short-term Business","2002 ","168","91","77",
"21 s","Short-term Business","2003 ","146","87","59",
"21 s","Short-term Business","2004 ","123","78","45",
"21 s","Short-term Business","2005 ","92","67","25",
"21 s","Short-term Business","2006 ","207","142","65",
"21 s","Short-term Business","2007 ","326","219","107",
"21 s","Short-term Business","2008 ","179","123","56",
"21 s","Short-term Business","2009 ","48","38","10",
"21 s","Short-term Business","2010 ","40","31","9",
"21 s","Short-term Business","2011 ","63","51","12",
"21 s","Short-term Visitors","2000 ","830","439","391",
"21 s","Short-term Visitors","2001 ","620","336","284",
"21 s","Short-term Visitors","2002 ","829","474","355",
"21 s","Short-term Visitors","2003 ","715","366","349",
"21 s","Short-term Visitors","2004 ","549","307","242",
"21 s","Short-term Visitors","2005 ","575","279","296",
"21 s","Short-term Visitors","2006 ","899","460","439",
"21 s","Short-term Visitors","2007 ","1015","496","519",
"21 s","Short-term Visitors","2008 ","814","429","385",
"21 s","Short-term Visitors","2009 ","407","190","217",
"21 s","Short-term Visitors","2010 ","593","290","303",
"21 s","Short-term Visitors","2011 ","818","425","393",
"21 s","Short-term Visitors","2012 ","1093","579","514",
"21 s","Short-term Visitors","2013 ","1373","733","640",
"21 s","Short-term Visitors","2014 ","830","439","391",
"21 s","Short-term Visitors","2015 ","994","513","481",
"21 s","Short-term Visitors","2016 ","686","350","336",
"21 s","Short-term Visitors","2017 ","693","389","304",
"21 s","Short-term Visitors","2018 ","908","563","345",
"21 s","Short-term Visitors","2019 ","746","454","292",
"21 s","Short-term Employment","2000 ","9","6","3",
"21 s","Short-term Employment","2001 ","7","3","4",
"21 s","Short-term Employment","2002 ","12","8","4",
"21 s","Short-term Employment","2003 ","14","8","6",
"21 s","Short-term Employment","2004 ","18","7","11",
"21 s","Short-term Employment","2005 ","20","7","13",
"21 s","Short-term Employment","2006 ","15","10","5",
"21 s","Short-term Employment","2007 ","18","6","12",
"21 s","Short-term Employment","2008 ","16","9","7",
"21 s","Short-term Employment","2009 ","7","2","5",
"21 s","Short-term Employment","2010 ","7","3","4",
"21 s","Short-term Employment","2011 ","9","5","4",
"21 s","Short-term Employment","2012 ","15","8","7",
"21 s","Short-term Employment","2013 ","5","2","3",
"21 s","Short-term Employment","2014 ","4","1","3",
"21 s","Short-term Employment","2015 ","4","1","3",
"21 s","Short-term Employment","2016 ","3","1","2",
"21 s","Short-term Employment","2017 ","8","3","5",
"21 s","Short-term Employment","2018 ","4","2","2",
"21 s","Short-term Employment","2019 ","4","2","2",
"21 s","Job Seeking","2000 ","0","0","0",
"21 s","Job Seeking","2001 ","0","0","0",
"21 s","Job Seeking","2002 ","0","0","0",
"21 s","Job Seeking","2003 ","0","0","0",
"21 s","Job Seeking","2004 ","0","0","0",
"21 s","Job Seeking","2005 ","0","0","0",
"21 s","Job Seeking","2006 ","0","0","0",
"21 s","Job Seeking","2007 ","0","0","0",
"21 s","Job Seeking","2008 ","0","0","0",
"21 s","Job Seeking","2009 ","0","0","0",
"21 s","Job Seeking","2010 ","0","0","0",
"21 s","Job Seeking","2014 ","1","1","0",
"21 s","Job Seeking","2015 ","2","1","1",
"21 s","Job Seeking","2017 ","1","0","1",
"21 s","Job Seeking","2018 ","3","0","3",
"21 s","Job Seeking","2019 ","2","1","1",
"21 s","study","2000 ","195","87","108",
"21 s","study","2001 ","294","120","174",
"21 s","study","2002 ","429","172","257",
"21 s","study","2003 ","685","248","437",
"21 s","study","2004 ","1151","502","649",
"21 s","study","2005 ","1402","616","786",
"21 s","study","2006 ","1953","833","1120",
"21 s","study","2007 ","2320","947","1373",
"21 s","study","2008 ","2715","1113","1602",
"21 s","study","2009 ","2759","1016","1743",
"21 s","study","2010 ","3180","1006","2174",
"21 s","study","2011 ","3006","926","2080",
"21 s","study","2012 ","2757","882","1875",
"21 s","study","2013 ","3648","1101","2547",
"21 s","study","2014 ","4211","1151","3060",
"21 s","study","2015 ","4325","1242","3083",
"21 s","study","2016 ","4934","1300","3634",
"21 s","study","2017 ","4786","1457","3329",
"21 s","study","2018 ","5818","1723","4095",
"21 s","study","2019 ","5515","1775","3740",
"21 s","General Trainees","2000 ","120","66","54",
"21 s","General Trainees","2001 ","170","75","95",
"21 s","General Trainees","2002 ","147","62","85",
"21 s","General Trainees","2003 ","275","136","139",
"21 s","General Trainees","2004 ","523","263","260",
"21 s","General Trainees","2005 ","476","230","246",
"21 s","General Trainees","2006 ","939","491","448",
"21 s","General Trainees","2007 ","1583","847","736",
"21 s","General Trainees","2008 ","1761","864","897",
"21 s","General Trainees","2009 ","1368","629","739",
"21 s","General Trainees","2010 ","1572","655","917",
"21 s","General Trainees","2011 ","1656","738","918",
"21 s","General Trainees","2012 ","1350","642","708",
"21 s","General Trainees","2013 ","1248","505","743",
"21 s","General Trainees","2014 ","1457","597","860",
"21 s","General Trainees","2015 ","1697","693","1004",
"21 s","General Trainees","2016 ","2520","1172","1348",
"21 s","General Trainees","2017 ","2801","1452","1349",
"21 s","General Trainees","2018 ","2943","1653","1290",
"21 s","General Trainees","2019 ","2532","1349","1183",
"21 s","Religious Activities","2000 ","38","5","33",
"21 s","Religious Activities","2001 ","49","7","42",
"21 s","Religious Activities","2002 ","63","14","49",
"21 s","Religious Activities","2003 ","43","7","36",
"21 s","Religious Activities","2004 ","39","18","21",
"21 s","Religious Activities","2005 ","36","8","28",
"21 s","Religious Activities","2006 ","33","9","24",
"21 s","Religious Activities","2007 ","50","12","38",
"21 s","Religious Activities","2008 ","47","11","36",
"21 s","Religious Activities","2009 ","27","4","23",
"21 s","Religious Activities","2010 ","33","6","27",
"21 s","Religious Activities","2011 ","30","6","24",
"21 s","Religious Activities","2012 ","524","119","405",
"21 s","Religious Activities","2013 ","33","7","26",
"21 s","Religious Activities","2014 ","21","5","16",
"21 s","Religious Activities","2015 ","18","3","15",
"21 s","Religious Activities","2016 ","23","8","15",
"21 s","Religious Activities","2017 ","18","5","13",
"21 s","Religious Activities","2018 ","17","5","12",
"21 s","Religious Activities","2019 ","14","4","10",
"21 s","Investors","2000 ","9","4","5",
"21 s","Investors","2001 ","8","6","2",
"21 s","Investors","2002 ","5","4","1",
"21 s","Investors","2003 ","4","3","1",
"21 s","Investors","2004 ","2","1","1",
"21 s","Investors","2005 ","6","3","3",
"21 s","Investors","2006 ","2","2","0",
"21 s","Investors","2007 ","3","3","0",
"21 s","Investors","2008 ","2","2","0",
"21 s","Investors","2009 ","4","4","0",
"21 s","Investors","2010 ","5","4","1",
"21 s","Investors","2012 ","1","1","",
"21 s","Investors","2015 ","2","2","0",
"21 s","Investors","2017 ","1","0","1",
"21 s","Investors","2018 ","2","2","0",
"21 s","Investors","2019 ","1","1","0",
"21 s","Trade and Business","2000 ","1","1","0",
"21 s","Trade and Business","2001 ","1","0","1",
"21 s","Trade and Business","2002 ","1","0","1",
"21 s","Trade and Business","2003 ","0","0","0",
"21 s","Trade and Business","2004 ","1","1","0",
"21 s","Trade and Business","2005 ","0","0","0",
"21 s","Trade and Business","2006 ","0","0","0",
"21 s","Trade and Business","2007 ","1","0","1",
"21 s","Trade and Business","2008 ","1","1","0",
"21 s","Trade and Business","2009 ","1","0","1",
"21 s","Trade and Business","2010 ","0","0","0",
"21 s","Trade and Business","2012 ","1","1","",
"21 s","Trade and Business","2013 ","4","4","0",
"21 s","Trade and Business","2014 ","2","2","0",
"21 s","Trade and Business","2016 ","1","1","0",
"21 s","Trade and Business","2017 ","2","2","0",
"21 s","Trade and Business","2018 ","1","1","0",
"21 s","Trade and Business","2019 ","1","1","0",
"21 s","Research","2000 ","3","2","1",
"21 s","Research","2001 ","0","0","0",
"21 s","Research","2002 ","3","3","0",
"21 s","Research","2003 ","2","1","1",
"21 s","Research","2004 ","7","5","2",
"21 s","Research","2005 ","2","2","0",
"21 s","Research","2006 ","0","0","0",
"21 s","Research","2007 ","0","0","0",
"21 s","Research","2008 ","0","0","0",
"21 s","Research","2009 ","0","0","0",
"21 s","Research","2010 ","1","1","0",
"21 s","Research","2013 ","1","1","0",
"21 s","Research","2014 ","4","4","0",
"21 s","Research","2015 ","12","9","3",
"21 s","Research","2016 ","6","6","0",
"21 s","Research","2017 ","1","1","0",
"21 s","Art and Entertainment","2000 ","537","19","518",
"21 s","Art and Entertainment","2001 ","625","31","594",
"21 s","Art and Entertainment","2002 ","457","27","430",
"21 s","Art and Entertainment","2003 ","261","38","223",
"21 s","Art and Entertainment","2004 ","246","25","221",
"21 s","Art and Entertainment","2005 ","341","45","296",
"21 s","Art and Entertainment","2006 ","228","43","185",
"21 s","Art and Entertainment","2007 ","188","23","165",
"21 s","Art and Entertainment","2008 ","200","31","169",
"21 s","Art and Entertainment","2009 ","218","18","200",
"21 s","Art and Entertainment","2010 ","184","25","159",
"21 s","Art and Entertainment","2011 ","120","29","91",
"21 s","Art and Entertainment","2012 ","161","26","135",
"21 s","Art and Entertainment","2013 ","165","26","139",
"21 s","Art and Entertainment","2014 ","163","18","145",
"21 s","Art and Entertainment","2015 ","157","33","124",
"21 s","Art and Entertainment","2016 ","107","37","70",
"21 s","Art and Entertainment","2017 ","59","25","34",
"21 s","Art and Entertainment","2018 ","56","19","37",
"21 s","Art and Entertainment","2019 ","58","19","39",
"21 s","Unskilled Employment","2000 ","0","0","0",
"21 s","Unskilled Employment","2001 ","0","0","0",
"21 s","Unskilled Employment","2002 ","0","0","0",
"21 s","Unskilled Employment","2003 ","11","9","2",
"21 s","Unskilled Employment","2004 ","243","231","12",
"21 s","Unskilled Employment","2005 ","2568","2340","228",
"21 s","Unskilled Employment","2006 ","1370","1244","126",
"21 s","Unskilled Employment","2007 ","1940","1738","202",
"21 s","Unskilled Employment","2008 ","3312","2969","343",
"21 s","Unskilled Employment","2009 ","1343","1175","168",
"21 s","Unskilled Employment","2010 ","2295","2061","234",
"21 s","Unskilled Employment","2011 ","3439","3073","366",
"21 s","Unskilled Employment","2012 ","4080","3738","342",
"21 s","Unskilled Employment","2013 ","3534","3202","332",
"21 s","Unskilled Employment","2014 ","3654","3231","423",
"21 s","Unskilled Employment","2015 ","3424","3054","370",
"21 s","Unskilled Employment","2016 ","3614","3228","386",
"21 s","Unskilled Employment","2017 ","2926","2597","329",
"21 s","Unskilled Employment","2018 ","3419","3070","349",
"21 s","Unskilled Employment","2019 ","3126","2775","351",
"21 s","Visiting and Joining Family","2000 ","149","3","146",
"21 s","Visiting and Joining Family","2001 ","294","5","289",
"21 s","Visiting and Joining Family","2002 ","136","8","128",
"21 s","Visiting and Joining Family","2003 ","52","12","40",
"21 s","Visiting and Joining Family","2004 ","30","13","17",
"21 s","Visiting and Joining Family","2005 ","47","17","30",
"21 s","Visiting and Joining Family","2006 ","62","34","28",
"21 s","Visiting and Joining Family","2007 ","74","33","41",
"21 s","Visiting and Joining Family","2008 ","126","74","52",
"21 s","Visiting and Joining Family","2009 ","152","91","61",
"21 s","Visiting and Joining Family","2010 ","318","165","153",
"21 s","Visiting and Joining Family","2011 ","229","97","132",
"21 s","Visiting and Joining Family","2012 ","114","54","60",
"21 s","Visiting and Joining Family","2013 ","88","38","50",
"21 s","Visiting and Joining Family","2014 ","59","27","32",
"21 s","Visiting and Joining Family","2015 ","52","11","41",
"21 s","Visiting and Joining Family","2016 ","56","13","43",
"21 s","Visiting and Joining Family","2017 ","60","12","48",
"21 s","Visiting and Joining Family","2018 ","77","25","52",
"21 s","Visiting and Joining Family","2019 ","88","14","74",
"21 s","Overseas Koreans","2000 ","15","8","7",
"21 s","Overseas Koreans","2001 ","26","14","12",
"21 s","Overseas Koreans","2002 ","25","10","15",
"21 s","Overseas Koreans","2003 ","36","22","14",
"21 s","Overseas Koreans","2004 ","28","18","10",
"21 s","Overseas Koreans","2005 ","25","13","12",
"21 s","Overseas Koreans","2006 ","35","17","18",
"21 s","Overseas Koreans","2007 ","39","20","19",
"21 s","Overseas Koreans","2008 ","60","28","32",
"21 s","Overseas Koreans","2009 ","73","39","34",
"21 s","Overseas Koreans","2010 ","160","88","72",
"21 s","Overseas Koreans","2011 ","274","153","121",
"21 s","Overseas Koreans","2012 ","234","110","124",
"21 s","Overseas Koreans","2013 ","243","111","132",
"21 s","Overseas Koreans","2014 ","290","127","163",
"21 s","Overseas Koreans","2015 ","303","151","152",
"21 s","Overseas Koreans","2016 ","374","186","188",
"21 s","Overseas Koreans","2017 ","324","152","172",
"21 s","Overseas Koreans","2018 ","281","149","132",
"21 s","Overseas Koreans","2019 ","278","135","143",
"21 s","Permanent Residence","2000 ","0","0","0",
"21 s","Permanent Residence","2001 ","0","0","0",
"21 s","Permanent Residence","2002 ","0","0","0",
"21 s","Permanent Residence","2003 ","5","1","4",
"21 s","Permanent Residence","2004 ","2","2","0",
"21 s","Permanent Residence","2005 ","6","3","3",
"21 s","Permanent Residence","2006 ","5","2","3",
"21 s","Permanent Residence","2007 ","11","4","7",
"21 s","Permanent Residence","2008 ","15","6","9",
"21 s","Permanent Residence","2009 ","20","4","16",
"21 s","Permanent Residence","2010 ","23","11","12",
"21 s","Permanent Residence","2011 ","59","42","17",
"21 s","Permanent Residence","2012 ","63","30","33",
"21 s","Permanent Residence","2013 ","69","36","33",
"21 s","Permanent Residence","2014 ","38","24","14",
"21 s","Permanent Residence","2015 ","22","11","11",
"21 s","Permanent Residence","2016 ","26","23","3",
"21 s","Permanent Residence","2017 ","27","17","10",
"21 s","Permanent Residence","2018 ","23","9","14",
"21 s","Permanent Residence","2019 ","16","11","5",
"21 s","Marriage Immigration","2011 ","62","","62",
"21 s","Marriage Immigration","2012 ","1015","5","1010",
"21 s","Marriage Immigration","2013 ","822","1","821",
"21 s","Marriage Immigration","2014 ","606","2","604",
"21 s","Marriage Immigration","2015 ","626","2","624",
"21 s","Marriage Immigration","2016 ","611","2","609",
"21 s","Marriage Immigration","2017 ","582","2","580",
"21 s","Marriage Immigration","2018 ","587","0","587",
"21 s","Marriage Immigration","2019 ","521","2","519",
"22 s","Total","2000 ","6802","3847","2955",
"22 s","Total","2001 ","6231","2942","3289",
"22 s","Total","2002 ","6522","3290","3232",
"22 s","Total","2003 ","6834","3886","2948",
"22 s","Total","2004 ","7252","4085","3167",
"22 s","Total","2005 ","10122","6390","3732",
"22 s","Total","2006 ","10612","6230","4382",
"22 s","Total","2007 ","10421","5528","4893",
"22 s","Total","2008 ","12076","6480","5596",
"22 s","Total","2009 ","9427","4339","5088",
"22 s","Total","2010 ","11993","5815","6178",
"22 s","Total","2011 ","13354","7142","6212",
"22 s","Total","2012 ","14142","7762","6380",
"22 s","Total","2013 ","13787","7329","6458",
"22 s","Total","2014 ","14173","7623","6550",
"22 s","Total","2015 ","13493","7122","6371",
"22 s","Total","2016 ","14933","7734","7199",
"22 s","Total","2017 ","16296","8480","7816",
"22 s","Total","2018 ","19102","10100","9002",
"22 s","Total","2019 ","16879","8499","8380",
"22 s","Sightseeing Pass","2000 ","351","199","152",
"22 s","Sightseeing Pass","2001 ","546","317","229",
"22 s","Sightseeing Pass","2002 ","569","318","251",
"22 s","Sightseeing Pass","2003 ","308","143","165",
"22 s","Sightseeing Pass","2004 ","333","140","193",
"22 s","Sightseeing Pass","2005 ","319","132","187",
"22 s","Sightseeing Pass","2006 ","310","145","165",
"22 s","Sightseeing Pass","2007 ","300","149","151",
"22 s","Sightseeing Pass","2008 ","403","192","211",
"22 s","Sightseeing Pass","2009 ","498","246","252",
"22 s","Sightseeing Pass","2010 ","712","331","381",
"22 s","Sightseeing Pass","2011 ","595","261","334",
"22 s","Sightseeing Pass","2012 ","549","275","274",
"22 s","Sightseeing Pass","2013 ","465","224","241",
"22 s","Sightseeing Pass","2014 ","517","269","248",
"22 s","Sightseeing Pass","2015 ","509","291","218",
"22 s","Sightseeing Pass","2016 ","429","232","197",
"22 s","Sightseeing Pass","2017 ","388","194","194",
"22 s","Sightseeing Pass","2018 ","455","260","195",
"22 s","Sightseeing Pass","2019 ","302","131","171",
"22 s","Short-term Business","2000 ","350","263","87",
"22 s","Short-term Business","2001 ","400","271","129",
"22 s","Short-term Business","2002 ","200","115","85",
"22 s","Short-term Business","2003 ","139","89","50",
"22 s","Short-term Business","2004 ","175","127","48",
"22 s","Short-term Business","2005 ","118","84","34",
"22 s","Short-term Business","2006 ","227","145","82",
"22 s","Short-term Business","2007 ","333","231","102",
"22 s","Short-term Business","2008 ","241","178","63",
"22 s","Short-term Business","2009 ","69","58","11",
"22 s","Short-term Business","2010 ","69","61","8",
"22 s","Short-term Business","2011 ","71","64","7",
"22 s","Short-term Visitors","2000 ","1004","535","469",
"22 s","Short-term Visitors","2001 ","830","419","411",
"22 s","Short-term Visitors","2002 ","964","552","412",
"22 s","Short-term Visitors","2003 ","723","390","333",
"22 s","Short-term Visitors","2004 ","673","396","277",
"22 s","Short-term Visitors","2005 ","640","307","333",
"22 s","Short-term Visitors","2006 ","981","458","523",
"22 s","Short-term Visitors","2007 ","1004","479","525",
"22 s","Short-term Visitors","2008 ","925","418","507",
"22 s","Short-term Visitors","2009 ","450","198","252",
"22 s","Short-term Visitors","2010 ","629","315","314",
"22 s","Short-term Visitors","2011 ","973","511","462",
"22 s","Short-term Visitors","2012 ","1464","808","656",
"22 s","Short-term Visitors","2013 ","1776","952","824",
"22 s","Short-term Visitors","2014 ","994","518","476",
"22 s","Short-term Visitors","2015 ","1191","612","579",
"22 s","Short-term Visitors","2016 ","788","419","369",
"22 s","Short-term Visitors","2017 ","843","503","340",
"22 s","Short-term Visitors","2018 ","1059","660","399",
"22 s","Short-term Visitors","2019 ","861","530","331",
"22 s","Short-term Employment","2000 ","8","8","0",
"22 s","Short-term Employment","2001 ","9","5","4",
"22 s","Short-term Employment","2002 ","18","13","5",
"22 s","Short-term Employment","2003 ","15","12","3",
"22 s","Short-term Employment","2004 ","14","10","4",
"22 s","Short-term Employment","2005 ","15","7","8",
"22 s","Short-term Employment","2006 ","9","4","5",
"22 s","Short-term Employment","2007 ","27","7","20",
"22 s","Short-term Employment","2008 ","16","11","5",
"22 s","Short-term Employment","2009 ","11","4","7",
"22 s","Short-term Employment","2010 ","8","2","6",
"22 s","Short-term Employment","2011 ","9","4","5",
"22 s","Short-term Employment","2012 ","11","6","5",
"22 s","Short-term Employment","2013 ","2","1","1",
"22 s","Short-term Employment","2014 ","4","3","1",
"22 s","Short-term Employment","2015 ","6","0","6",
"22 s","Short-term Employment","2016 ","6","5","1",
"22 s","Short-term Employment","2017 ","8","6","2",
"22 s","Short-term Employment","2018 ","4","3","1",
"22 s","Short-term Employment","2019 ","2","1","1",
"22 s","Job Seeking","2000 ","0","0","0",
"22 s","Job Seeking","2001 ","0","0","0",
"22 s","Job Seeking","2002 ","0","0","0",
"22 s","Job Seeking","2003 ","0","0","0",
"22 s","Job Seeking","2004 ","0","0","0",
"22 s","Job Seeking","2005 ","0","0","0",
"22 s","Job Seeking","2006 ","0","0","0",
"22 s","Job Seeking","2007 ","0","0","0",
"22 s","Job Seeking","2008 ","0","0","0",
"22 s","Job Seeking","2009 ","0","0","0",
"22 s","Job Seeking","2010 ","0","0","0",
"22 s","Job Seeking","2011 ","1","1","",
"22 s","Job Seeking","2012 ","1","1","",
"22 s","Job Seeking","2013 ","4","0","4",
"22 s","Job Seeking","2014 ","3","2","1",
"22 s","Job Seeking","2015 ","7","4","3",
"22 s","Job Seeking","2016 ","5","2","3",
"22 s","Job Seeking","2017 ","10","3","7",
"22 s","Job Seeking","2018 ","12","5","7",
"22 s","Job Seeking","2019 ","5","1","4",
"22 s","study","2000 ","203","87","116",
"22 s","study","2001 ","272","115","157",
"22 s","study","2002 ","352","158","194",
"22 s","study","2003 ","467","222","245",
"22 s","study","2004 ","879","431","448",
"22 s","study","2005 ","1133","554","579",
"22 s","study","2006 ","1392","681","711",
"22 s","study","2007 ","1482","698","784",
"22 s","study","2008 ","1508","667","841",
"22 s","study","2009 ","1637","700","937",
"22 s","study","2010 ","2128","883","1245",
"22 s","study","2011 ","2142","833","1309",
"22 s","study","2012 ","2100","891","1209",
"22 s","study","2013 ","2453","972","1481",
"22 s","study","2014 ","2505","925","1580",
"22 s","study","2015 ","2707","944","1763",
"22 s","study","2016 ","3130","1033","2097",
"22 s","study","2017 ","3186","1096","2090",
"22 s","study","2018 ","4131","1433","2698",
"22 s","study","2019 ","4061","1426","2635",
"22 s","General Trainees","2000 ","98","45","53",
"22 s","General Trainees","2001 ","163","69","94",
"22 s","General Trainees","2002 ","132","64","68",
"22 s","General Trainees","2003 ","168","81","87",
"22 s","General Trainees","2004 ","385","201","184",
"22 s","General Trainees","2005 ","446","225","221",
"22 s","General Trainees","2006 ","735","372","363",
"22 s","General Trainees","2007 ","1037","512","525",
"22 s","General Trainees","2008 ","1193","513","680",
"22 s","General Trainees","2009 ","1120","454","666",
"22 s","General Trainees","2010 ","1300","537","763",
"22 s","General Trainees","2011 ","1363","602","761",
"22 s","General Trainees","2012 ","1338","549","789",
"22 s","General Trainees","2013 ","1294","506","788",
"22 s","General Trainees","2014 ","1462","515","947",
"22 s","General Trainees","2015 ","1687","609","1078",
"22 s","General Trainees","2016 ","2416","942","1474",
"22 s","General Trainees","2017 ","2670","1270","1400",
"22 s","General Trainees","2018 ","2766","1383","1383",
"22 s","General Trainees","2019 ","2460","1099","1361",
"22 s","Religious Activities","2000 ","17","4","13",
"22 s","Religious Activities","2001 ","29","9","20",
"22 s","Religious Activities","2002 ","34","5","29",
"22 s","Religious Activities","2003 ","22","4","18",
"22 s","Religious Activities","2004 ","20","8","12",
"22 s","Religious Activities","2005 ","26","12","14",
"22 s","Religious Activities","2006 ","32","9","23",
"22 s","Religious Activities","2007 ","22","6","16",
"22 s","Religious Activities","2008 ","32","10","22",
"22 s","Religious Activities","2009 ","18","4","14",
"22 s","Religious Activities","2010 ","24","4","20",
"22 s","Religious Activities","2011 ","23","2","21",
"22 s","Religious Activities","2012 ","230","73","157",
"22 s","Religious Activities","2013 ","26","5","21",
"22 s","Religious Activities","2014 ","16","4","12",
"22 s","Religious Activities","2015 ","23","7","16",
"22 s","Religious Activities","2016 ","24","6","18",
"22 s","Religious Activities","2017 ","14","4","10",
"22 s","Religious Activities","2018 ","15","7","8",
"22 s","Religious Activities","2019 ","14","3","11",
"22 s","Investors","2000 ","13","9","4",
"22 s","Investors","2001 ","8","4","4",
"22 s","Investors","2002 ","6","4","2",
"22 s","Investors","2003 ","2","2","0",
"22 s","Investors","2004 ","3","2","1",
"22 s","Investors","2005 ","7","5","2",
"22 s","Investors","2006 ","3","2","1",
"22 s","Investors","2007 ","5","4","1",
"22 s","Investors","2008 ","7","7","0",
"22 s","Investors","2009 ","3","3","0",
"22 s","Investors","2010 ","6","5","1",
"22 s","Investors","2011 ","1","1","",
"22 s","Investors","2012 ","1","1","",
"22 s","Investors","2013 ","2","2","0",
"22 s","Investors","2014 ","1","0","1",
"22 s","Investors","2015 ","6","6","0",
"22 s","Investors","2016 ","1","1","0",
"22 s","Investors","2017 ","2","1","1",
"22 s","Investors","2018 ","2","0","2",
"22 s","Investors","2019 ","1","1","0",
"22 s","Trade and Business","2000 ","0","0","0",
"22 s","Trade and Business","2001 ","0","0","0",
"22 s","Trade and Business","2002 ","1","1","0",
"22 s","Trade and Business","2003 ","1","1","0",
"22 s","Trade and Business","2004 ","2","1","1",
"22 s","Trade and Business","2005 ","2","2","0",
"22 s","Trade and Business","2006 ","3","2","1",
"22 s","Trade and Business","2007 ","0","0","0",
"22 s","Trade and Business","2008 ","3","2","1",
"22 s","Trade and Business","2009 ","3","3","0",
"22 s","Trade and Business","2010 ","6","6","0",
"22 s","Trade and Business","2011 ","9","9","",
"22 s","Trade and Business","2012 ","6","6","",
"22 s","Trade and Business","2013 ","6","6","0",
"22 s","Trade and Business","2014 ","5","4","1",
"22 s","Trade and Business","2015 ","4","3","1",
"22 s","Trade and Business","2017 ","1","0","1",
"22 s","Trade and Business","2018 ","3","2","1",
"22 s","Trade and Business","2019 ","1","1","0",
"22 s","Research","2000 ","3","1","2",
"22 s","Research","2001 ","9","7","2",
"22 s","Research","2002 ","4","3","1",
"22 s","Research","2003 ","6","3","3",
"22 s","Research","2004 ","10","7","3",
"22 s","Research","2005 ","6","5","1",
"22 s","Research","2006 ","4","3","1",
"22 s","Research","2007 ","5","3","2",
"22 s","Research","2008 ","0","0","0",
"22 s","Research","2009 ","6","3","3",
"22 s","Research","2010 ","5","4","1",
"22 s","Research","2011 ","5","5","",
"22 s","Research","2012 ","5","3","2",
"22 s","Research","2013 ","3","1","2",
"22 s","Research","2014 ","15","13","2",
"22 s","Research","2015 ","8","8","0",
"22 s","Research","2016 ","5","4","1",
"22 s","Research","2017 ","3","3","0",
"22 s","Art and Entertainment","2000 ","541","31","510",
"22 s","Art and Entertainment","2001 ","599","40","559",
"22 s","Art and Entertainment","2002 ","517","38","479",
"22 s","Art and Entertainment","2003 ","297","32","265",
"22 s","Art and Entertainment","2004 ","240","41","199",
"22 s","Art and Entertainment","2005 ","296","36","260",
"22 s","Art and Entertainment","2006 ","252","42","210",
"22 s","Art and Entertainment","2007 ","180","32","148",
"22 s","Art and Entertainment","2008 ","243","39","204",
"22 s","Art and Entertainment","2009 ","233","30","203",
"22 s","Art and Entertainment","2010 ","185","30","155",
"22 s","Art and Entertainment","2011 ","147","34","113",
"22 s","Art and Entertainment","2012 ","194","40","154",
"22 s","Art and Entertainment","2013 ","193","31","162",
"22 s","Art and Entertainment","2014 ","190","28","162",
"22 s","Art and Entertainment","2015 ","176","29","147",
"22 s","Art and Entertainment","2016 ","130","32","98",
"22 s","Art and Entertainment","2017 ","74","35","39",
"22 s","Art and Entertainment","2018 ","68","30","38",
"22 s","Art and Entertainment","2019 ","76","30","46",
"22 s","Unskilled Employment","2000 ","0","0","0",
"22 s","Unskilled Employment","2001 ","0","0","0",
"22 s","Unskilled Employment","2002 ","0","0","0",
"22 s","Unskilled Employment","2003 ","10","5","5",
"22 s","Unskilled Employment","2004 ","274","254","20",
"22 s","Unskilled Employment","2005 ","2695","2481","214",
"22 s","Unskilled Employment","2006 ","1691","1529","162",
"22 s","Unskilled Employment","2007 ","2688","2449","239",
"22 s","Unskilled Employment","2008 ","3661","3313","348",
"22 s","Unskilled Employment","2009 ","1612","1464","148",
"22 s","Unskilled Employment","2010 ","2640","2368","272",
"22 s","Unskilled Employment","2011 ","3793","3416","377",
"22 s","Unskilled Employment","2012 ","4176","3831","345",
"22 s","Unskilled Employment","2013 ","3740","3382","358",
"22 s","Unskilled Employment","2014 ","3971","3545","426",
"22 s","Unskilled Employment","2015 ","3812","3436","376",
"22 s","Unskilled Employment","2016 ","4039","3626","413",
"22 s","Unskilled Employment","2017 ","3230","2875","355",
"22 s","Unskilled Employment","2018 ","3679","3345","334",
"22 s","Unskilled Employment","2019 ","3470","3124","346",
"22 s","Visiting and Joining Family","2000 ","221","10","211",
"22 s","Visiting and Joining Family","2001 ","485","8","477",
"22 s","Visiting and Joining Family","2002 ","225","8","217",
"22 s","Visiting and Joining Family","2003 ","73","4","69",
"22 s","Visiting and Joining Family","2004 ","33","10","23",
"22 s","Visiting and Joining Family","2005 ","59","22","37",
"22 s","Visiting and Joining Family","2006 ","83","39","44",
"22 s","Visiting and Joining Family","2007 ","61","34","27",
"22 s","Visiting and Joining Family","2008 ","106","54","52",
"22 s","Visiting and Joining Family","2009 ","162","96","66",
"22 s","Visiting and Joining Family","2010 ","367","208","159",
"22 s","Visiting and Joining Family","2011 ","280","144","136",
"22 s","Visiting and Joining Family","2012 ","138","70","68",
"22 s","Visiting and Joining Family","2013 ","93","29","64",
"22 s","Visiting and Joining Family","2014 ","73","28","45",
"22 s","Visiting and Joining Family","2015 ","56","25","31",
"22 s","Visiting and Joining Family","2016 ","112","24","88",
"22 s","Visiting and Joining Family","2017 ","113","22","91",
"22 s","Visiting and Joining Family","2018 ","95","24","71",
"22 s","Visiting and Joining Family","2019 ","83","15","68",
"22 s","Overseas Koreans","2000 ","19","12","7",
"22 s","Overseas Koreans","2001 ","35","17","18",
"22 s","Overseas Koreans","2002 ","39","30","9",
"22 s","Overseas Koreans","2003 ","36","21","15",
"22 s","Overseas Koreans","2004 ","57","28","29",
"22 s","Overseas Koreans","2005 ","64","34","30",
"22 s","Overseas Koreans","2006 ","68","28","40",
"22 s","Overseas Koreans","2007 ","103","39","64",
"22 s","Overseas Koreans","2008 ","169","75","94",
"22 s","Overseas Koreans","2009 ","197","88","109",
"22 s","Overseas Koreans","2010 ","450","175","275",
"22 s","Overseas Koreans","2011 ","735","292","443",
"22 s","Overseas Koreans","2012 ","599","216","383",
"22 s","Overseas Koreans","2013 ","666","248","418",
"22 s","Overseas Koreans","2014 ","745","274","471",
"22 s","Overseas Koreans","2015 ","715","281","434",
"22 s","Overseas Koreans","2016 ","733","329","404",
"22 s","Overseas Koreans","2017 ","673","300","373",
"22 s","Overseas Koreans","2018 ","608","266","342",
"22 s","Overseas Koreans","2019 ","497","247","250",
"22 s","Permanent Residence","2000 ","0","0","0",
"22 s","Permanent Residence","2001 ","0","0","0",
"22 s","Permanent Residence","2002 ","1","1","0",
"22 s","Permanent Residence","2003 ","6","0","6",
"22 s","Permanent Residence","2004 ","5","0","5",
"22 s","Permanent Residence","2005 ","15","5","10",
"22 s","Permanent Residence","2006 ","20","13","7",
"22 s","Permanent Residence","2007 ","15","7","8",
"22 s","Permanent Residence","2008 ","16","6","10",
"22 s","Permanent Residence","2009 ","20","8","12",
"22 s","Permanent Residence","2010 ","33","16","17",
"22 s","Permanent Residence","2011 ","75","52","23",
"22 s","Permanent Residence","2012 ","109","60","49",
"22 s","Permanent Residence","2013 ","98","64","34",
"22 s","Permanent Residence","2014 ","70","47","23",
"22 s","Permanent Residence","2015 ","59","33","26",
"22 s","Permanent Residence","2016 ","36","20","16",
"22 s","Permanent Residence","2017 ","34","19","15",
"22 s","Permanent Residence","2018 ","17","9","8",
"22 s","Permanent Residence","2019 ","15","6","9",
"22 s","Marriage Immigration","2011 ","39","1","38",
"22 s","Marriage Immigration","2012 ","923","7","916",
"22 s","Marriage Immigration","2013 ","850","9","841",
"22 s","Marriage Immigration","2014 ","569","3","566",
"22 s","Marriage Immigration","2015 ","551","2","549",
"22 s","Marriage Immigration","2016 ","605","4","601",
"22 s","Marriage Immigration","2017 ","534","4","530",
"22 s","Marriage Immigration","2018 ","558","4","554",
"22 s","Marriage Immigration","2019 ","506","6","500",
"23 s","Total","2000 ","6883","3978","2905",
"23 s","Total","2001 ","6024","3009","3015",
"23 s","Total","2002 ","6893","3655","3238",
"23 s","Total","2003 ","7412","4347","3065",
"23 s","Total","2004 ","6775","3928","2847",
"23 s","Total","2005 ","9926","6207","3719",
"23 s","Total","2006 ","11191","6762","4429",
"23 s","Total","2007 ","10537","5903","4634",
"23 s","Total","2008 ","11423","6389","5034",
"23 s","Total","2009 ","9280","4551","4729",
"23 s","Total","2010 ","12099","6245","5854",
"23 s","Total","2011 ","14288","7846","6442",
"23 s","Total","2012 ","14147","7825","6322",
"23 s","Total","2013 ","14349","7874","6475",
"23 s","Total","2014 ","14386","8048","6338",
"23 s","Total","2015 ","13215","7245","5970",
"23 s","Total","2016 ","14480","7983","6497",
"23 s","Total","2017 ","15704","8510","7194",
"23 s","Total","2018 ","18583","10297","8286",
"23 s","Total","2019 ","16061","8510","7551",
"23 s","Sightseeing Pass","2000 ","408","242","166",
"23 s","Sightseeing Pass","2001 ","512","304","208",
"23 s","Sightseeing Pass","2002 ","662","411","251",
"23 s","Sightseeing Pass","2003 ","322","173","149",
"23 s","Sightseeing Pass","2004 ","342","175","167",
"23 s","Sightseeing Pass","2005 ","349","150","199",
"23 s","Sightseeing Pass","2006 ","323","156","167",
"23 s","Sightseeing Pass","2007 ","351","182","169",
"23 s","Sightseeing Pass","2008 ","410","214","196",
"23 s","Sightseeing Pass","2009 ","512","259","253",
"23 s","Sightseeing Pass","2010 ","614","322","292",
"23 s","Sightseeing Pass","2011 ","652","322","330",
"23 s","Sightseeing Pass","2012 ","568","286","282",
"23 s","Sightseeing Pass","2013 ","468","254","214",
"23 s","Sightseeing Pass","2014 ","479","273","206",
"23 s","Sightseeing Pass","2015 ","585","341","244",
"23 s","Sightseeing Pass","2016 ","490","278","212",
"23 s","Sightseeing Pass","2017 ","429","235","194",
"23 s","Sightseeing Pass","2018 ","466","275","191",
"23 s","Sightseeing Pass","2019 ","355","169","186",
"23 s","Short-term Business","2000 ","375","283","92",
"23 s","Short-term Business","2001 ","458","299","159",
"23 s","Short-term Business","2002 ","241","138","103",
"23 s","Short-term Business","2003 ","191","122","69",
"23 s","Short-term Business","2004 ","183","131","52",
"23 s","Short-term Business","2005 ","163","116","47",
"23 s","Short-term Business","2006 ","310","219","91",
"23 s","Short-term Business","2007 ","398","274","124",
"23 s","Short-term Business","2008 ","222","167","55",
"23 s","Short-term Business","2009 ","88","78","10",
"23 s","Short-term Business","2010 ","80","71","9",
"23 s","Short-term Business","2011 ","71","65","6",
"23 s","Short-term Visitors","2000 ","1104","568","536",
"23 s","Short-term Visitors","2001 ","780","430","350",
"23 s","Short-term Visitors","2002 ","1009","539","470",
"23 s","Short-term Visitors","2003 ","803","400","403",
"23 s","Short-term Visitors","2004 ","677","400","277",
"23 s","Short-term Visitors","2005 ","662","338","324",
"23 s","Short-term Visitors","2006 ","1048","520","528",
"23 s","Short-term Visitors","2007 ","1110","509","601",
"23 s","Short-term Visitors","2008 ","825","385","440",
"23 s","Short-term Visitors","2009 ","517","221","296",
"23 s","Short-term Visitors","2010 ","669","331","338",
"23 s","Short-term Visitors","2011 ","1174","603","571",
"23 s","Short-term Visitors","2012 ","1713","937","776",
"23 s","Short-term Visitors","2013 ","2228","1216","1012",
"23 s","Short-term Visitors","2014 ","1149","640","509",
"23 s","Short-term Visitors","2015 ","1436","764","672",
"23 s","Short-term Visitors","2016 ","926","504","422",
"23 s","Short-term Visitors","2017 ","887","492","395",
"23 s","Short-term Visitors","2018 ","1278","796","482",
"23 s","Short-term Visitors","2019 ","996","609","387",
"23 s","Short-term Employment","2000 ","9","5","4",
"23 s","Short-term Employment","2001 ","9","7","2",
"23 s","Short-term Employment","2002 ","18","15","3",
"23 s","Short-term Employment","2003 ","8","4","4",
"23 s","Short-term Employment","2004 ","13","7","6",
"23 s","Short-term Employment","2005 ","20","11","9",
"23 s","Short-term Employment","2006 ","18","9","9",
"23 s","Short-term Employment","2007 ","21","11","10",
"23 s","Short-term Employment","2008 ","19","7","12",
"23 s","Short-term Employment","2009 ","5","3","2",
"23 s","Short-term Employment","2010 ","17","9","8",
"23 s","Short-term Employment","2011 ","13","7","6",
"23 s","Short-term Employment","2012 ","11","6","5",
"23 s","Short-term Employment","2013 ","2","2","0",
"23 s","Short-term Employment","2014 ","3","0","3",
"23 s","Short-term Employment","2015 ","11","7","4",
"23 s","Short-term Employment","2016 ","12","10","2",
"23 s","Short-term Employment","2017 ","7","5","2",
"23 s","Short-term Employment","2018 ","11","9","2",
"23 s","Short-term Employment","2019 ","5","2","3",
"23 s","Job Seeking","2000 ","0","0","0",
"23 s","Job Seeking","2001 ","0","0","0",
"23 s","Job Seeking","2002 ","0","0","0",
"23 s","Job Seeking","2003 ","0","0","0",
"23 s","Job Seeking","2004 ","0","0","0",
"23 s","Job Seeking","2005 ","0","0","0",
"23 s","Job Seeking","2006 ","0","0","0",
"23 s","Job Seeking","2007 ","0","0","0",
"23 s","Job Seeking","2008 ","0","0","0",
"23 s","Job Seeking","2009 ","0","0","0",
"23 s","Job Seeking","2010 ","0","0","0",
"23 s","Job Seeking","2011 ","1","1","",
"23 s","Job Seeking","2012 ","5","3","2",
"23 s","Job Seeking","2013 ","13","8","5",
"23 s","Job Seeking","2014 ","14","4","10",
"23 s","Job Seeking","2015 ","8","4","4",
"23 s","Job Seeking","2016 ","9","2","7",
"23 s","Job Seeking","2017 ","9","4","5",
"23 s","Job Seeking","2018 ","16","4","12",
"23 s","Job Seeking","2019 ","10","5","5",
"23 s","study","2000 ","173","98","75",
"23 s","study","2001 ","200","100","100",
"23 s","study","2002 ","325","171","154",
"23 s","study","2003 ","391","218","173",
"23 s","study","2004 ","611","325","286",
"23 s","study","2005 ","913","481","432",
"23 s","study","2006 ","1117","553","564",
"23 s","study","2007 ","1184","606","578",
"23 s","study","2008 ","1116","571","545",
"23 s","study","2009 ","1213","543","670",
"23 s","study","2010 ","1560","739","821",
"23 s","study","2011 ","1527","722","805",
"23 s","study","2012 ","1536","738","798",
"23 s","study","2013 ","1882","863","1019",
"23 s","study","2014 ","1826","834","992",
"23 s","study","2015 ","1728","735","993",
"23 s","study","2016 ","2101","924","1177",
"23 s","study","2017 ","2175","947","1228",
"23 s","study","2018 ","3054","1292","1762",
"23 s","study","2019 ","2893","1301","1592",
"23 s","General Trainees","2000 ","91","43","48",
"23 s","General Trainees","2001 ","110","58","52",
"23 s","General Trainees","2002 ","103","43","60",
"23 s","General Trainees","2003 ","167","87","80",
"23 s","General Trainees","2004 ","287","149","138",
"23 s","General Trainees","2005 ","372","186","186",
"23 s","General Trainees","2006 ","596","289","307",
"23 s","General Trainees","2007 ","831","414","417",
"23 s","General Trainees","2008 ","874","363","511",
"23 s","General Trainees","2009 ","741","287","454",
"23 s","General Trainees","2010 ","969","412","557",
"23 s","General Trainees","2011 ","1054","452","602",
"23 s","General Trainees","2012 ","976","360","616",
"23 s","General Trainees","2013 ","1078","416","662",
"23 s","General Trainees","2014 ","1185","430","755",
"23 s","General Trainees","2015 ","1254","470","784",
"23 s","General Trainees","2016 ","1954","816","1138",
"23 s","General Trainees","2017 ","2122","1051","1071",
"23 s","General Trainees","2018 ","2298","1153","1145",
"23 s","General Trainees","2019 ","1859","788","1071",
"23 s","Religious Activities","2000 ","19","1","18",
"23 s","Religious Activities","2001 ","18","7","11",
"23 s","Religious Activities","2002 ","16","8","8",
"23 s","Religious Activities","2003 ","24","6","18",
"23 s","Religious Activities","2004 ","27","10","17",
"23 s","Religious Activities","2005 ","30","10","20",
"23 s","Religious Activities","2006 ","36","10","26",
"23 s","Religious Activities","2007 ","30","15","15",
"23 s","Religious Activities","2008 ","28","11","17",
"23 s","Religious Activities","2009 ","27","9","18",
"23 s","Religious Activities","2010 ","22","4","18",
"23 s","Religious Activities","2011 ","25","6","19",
"23 s","Religious Activities","2012 ","103","34","69",
"23 s","Religious Activities","2013 ","26","6","20",
"23 s","Religious Activities","2014 ","12","5","7",
"23 s","Religious Activities","2015 ","14","6","8",
"23 s","Religious Activities","2016 ","27","7","20",
"23 s","Religious Activities","2017 ","19","9","10",
"23 s","Religious Activities","2018 ","24","7","17",
"23 s","Religious Activities","2019 ","11","5","6",
"23 s","Investors","2000 ","22","17","5",
"23 s","Investors","2001 ","19","13","6",
"23 s","Investors","2002 ","3","3","0",
"23 s","Investors","2003 ","9","8","1",
"23 s","Investors","2004 ","11","8","3",
"23 s","Investors","2005 ","10","6","4",
"23 s","Investors","2006 ","5","4","1",
"23 s","Investors","2007 ","9","6","3",
"23 s","Investors","2008 ","11","9","2",
"23 s","Investors","2009 ","4","3","1",
"23 s","Investors","2010 ","4","3","1",
"23 s","Investors","2011 ","5","5","",
"23 s","Investors","2012 ","2","2","",
"23 s","Investors","2013 ","7","7","0",
"23 s","Investors","2014 ","3","3","0",
"23 s","Investors","2015 ","2","2","0",
"23 s","Investors","2016 ","2","2","0",
"23 s","Investors","2017 ","2","2","0",
"23 s","Investors","2018 ","3","3","0",
"23 s","Investors","2019 ","3","0","3",
"23 s","Trade and Business","2000 ","2","2","0",
"23 s","Trade and Business","2001 ","1","1","0",
"23 s","Trade and Business","2002 ","3","3","0",
"23 s","Trade and Business","2003 ","2","2","0",
"23 s","Trade and Business","2004 ","4","4","0",
"23 s","Trade and Business","2005 ","5","5","0",
"23 s","Trade and Business","2006 ","0","0","0",
"23 s","Trade and Business","2007 ","12","12","0",
"23 s","Trade and Business","2008 ","5","4","1",
"23 s","Trade and Business","2009 ","8","8","0",
"23 s","Trade and Business","2010 ","6","5","1",
"23 s","Trade and Business","2011 ","13","11","2",
"23 s","Trade and Business","2012 ","10","9","1",
"23 s","Trade and Business","2013 ","7","6","1",
"23 s","Trade and Business","2014 ","17","16","1",
"23 s","Trade and Business","2015 ","10","9","1",
"23 s","Trade and Business","2016 ","2","2","0",
"23 s","Trade and Business","2017 ","6","2","4",
"23 s","Trade and Business","2018 ","3","2","1",
"23 s","Trade and Business","2019 ","7","3","4",
"23 s","Research","2000 ","8","5","3",
"23 s","Research","2001 ","15","10","5",
"23 s","Research","2002 ","21","19","2",
"23 s","Research","2003 ","11","6","5",
"23 s","Research","2004 ","21","19","2",
"23 s","Research","2005 ","16","12","4",
"23 s","Research","2006 ","12","8","4",
"23 s","Research","2007 ","5","3","2",
"23 s","Research","2008 ","6","5","1",
"23 s","Research","2009 ","11","8","3",
"23 s","Research","2010 ","5","4","1",
"23 s","Research","2011 ","6","3","3",
"23 s","Research","2012 ","8","5","3",
"23 s","Research","2013 ","8","4","4",
"23 s","Research","2014 ","5","2","3",
"23 s","Research","2015 ","3","2","1",
"23 s","Research","2016 ","7","3","4",
"23 s","Research","2017 ","5","1","4",
"23 s","Research","2018 ","4","2","2",
"23 s","Research","2019 ","3","2","1",
"23 s","Art and Entertainment","2000 ","462","29","433",
"23 s","Art and Entertainment","2001 ","617","44","573",
"23 s","Art and Entertainment","2002 ","464","39","425",
"23 s","Art and Entertainment","2003 ","281","41","240",
"23 s","Art and Entertainment","2004 ","247","45","202",
"23 s","Art and Entertainment","2005 ","288","41","247",
"23 s","Art and Entertainment","2006 ","230","51","179",
"23 s","Art and Entertainment","2007 ","210","30","180",
"23 s","Art and Entertainment","2008 ","241","42","199",
"23 s","Art and Entertainment","2009 ","246","29","217",
"23 s","Art and Entertainment","2010 ","197","37","160",
"23 s","Art and Entertainment","2011 ","120","26","94",
"23 s","Art and Entertainment","2012 ","186","39","147",
"23 s","Art and Entertainment","2013 ","191","45","146",
"23 s","Art and Entertainment","2014 ","213","41","172",
"23 s","Art and Entertainment","2015 ","173","29","144",
"23 s","Art and Entertainment","2016 ","109","26","83",
"23 s","Art and Entertainment","2017 ","70","25","45",
"23 s","Art and Entertainment","2018 ","56","19","37",
"23 s","Art and Entertainment","2019 ","87","26","61",
"23 s","Unskilled Employment","2000 ","0","0","0",
"23 s","Unskilled Employment","2001 ","0","0","0",
"23 s","Unskilled Employment","2002 ","0","0","0",
"23 s","Unskilled Employment","2003 ","25","16","9",
"23 s","Unskilled Employment","2004 ","194","166","28",
"23 s","Unskilled Employment","2005 ","2225","2012","213",
"23 s","Unskilled Employment","2006 ","1751","1561","190",
"23 s","Unskilled Employment","2007 ","2767","2570","197",
"23 s","Unskilled Employment","2008 ","3607","3274","333",
"23 s","Unskilled Employment","2009 ","1747","1575","172",
"23 s","Unskilled Employment","2010 ","2803","2522","281",
"23 s","Unskilled Employment","2011 ","3980","3600","380",
"23 s","Unskilled Employment","2012 ","4100","3698","402",
"23 s","Unskilled Employment","2013 ","3865","3461","404",
"23 s","Unskilled Employment","2014 ","3892","3540","352",
"23 s","Unskilled Employment","2015 ","3713","3338","375",
"23 s","Unskilled Employment","2016 ","4106","3657","449",
"23 s","Unskilled Employment","2017 ","3089","2763","326",
"23 s","Unskilled Employment","2018 ","3675","3331","344",
"23 s","Unskilled Employment","2019 ","3549","3218","331",
"23 s","Visiting and Joining Family","2000 ","235","11","224",
"23 s","Visiting and Joining Family","2001 ","494","10","484",
"23 s","Visiting and Joining Family","2002 ","233","3","230",
"23 s","Visiting and Joining Family","2003 ","74","4","70",
"23 s","Visiting and Joining Family","2004 ","29","7","22",
"23 s","Visiting and Joining Family","2005 ","47","20","27",
"23 s","Visiting and Joining Family","2006 ","104","39","65",
"23 s","Visiting and Joining Family","2007 ","60","31","29",
"23 s","Visiting and Joining Family","2008 ","88","45","43",
"23 s","Visiting and Joining Family","2009 ","157","90","67",
"23 s","Visiting and Joining Family","2010 ","358","202","156",
"23 s","Visiting and Joining Family","2011 ","293","159","134",
"23 s","Visiting and Joining Family","2012 ","124","57","67",
"23 s","Visiting and Joining Family","2013 ","82","42","40",
"23 s","Visiting and Joining Family","2014 ","79","27","52",
"23 s","Visiting and Joining Family","2015 ","58","22","36",
"23 s","Visiting and Joining Family","2016 ","122","38","84",
"23 s","Visiting and Joining Family","2017 ","161","43","118",
"23 s","Visiting and Joining Family","2018 ","119","21","98",
"23 s","Visiting and Joining Family","2019 ","129","30","99",
"23 s","Overseas Koreans","2000 ","32","16","16",
"23 s","Overseas Koreans","2001 ","33","15","18",
"23 s","Overseas Koreans","2002 ","44","20","24",
"23 s","Overseas Koreans","2003 ","58","27","31",
"23 s","Overseas Koreans","2004 ","54","26","28",
"23 s","Overseas Koreans","2005 ","72","39","33",
"23 s","Overseas Koreans","2006 ","104","54","50",
"23 s","Overseas Koreans","2007 ","124","59","65",
"23 s","Overseas Koreans","2008 ","175","91","84",
"23 s","Overseas Koreans","2009 ","222","112","110",
"23 s","Overseas Koreans","2010 ","850","306","544",
"23 s","Overseas Koreans","2011 ","1370","553","817",
"23 s","Overseas Koreans","2012 ","988","375","613",
"23 s","Overseas Koreans","2013 ","981","370","611",
"23 s","Overseas Koreans","2014 ","1120","443","677",
"23 s","Overseas Koreans","2015 ","1153","464","689",
"23 s","Overseas Koreans","2016 ","1011","440","571",
"23 s","Overseas Koreans","2017 ","857","381","476",
"23 s","Overseas Koreans","2018 ","781","354","427",
"23 s","Overseas Koreans","2019 ","591","275","316",
"23 s","Permanent Residence","2000 ","0","0","0",
"23 s","Permanent Residence","2001 ","0","0","0",
"23 s","Permanent Residence","2002 ","0","0","0",
"23 s","Permanent Residence","2003 ","3","0","3",
"23 s","Permanent Residence","2004 ","7","1","6",
"23 s","Permanent Residence","2005 ","5","4","1",
"23 s","Permanent Residence","2006 ","10","6","4",
"23 s","Permanent Residence","2007 ","18","9","9",
"23 s","Permanent Residence","2008 ","14","5","9",
"23 s","Permanent Residence","2009 ","9","4","5",
"23 s","Permanent Residence","2010 ","30","17","13",
"23 s","Permanent Residence","2011 ","67","34","33",
"23 s","Permanent Residence","2012 ","113","61","52",
"23 s","Permanent Residence","2013 ","133","84","49",
"23 s","Permanent Residence","2014 ","101","63","38",
"23 s","Permanent Residence","2015 ","59","37","22",
"23 s","Permanent Residence","2016 ","35","20","15",
"23 s","Permanent Residence","2017 ","43","23","20",
"23 s","Permanent Residence","2018 ","21","14","7",
"23 s","Permanent Residence","2019 ","27","10","17",
"23 s","Marriage Immigration","2011 ","42","1","41",
"23 s","Marriage Immigration","2012 ","875","23","852",
"23 s","Marriage Immigration","2013 ","855","9","846",
"23 s","Marriage Immigration","2014 ","573","5","568",
"23 s","Marriage Immigration","2015 ","573","6","567",
"23 s","Marriage Immigration","2016 ","606","4","602",
"23 s","Marriage Immigration","2017 ","554","6","548",
"23 s","Marriage Immigration","2018 ","536","12","524",
"23 s","Marriage Immigration","2019 ","500","4","496",
"24 s","Total","2000 ","6969","4202","2767",
"24 s","Total","2001 ","6002","3184","2818",
"24 s","Total","2002 ","6590","3534","3056",
"24 s","Total","2003 ","7439","4395","3044",
"24 s","Total","2004 ","6913","4118","2795",
"24 s","Total","2005 ","8654","5559","3095",
"24 s","Total","2006 ","10707","6637","4070",
"24 s","Total","2007 ","9723","5492","4231",
"24 s","Total","2008 ","10283","5893","4390",
"24 s","Total","2009 ","8119","4252","3867",
"24 s","Total","2010 ","11023","5947","5076",
"24 s","Total","2011 ","12898","7455","5443",
"24 s","Total","2012 ","13394","7639","5755",
"24 s","Total","2013 ","13303","7660","5643",
"24 s","Total","2014 ","13872","8072","5800",
"24 s","Total","2015 ","12388","7078","5310",
"24 s","Total","2016 ","13181","7540","5641",
"24 s","Total","2017 ","14931","8483","6448",
"24 s","Total","2018 ","17263","9868","7395",
"24 s","Total","2019 ","14895","8101","6794",
"24 s","Sightseeing Pass","2000 ","433","266","167",
"24 s","Sightseeing Pass","2001 ","575","353","222",
"24 s","Sightseeing Pass","2002 ","658","388","270",
"24 s","Sightseeing Pass","2003 ","407","222","185",
"24 s","Sightseeing Pass","2004 ","376","213","163",
"24 s","Sightseeing Pass","2005 ","330","179","151",
"24 s","Sightseeing Pass","2006 ","351","182","169",
"24 s","Sightseeing Pass","2007 ","376","201","175",
"24 s","Sightseeing Pass","2008 ","378","203","175",
"24 s","Sightseeing Pass","2009 ","476","247","229",
"24 s","Sightseeing Pass","2010 ","643","331","312",
"24 s","Sightseeing Pass","2011 ","578","303","275",
"24 s","Sightseeing Pass","2012 ","571","281","290",
"24 s","Sightseeing Pass","2013 ","469","245","224",
"24 s","Sightseeing Pass","2014 ","563","346","217",
"24 s","Sightseeing Pass","2015 ","597","374","223",
"24 s","Sightseeing Pass","2016 ","499","277","222",
"24 s","Sightseeing Pass","2017 ","489","280","209",
"24 s","Sightseeing Pass","2018 ","555","315","240",
"24 s","Sightseeing Pass","2019 ","358","188","170",
"24 s","Short-term Business","2000 ","424","320","104",
"24 s","Short-term Business","2001 ","495","321","174",
"24 s","Short-term Business","2002 ","303","185","118",
"24 s","Short-term Business","2003 ","206","122","84",
"24 s","Short-term Business","2004 ","213","135","78",
"24 s","Short-term Business","2005 ","159","111","48",
"24 s","Short-term Business","2006 ","333","210","123",
"24 s","Short-term Business","2007 ","482","323","159",
"24 s","Short-term Business","2008 ","218","165","53",
"24 s","Short-term Business","2009 ","98","75","23",
"24 s","Short-term Business","2010 ","81","64","17",
"24 s","Short-term Business","2011 ","91","84","7",
"24 s","Short-term Visitors","2000 ","1158","616","542",
"24 s","Short-term Visitors","2001 ","883","483","400",
"24 s","Short-term Visitors","2002 ","1086","602","484",
"24 s","Short-term Visitors","2003 ","783","390","393",
"24 s","Short-term Visitors","2004 ","628","362","266",
"24 s","Short-term Visitors","2005 ","628","325","303",
"24 s","Short-term Visitors","2006 ","1012","527","485",
"24 s","Short-term Visitors","2007 ","976","478","498",
"24 s","Short-term Visitors","2008 ","892","404","488",
"24 s","Short-term Visitors","2009 ","475","199","276",
"24 s","Short-term Visitors","2010 ","665","316","349",
"24 s","Short-term Visitors","2011 ","1166","634","532",
"24 s","Short-term Visitors","2012 ","1906","1031","875",
"24 s","Short-term Visitors","2013 ","2311","1288","1023",
"24 s","Short-term Visitors","2014 ","1263","675","588",
"24 s","Short-term Visitors","2015 ","1585","874","711",
"24 s","Short-term Visitors","2016 ","1006","547","459",
"24 s","Short-term Visitors","2017 ","987","539","448",
"24 s","Short-term Visitors","2018 ","1330","850","480",
"24 s","Short-term Visitors","2019 ","1111","692","419",
"24 s","Short-term Employment","2000 ","6","5","1",
"24 s","Short-term Employment","2001 ","8","5","3",
"24 s","Short-term Employment","2002 ","17","11","6",
"24 s","Short-term Employment","2003 ","19","16","3",
"24 s","Short-term Employment","2004 ","11","9","2",
"24 s","Short-term Employment","2005 ","15","10","5",
"24 s","Short-term Employment","2006 ","20","13","7",
"24 s","Short-term Employment","2007 ","20","15","5",
"24 s","Short-term Employment","2008 ","18","11","7",
"24 s","Short-term Employment","2009 ","15","8","7",
"24 s","Short-term Employment","2010 ","12","3","9",
"24 s","Short-term Employment","2011 ","6","3","3",
"24 s","Short-term Employment","2012 ","11","5","6",
"24 s","Short-term Employment","2013 ","2","1","1",
"24 s","Short-term Employment","2014 ","4","3","1",
"24 s","Short-term Employment","2015 ","5","1","4",
"24 s","Short-term Employment","2016 ","16","14","2",
"24 s","Short-term Employment","2017 ","18","12","6",
"24 s","Short-term Employment","2018 ","9","6","3",
"24 s","Short-term Employment","2019 ","9","4","5",
"24 s","Job Seeking","2000 ","0","0","0",
"24 s","Job Seeking","2001 ","0","0","0",
"24 s","Job Seeking","2002 ","0","0","0",
"24 s","Job Seeking","2003 ","0","0","0",
"24 s","Job Seeking","2004 ","0","0","0",
"24 s","Job Seeking","2005 ","0","0","0",
"24 s","Job Seeking","2006 ","0","0","0",
"24 s","Job Seeking","2007 ","0","0","0",
"24 s","Job Seeking","2008 ","0","0","0",
"24 s","Job Seeking","2009 ","1","0","1",
"24 s","Job Seeking","2010 ","2","2","0",
"24 s","Job Seeking","2011 ","3","1","2",
"24 s","Job Seeking","2012 ","13","3","10",
"24 s","Job Seeking","2013 ","19","9","10",
"24 s","Job Seeking","2014 ","21","9","12",
"24 s","Job Seeking","2015 ","13","5","8",
"24 s","Job Seeking","2016 ","19","7","12",
"24 s","Job Seeking","2017 ","17","4","13",
"24 s","Job Seeking","2018 ","36","10","26",
"24 s","Job Seeking","2019 ","29","8","21",
"24 s","study","2000 ","134","69","65",
"24 s","study","2001 ","166","99","67",
"24 s","study","2002 ","203","106","97",
"24 s","study","2003 ","307","168","139",
"24 s","study","2004 ","466","255","211",
"24 s","study","2005 ","529","287","242",
"24 s","study","2006 ","780","408","372",
"24 s","study","2007 ","859","444","415",
"24 s","study","2008 ","757","380","377",
"24 s","study","2009 ","770","375","395",
"24 s","study","2010 ","992","477","515",
"24 s","study","2011 ","1019","544","475",
"24 s","study","2012 ","1069","563","506",
"24 s","study","2013 ","1267","641","626",
"24 s","study","2014 ","1231","610","621",
"24 s","study","2015 ","1216","584","632",
"24 s","study","2016 ","1374","639","735",
"24 s","study","2017 ","1476","714","762",
"24 s","study","2018 ","2114","998","1116",
"24 s","study","2019 ","1994","915","1079",
"24 s","General Trainees","2000 ","75","43","32",
"24 s","General Trainees","2001 ","94","53","41",
"24 s","General Trainees","2002 ","81","44","37",
"24 s","General Trainees","2003 ","126","71","55",
"24 s","General Trainees","2004 ","179","86","93",
"24 s","General Trainees","2005 ","219","101","118",
"24 s","General Trainees","2006 ","400","201","199",
"24 s","General Trainees","2007 ","545","267","278",
"24 s","General Trainees","2008 ","587","270","317",
"24 s","General Trainees","2009 ","489","210","279",
"24 s","General Trainees","2010 ","619","261","358",
"24 s","General Trainees","2011 ","711","334","377",
"24 s","General Trainees","2012 ","720","312","408",
"24 s","General Trainees","2013 ","781","332","449",
"24 s","General Trainees","2014 ","911","336","575",
"24 s","General Trainees","2015 ","890","365","525",
"24 s","General Trainees","2016 ","1287","597","690",
"24 s","General Trainees","2017 ","1504","756","748",
"24 s","General Trainees","2018 ","1598","776","822",
"24 s","General Trainees","2019 ","1269","545","724",
"24 s","Religious Activities","2000 ","13","4","9",
"24 s","Religious Activities","2001 ","29","5","24",
"24 s","Religious Activities","2002 ","22","10","12",
"24 s","Religious Activities","2003 ","13","4","9",
"24 s","Religious Activities","2004 ","22","9","13",
"24 s","Religious Activities","2005 ","30","14","16",
"24 s","Religious Activities","2006 ","43","19","24",
"24 s","Religious Activities","2007 ","19","5","14",
"24 s","Religious Activities","2008 ","20","6","14",
"24 s","Religious Activities","2009 ","16","4","12",
"24 s","Religious Activities","2010 ","29","6","23",
"24 s","Religious Activities","2011 ","20","2","18",
"24 s","Religious Activities","2012 ","58","15","43",
"24 s","Religious Activities","2013 ","19","8","11",
"24 s","Religious Activities","2014 ","21","5","16",
"24 s","Religious Activities","2015 ","11","3","8",
"24 s","Religious Activities","2016 ","12","0","12",
"24 s","Religious Activities","2017 ","17","8","9",
"24 s","Religious Activities","2018 ","18","3","15",
"24 s","Religious Activities","2019 ","15","7","8",
"24 s","Investors","2000 ","20","13","7",
"24 s","Investors","2001 ","13","9","4",
"24 s","Investors","2002 ","18","14","4",
"24 s","Investors","2003 ","7","6","1",
"24 s","Investors","2004 ","10","9","1",
"24 s","Investors","2005 ","18","12","6",
"24 s","Investors","2006 ","10","9","1",
"24 s","Investors","2007 ","13","9","4",
"24 s","Investors","2008 ","16","12","4",
"24 s","Investors","2009 ","10","8","2",
"24 s","Investors","2010 ","10","7","3",
"24 s","Investors","2011 ","11","9","2",
"24 s","Investors","2012 ","14","12","2",
"24 s","Investors","2013 ","4","4","0",
"24 s","Investors","2014 ","10","9","1",
"24 s","Investors","2015 ","4","3","1",
"24 s","Investors","2016 ","2","1","1",
"24 s","Investors","2017 ","6","5","1",
"24 s","Investors","2018 ","7","6","1",
"24 s","Investors","2019 ","5","3","2",
"24 s","Trade and Business","2000 ","3","3","0",
"24 s","Trade and Business","2001 ","2","2","0",
"24 s","Trade and Business","2002 ","1","1","0",
"24 s","Trade and Business","2003 ","4","4","0",
"24 s","Trade and Business","2004 ","3","2","1",
"24 s","Trade and Business","2005 ","9","8","1",
"24 s","Trade and Business","2006 ","3","3","0",
"24 s","Trade and Business","2007 ","12","12","0",
"24 s","Trade and Business","2008 ","10","10","0",
"24 s","Trade and Business","2009 ","12","12","0",
"24 s","Trade and Business","2010 ","12","11","1",
"24 s","Trade and Business","2011 ","17","16","1",
"24 s","Trade and Business","2012 ","10","10","",
"24 s","Trade and Business","2013 ","24","23","1",
"24 s","Trade and Business","2014 ","25","22","3",
"24 s","Trade and Business","2015 ","14","13","1",
"24 s","Trade and Business","2016 ","8","6","2",
"24 s","Trade and Business","2017 ","11","8","3",
"24 s","Trade and Business","2018 ","5","4","1",
"24 s","Trade and Business","2019 ","7","5","2",
"24 s","Research","2000 ","11","8","3",
"24 s","Research","2001 ","17","11","6",
"24 s","Research","2002 ","26","20","6",
"24 s","Research","2003 ","16","11","5",
"24 s","Research","2004 ","32","21","11",
"24 s","Research","2005 ","17","13","4",
"24 s","Research","2006 ","27","20","7",
"24 s","Research","2007 ","18","10","8",
"24 s","Research","2008 ","10","6","4",
"24 s","Research","2009 ","7","7","0",
"24 s","Research","2010 ","8","8","0",
"24 s","Research","2011 ","14","9","5",
"24 s","Research","2012 ","15","8","7",
"24 s","Research","2013 ","13","8","5",
"24 s","Research","2014 ","8","6","2",
"24 s","Research","2015 ","7","4","3",
"24 s","Research","2016 ","14","14","0",
"24 s","Research","2017 ","6","3","3",
"24 s","Research","2018 ","3","3","0",
"24 s","Research","2019 ","6","5","1",
"24 s","Art and Entertainment","2000 ","422","36","386",
"24 s","Art and Entertainment","2001 ","560","48","512",
"24 s","Art and Entertainment","2002 ","438","41","397",
"24 s","Art and Entertainment","2003 ","310","39","271",
"24 s","Art and Entertainment","2004 ","237","43","194",
"24 s","Art and Entertainment","2005 ","253","38","215",
"24 s","Art and Entertainment","2006 ","210","35","175",
"24 s","Art and Entertainment","2007 ","204","37","167",
"24 s","Art and Entertainment","2008 ","236","59","177",
"24 s","Art and Entertainment","2009 ","212","30","182",
"24 s","Art and Entertainment","2010 ","178","34","144",
"24 s","Art and Entertainment","2011 ","119","26","93",
"24 s","Art and Entertainment","2012 ","178","25","153",
"24 s","Art and Entertainment","2013 ","181","37","144",
"24 s","Art and Entertainment","2014 ","199","44","155",
"24 s","Art and Entertainment","2015 ","157","25","132",
"24 s","Art and Entertainment","2016 ","111","27","84",
"24 s","Art and Entertainment","2017 ","89","28","61",
"24 s","Art and Entertainment","2018 ","70","29","41",
"24 s","Art and Entertainment","2019 ","98","45","53",
"24 s","Unskilled Employment","2000 ","0","0","0",
"24 s","Unskilled Employment","2001 ","0","0","0",
"24 s","Unskilled Employment","2002 ","0","0","0",
"24 s","Unskilled Employment","2003 ","49","32","17",
"24 s","Unskilled Employment","2004 ","246","191","55",
"24 s","Unskilled Employment","2005 ","1716","1539","177",
"24 s","Unskilled Employment","2006 ","1641","1431","210",
"24 s","Unskilled Employment","2007 ","2481","2287","194",
"24 s","Unskilled Employment","2008 ","3312","2980","332",
"24 s","Unskilled Employment","2009 ","1838","1675","163",
"24 s","Unskilled Employment","2010 ","2695","2443","252",
"24 s","Unskilled Employment","2011 ","3708","3311","397",
"24 s","Unskilled Employment","2012 ","3993","3543","450",
"24 s","Unskilled Employment","2013 ","3828","3423","405",
"24 s","Unskilled Employment","2014 ","4100","3660","440",
"24 s","Unskilled Employment","2015 ","3601","3243","358",
"24 s","Unskilled Employment","2016 ","3994","3561","433",
"24 s","Unskilled Employment","2017 ","3395","3020","375",
"24 s","Unskilled Employment","2018 ","3671","3329","342",
"24 s","Unskilled Employment","2019 ","3442","3108","334",
"24 s","Visiting and Joining Family","2000 ","257","4","253",
"24 s","Visiting and Joining Family","2001 ","427","10","417",
"24 s","Visiting and Joining Family","2002 ","260","6","254",
"24 s","Visiting and Joining Family","2003 ","71","8","63",
"24 s","Visiting and Joining Family","2004 ","33","11","22",
"24 s","Visiting and Joining Family","2005 ","86","48","38",
"24 s","Visiting and Joining Family","2006 ","184","93","91",
"24 s","Visiting and Joining Family","2007 ","85","45","40",
"24 s","Visiting and Joining Family","2008 ","89","53","36",
"24 s","Visiting and Joining Family","2009 ","119","58","61",
"24 s","Visiting and Joining Family","2010 ","357","209","148",
"24 s","Visiting and Joining Family","2011 ","255","130","125",
"24 s","Visiting and Joining Family","2012 ","114","46","68",
"24 s","Visiting and Joining Family","2013 ","86","31","55",
"24 s","Visiting and Joining Family","2014 ","80","33","47",
"24 s","Visiting and Joining Family","2015 ","80","33","47",
"24 s","Visiting and Joining Family","2016 ","140","41","99",
"24 s","Visiting and Joining Family","2017 ","137","35","102",
"24 s","Visiting and Joining Family","2018 ","158","51","107",
"24 s","Visiting and Joining Family","2019 ","157","38","119",
"24 s","Overseas Koreans","2000 ","28","13","15",
"24 s","Overseas Koreans","2001 ","33","21","12",
"24 s","Overseas Koreans","2002 ","49","23","26",
"24 s","Overseas Koreans","2003 ","68","41","27",
"24 s","Overseas Koreans","2004 ","60","38","22",
"24 s","Overseas Koreans","2005 ","88","54","34",
"24 s","Overseas Koreans","2006 ","104","47","57",
"24 s","Overseas Koreans","2007 ","116","64","52",
"24 s","Overseas Koreans","2008 ","165","82","83",
"24 s","Overseas Koreans","2009 ","171","94","77",
"24 s","Overseas Koreans","2010 ","876","379","497",
"24 s","Overseas Koreans","2011 ","1301","598","703",
"24 s","Overseas Koreans","2012 ","955","386","569",
"24 s","Overseas Koreans","2013 ","907","413","494",
"24 s","Overseas Koreans","2014 ","1047","455","592",
"24 s","Overseas Koreans","2015 ","1026","456","570",
"24 s","Overseas Koreans","2016 ","1066","453","613",
"24 s","Overseas Koreans","2017 ","839","413","426",
"24 s","Overseas Koreans","2018 ","768","377","391",
"24 s","Overseas Koreans","2019 ","614","288","326",
"24 s","Permanent Residence","2000 ","0","0","0",
"24 s","Permanent Residence","2001 ","0","0","0",
"24 s","Permanent Residence","2002 ","0","0","0",
"24 s","Permanent Residence","2003 ","1","1","0",
"24 s","Permanent Residence","2004 ","7","5","2",
"24 s","Permanent Residence","2005 ","7","4","3",
"24 s","Permanent Residence","2006 ","11","7","4",
"24 s","Permanent Residence","2007 ","7","3","4",
"24 s","Permanent Residence","2008 ","11","6","5",
"24 s","Permanent Residence","2009 ","15","5","10",
"24 s","Permanent Residence","2010 ","33","15","18",
"24 s","Permanent Residence","2011 ","82","39","43",
"24 s","Permanent Residence","2012 ","118","62","56",
"24 s","Permanent Residence","2013 ","142","79","63",
"24 s","Permanent Residence","2014 ","116","62","54",
"24 s","Permanent Residence","2015 ","92","57","35",
"24 s","Permanent Residence","2016 ","54","36","18",
"24 s","Permanent Residence","2017 ","36","20","16",
"24 s","Permanent Residence","2018 ","33","18","15",
"24 s","Permanent Residence","2019 ","25","13","12",
"24 s","Marriage Immigration","2011 ","51","","51",
"24 s","Marriage Immigration","2012 ","899","24","875",
"24 s","Marriage Immigration","2013 ","759","15","744",
"24 s","Marriage Immigration","2014 ","552","8","544",
"24 s","Marriage Immigration","2015 ","597","19","578",
"24 s","Marriage Immigration","2016 ","528","10","518",
"24 s","Marriage Immigration","2017 ","518","10","508",
"24 s","Marriage Immigration","2018 ","528","17","511",
"24 s","Marriage Immigration","2019 ","536","17","519",
"25 s","Total","2000 ","7035","4305","2730",
"25 s","Total","2001 ","5979","3298","2681",
"25 s","Total","2002 ","6040","3413","2627",
"25 s","Total","2003 ","6689","4174","2515",
"25 s","Total","2004 ","6583","3959","2624",
"25 s","Total","2005 ","8830","5690","3140",
"25 s","Total","2006 ","10335","6626","3709",
"25 s","Total","2007 ","10585","6080","4505",
"25 s","Total","2008 ","11475","6732","4743",
"25 s","Total","2009 ","8745","4838","3907",
"25 s","Total","2010 ","10527","5984","4543",
"25 s","Total","2011 ","12411","7208","5203",
"25 s","Total","2012 ","13551","8099","5452",
"25 s","Total","2013 ","14713","8883","5830",
"25 s","Total","2014 ","14954","9266","5688",
"25 s","Total","2015 ","15042","9086","5956",
"25 s","Total","2016 ","14934","8969","5965",
"25 s","Total","2017 ","15737","9374","6363",
"25 s","Total","2018 ","17242","10292","6950",
"25 s","Total","2019 ","14306","8160","6146",
"25 s","Sightseeing Pass","2000 ","444","259","185",
"25 s","Sightseeing Pass","2001 ","608","379","229",
"25 s","Sightseeing Pass","2002 ","620","378","242",
"25 s","Sightseeing Pass","2003 ","395","232","163",
"25 s","Sightseeing Pass","2004 ","376","190","186",
"25 s","Sightseeing Pass","2005 ","360","195","165",
"25 s","Sightseeing Pass","2006 ","335","176","159",
"25 s","Sightseeing Pass","2007 ","379","208","171",
"25 s","Sightseeing Pass","2008 ","401","224","177",
"25 s","Sightseeing Pass","2009 ","470","260","210",
"25 s","Sightseeing Pass","2010 ","543","294","249",
"25 s","Sightseeing Pass","2011 ","537","291","246",
"25 s","Sightseeing Pass","2012 ","578","294","284",
"25 s","Sightseeing Pass","2013 ","438","232","206",
"25 s","Sightseeing Pass","2014 ","494","283","211",
"25 s","Sightseeing Pass","2015 ","706","446","260",
"25 s","Sightseeing Pass","2016 ","560","330","230",
"25 s","Sightseeing Pass","2017 ","501","308","193",
"25 s","Sightseeing Pass","2018 ","604","346","258",
"25 s","Sightseeing Pass","2019 ","386","207","179",
"25 s","Short-term Business","2000 ","486","358","128",
"25 s","Short-term Business","2001 ","537","341","196",
"25 s","Short-term Business","2002 ","312","215","97",
"25 s","Short-term Business","2003 ","220","151","69",
"25 s","Short-term Business","2004 ","222","157","65",
"25 s","Short-term Business","2005 ","187","131","56",
"25 s","Short-term Business","2006 ","325","238","87",
"25 s","Short-term Business","2007 ","527","379","148",
"25 s","Short-term Business","2008 ","279","201","78",
"25 s","Short-term Business","2009 ","99","70","29",
"25 s","Short-term Business","2010 ","103","86","17",
"25 s","Short-term Business","2011 ","106","95","11",
"25 s","Short-term Visitors","2000 ","1305","713","592",
"25 s","Short-term Visitors","2001 ","980","528","452",
"25 s","Short-term Visitors","2002 ","1038","579","459",
"25 s","Short-term Visitors","2003 ","734","375","359",
"25 s","Short-term Visitors","2004 ","666","386","280",
"25 s","Short-term Visitors","2005 ","591","279","312",
"25 s","Short-term Visitors","2006 ","772","408","364",
"25 s","Short-term Visitors","2007 ","795","369","426",
"25 s","Short-term Visitors","2008 ","682","302","380",
"25 s","Short-term Visitors","2009 ","406","162","244",
"25 s","Short-term Visitors","2010 ","652","317","335",
"25 s","Short-term Visitors","2011 ","1650","852","798",
"25 s","Short-term Visitors","2012 ","2698","1609","1089",
"25 s","Short-term Visitors","2013 ","3838","2298","1540",
"25 s","Short-term Visitors","2014 ","2521","1549","972",
"25 s","Short-term Visitors","2015 ","3529","2159","1370",
"25 s","Short-term Visitors","2016 ","2163","1350","813",
"25 s","Short-term Visitors","2017 ","1759","1082","677",
"25 s","Short-term Visitors","2018 ","1731","1142","589",
"25 s","Short-term Visitors","2019 ","1172","753","419",
"25 s","Short-term Employment","2000 ","14","14","0",
"25 s","Short-term Employment","2001 ","3","1","2",
"25 s","Short-term Employment","2002 ","15","12","3",
"25 s","Short-term Employment","2003 ","11","8","3",
"25 s","Short-term Employment","2004 ","18","14","4",
"25 s","Short-term Employment","2005 ","11","9","2",
"25 s","Short-term Employment","2006 ","16","8","8",
"25 s","Short-term Employment","2007 ","24","13","11",
"25 s","Short-term Employment","2008 ","16","10","6",
"25 s","Short-term Employment","2009 ","7","6","1",
"25 s","Short-term Employment","2010 ","8","3","5",
"25 s","Short-term Employment","2011 ","9","6","3",
"25 s","Short-term Employment","2012 ","11","8","3",
"25 s","Short-term Employment","2013 ","4","2","2",
"25 s","Short-term Employment","2014 ","2","1","1",
"25 s","Short-term Employment","2015 ","13","10","3",
"25 s","Short-term Employment","2016 ","12","11","1",
"25 s","Short-term Employment","2017 ","15","5","10",
"25 s","Short-term Employment","2018 ","4","1","3",
"25 s","Short-term Employment","2019 ","12","7","5",
"25 s","Job Seeking","2000 ","0","0","0",
"25 s","Job Seeking","2001 ","0","0","0",
"25 s","Job Seeking","2002 ","0","0","0",
"25 s","Job Seeking","2003 ","0","0","0",
"25 s","Job Seeking","2004 ","0","0","0",
"25 s","Job Seeking","2005 ","0","0","0",
"25 s","Job Seeking","2006 ","0","0","0",
"25 s","Job Seeking","2007 ","0","0","0",
"25 s","Job Seeking","2008 ","0","0","0",
"25 s","Job Seeking","2009 ","0","0","0",
"25 s","Job Seeking","2010 ","0","0","0",
"25 s","Job Seeking","2011 ","1","1","",
"25 s","Job Seeking","2012 ","11","5","6",
"25 s","Job Seeking","2013 ","22","5","17",
"25 s","Job Seeking","2014 ","38","16","22",
"25 s","Job Seeking","2015 ","25","10","15",
"25 s","Job Seeking","2016 ","37","11","26",
"25 s","Job Seeking","2017 ","17","6","11",
"25 s","Job Seeking","2018 ","28","8","20",
"25 s","Job Seeking","2019 ","25","8","17",
"25 s","study","2000 ","91","57","34",
"25 s","study","2001 ","123","71","52",
"25 s","study","2002 ","151","81","70",
"25 s","study","2003 ","212","121","91",
"25 s","study","2004 ","305","185","120",
"25 s","study","2005 ","341","197","144",
"25 s","study","2006 ","426","235","191",
"25 s","study","2007 ","591","296","295",
"25 s","study","2008 ","559","322","237",
"25 s","study","2009 ","515","294","221",
"25 s","study","2010 ","699","387","312",
"25 s","study","2011 ","590","323","267",
"25 s","study","2012 ","709","393","316",
"25 s","study","2013 ","851","470","381",
"25 s","study","2014 ","805","410","395",
"25 s","study","2015 ","905","429","476",
"25 s","study","2016 ","957","507","450",
"25 s","study","2017 ","1003","549","454",
"25 s","study","2018 ","1330","641","689",
"25 s","study","2019 ","1369","682","687",
"25 s","General Trainees","2000 ","61","25","36",
"25 s","General Trainees","2001 ","80","47","33",
"25 s","General Trainees","2002 ","52","31","21",
"25 s","General Trainees","2003 ","95","56","39",
"25 s","General Trainees","2004 ","125","50","75",
"25 s","General Trainees","2005 ","148","78","70",
"25 s","General Trainees","2006 ","215","97","118",
"25 s","General Trainees","2007 ","306","146","160",
"25 s","General Trainees","2008 ","328","150","178",
"25 s","General Trainees","2009 ","276","122","154",
"25 s","General Trainees","2010 ","394","165","229",
"25 s","General Trainees","2011 ","488","237","251",
"25 s","General Trainees","2012 ","509","220","289",
"25 s","General Trainees","2013 ","509","194","315",
"25 s","General Trainees","2014 ","581","233","348",
"25 s","General Trainees","2015 ","646","226","420",
"25 s","General Trainees","2016 ","863","364","499",
"25 s","General Trainees","2017 ","1089","556","533",
"25 s","General Trainees","2018 ","1136","589","547",
"25 s","General Trainees","2019 ","833","316","517",
"25 s","Religious Activities","2000 ","12","4","8",
"25 s","Religious Activities","2001 ","27","8","19",
"25 s","Religious Activities","2002 ","14","2","12",
"25 s","Religious Activities","2003 ","14","8","6",
"25 s","Religious Activities","2004 ","14","8","6",
"25 s","Religious Activities","2005 ","20","7","13",
"25 s","Religious Activities","2006 ","37","13","24",
"25 s","Religious Activities","2007 ","26","6","20",
"25 s","Religious Activities","2008 ","22","8","14",
"25 s","Religious Activities","2009 ","24","12","12",
"25 s","Religious Activities","2010 ","21","8","13",
"25 s","Religious Activities","2011 ","14","3","11",
"25 s","Religious Activities","2012 ","27","10","17",
"25 s","Religious Activities","2013 ","19","7","12",
"25 s","Religious Activities","2014 ","10","1","9",
"25 s","Religious Activities","2015 ","11","3","8",
"25 s","Religious Activities","2016 ","10","4","6",
"25 s","Religious Activities","2017 ","13","7","6",
"25 s","Religious Activities","2018 ","17","4","13",
"25 s","Religious Activities","2019 ","14","7","7",
"25 s","Investors","2000 ","16","6","10",
"25 s","Investors","2001 ","25","21","4",
"25 s","Investors","2002 ","11","11","0",
"25 s","Investors","2003 ","19","15","4",
"25 s","Investors","2004 ","21","18","3",
"25 s","Investors","2005 ","23","18","5",
"25 s","Investors","2006 ","13","10","3",
"25 s","Investors","2007 ","15","12","3",
"25 s","Investors","2008 ","21","15","6",
"25 s","Investors","2009 ","12","12","0",
"25 s","Investors","2010 ","15","13","2",
"25 s","Investors","2011 ","10","5","5",
"25 s","Investors","2012 ","9","9","",
"25 s","Investors","2013 ","14","12","2",
"25 s","Investors","2014 ","9","9","0",
"25 s","Investors","2015 ","8","7","1",
"25 s","Investors","2016 ","13","12","1",
"25 s","Investors","2017 ","4","3","1",
"25 s","Investors","2018 ","4","3","1",
"25 s","Investors","2019 ","8","6","2",
"25 s","Trade and Business","2000 ","3","2","1",
"25 s","Trade and Business","2001 ","4","3","1",
"25 s","Trade and Business","2002 ","4","4","0",
"25 s","Trade and Business","2003 ","4","4","0",
"25 s","Trade and Business","2004 ","6","5","1",
"25 s","Trade and Business","2005 ","8","8","0",
"25 s","Trade and Business","2006 ","13","13","0",
"25 s","Trade and Business","2007 ","12","11","1",
"25 s","Trade and Business","2008 ","21","20","1",
"25 s","Trade and Business","2009 ","19","19","0",
"25 s","Trade and Business","2010 ","16","14","2",
"25 s","Trade and Business","2011 ","18","17","1",
"25 s","Trade and Business","2012 ","16","15","1",
"25 s","Trade and Business","2013 ","19","18","1",
"25 s","Trade and Business","2014 ","24","23","1",
"25 s","Trade and Business","2015 ","22","20","2",
"25 s","Trade and Business","2016 ","14","13","1",
"25 s","Trade and Business","2017 ","4","4","0",
"25 s","Trade and Business","2018 ","10","8","2",
"25 s","Trade and Business","2019 ","12","12","0",
"25 s","Research","2000 ","16","13","3",
"25 s","Research","2001 ","20","15","5",
"25 s","Research","2002 ","24","20","4",
"25 s","Research","2003 ","29","24","5",
"25 s","Research","2004 ","22","17","5",
"25 s","Research","2005 ","37","28","9",
"25 s","Research","2006 ","36","28","8",
"25 s","Research","2007 ","26","19","7",
"25 s","Research","2008 ","12","10","2",
"25 s","Research","2009 ","8","6","2",
"25 s","Research","2010 ","20","16","4",
"25 s","Research","2011 ","20","16","4",
"25 s","Research","2012 ","21","16","5",
"25 s","Research","2013 ","22","16","6",
"25 s","Research","2014 ","18","13","5",
"25 s","Research","2015 ","8","4","4",
"25 s","Research","2016 ","18","11","7",
"25 s","Research","2017 ","4","2","2",
"25 s","Research","2018 ","7","6","1",
"25 s","Research","2019 ","8","8","0",
"25 s","Art and Entertainment","2000 ","378","28","350",
"25 s","Art and Entertainment","2001 ","498","58","440",
"25 s","Art and Entertainment","2002 ","345","43","302",
"25 s","Art and Entertainment","2003 ","276","44","232",
"25 s","Art and Entertainment","2004 ","184","45","139",
"25 s","Art and Entertainment","2005 ","248","51","197",
"25 s","Art and Entertainment","2006 ","207","58","149",
"25 s","Art and Entertainment","2007 ","203","40","163",
"25 s","Art and Entertainment","2008 ","193","37","156",
"25 s","Art and Entertainment","2009 ","217","26","191",
"25 s","Art and Entertainment","2010 ","188","30","158",
"25 s","Art and Entertainment","2011 ","114","19","95",
"25 s","Art and Entertainment","2012 ","161","25","136",
"25 s","Art and Entertainment","2013 ","184","39","145",
"25 s","Art and Entertainment","2014 ","196","44","152",
"25 s","Art and Entertainment","2015 ","161","22","139",
"25 s","Art and Entertainment","2016 ","112","28","84",
"25 s","Art and Entertainment","2017 ","68","21","47",
"25 s","Art and Entertainment","2018 ","84","32","52",
"25 s","Art and Entertainment","2019 ","90","30","60",
"25 s","Unskilled Employment","2000 ","0","0","0",
"25 s","Unskilled Employment","2001 ","0","0","0",
"25 s","Unskilled Employment","2002 ","0","0","0",
"25 s","Unskilled Employment","2003 ","74","59","15",
"25 s","Unskilled Employment","2004 ","282","223","59",
"25 s","Unskilled Employment","2005 ","1665","1418","247",
"25 s","Unskilled Employment","2006 ","1711","1468","243",
"25 s","Unskilled Employment","2007 ","2229","2056","173",
"25 s","Unskilled Employment","2008 ","3216","2889","327",
"25 s","Unskilled Employment","2009 ","1801","1662","139",
"25 s","Unskilled Employment","2010 ","2660","2418","242",
"25 s","Unskilled Employment","2011 ","3465","3074","391",
"25 s","Unskilled Employment","2012 ","3759","3347","412",
"25 s","Unskilled Employment","2013 ","4013","3566","447",
"25 s","Unskilled Employment","2014 ","4082","3694","388",
"25 s","Unskilled Employment","2015 ","3758","3377","381",
"25 s","Unskilled Employment","2016 ","4322","3816","506",
"25 s","Unskilled Employment","2017 ","3515","3133","382",
"25 s","Unskilled Employment","2018 ","4102","3722","380",
"25 s","Unskilled Employment","2019 ","3879","3491","388",
"25 s","Visiting and Joining Family","2000 ","248","10","238",
"25 s","Visiting and Joining Family","2001 ","438","7","431",
"25 s","Visiting and Joining Family","2002 ","246","19","227",
"25 s","Visiting and Joining Family","2003 ","72","6","66",
"25 s","Visiting and Joining Family","2004 ","67","25","42",
"25 s","Visiting and Joining Family","2005 ","623","377","246",
"25 s","Visiting and Joining Family","2006 ","1146","669","477",
"25 s","Visiting and Joining Family","2007 ","282","175","107",
"25 s","Visiting and Joining Family","2008 ","66","36","30",
"25 s","Visiting and Joining Family","2009 ","104","46","58",
"25 s","Visiting and Joining Family","2010 ","291","177","114",
"25 s","Visiting and Joining Family","2011 ","261","147","114",
"25 s","Visiting and Joining Family","2012 ","127","72","55",
"25 s","Visiting and Joining Family","2013 ","65","20","45",
"25 s","Visiting and Joining Family","2014 ","91","26","65",
"25 s","Visiting and Joining Family","2015 ","97","29","68",
"25 s","Visiting and Joining Family","2016 ","170","52","118",
"25 s","Visiting and Joining Family","2017 ","188","60","128",
"25 s","Visiting and Joining Family","2018 ","137","41","96",
"25 s","Visiting and Joining Family","2019 ","178","54","124",
"25 s","Overseas Koreans","2000 ","42","21","21",
"25 s","Overseas Koreans","2001 ","40","18","22",
"25 s","Overseas Koreans","2002 ","61","26","35",
"25 s","Overseas Koreans","2003 ","58","24","34",
"25 s","Overseas Koreans","2004 ","63","43","20",
"25 s","Overseas Koreans","2005 ","85","41","44",
"25 s","Overseas Koreans","2006 ","72","38","34",
"25 s","Overseas Koreans","2007 ","80","36","44",
"25 s","Overseas Koreans","2008 ","160","86","74",
"25 s","Overseas Koreans","2009 ","194","98","96",
"25 s","Overseas Koreans","2010 ","800","343","457",
"25 s","Overseas Koreans","2011 ","1188","548","640",
"25 s","Overseas Koreans","2012 ","819","387","432",
"25 s","Overseas Koreans","2013 ","882","394","488",
"25 s","Overseas Koreans","2014 ","863","394","469",
"25 s","Overseas Koreans","2015 ","969","460","509",
"25 s","Overseas Koreans","2016 ","1086","542","544",
"25 s","Overseas Koreans","2017 ","873","458","415",
"25 s","Overseas Koreans","2018 ","746","396","350",
"25 s","Overseas Koreans","2019 ","634","325","309",
"25 s","Permanent Residence","2000 ","0","0","0",
"25 s","Permanent Residence","2001 ","0","0","0",
"25 s","Permanent Residence","2002 ","1","1","0",
"25 s","Permanent Residence","2003 ","2","1","1",
"25 s","Permanent Residence","2004 ","5","1","4",
"25 s","Permanent Residence","2005 ","5","3","2",
"25 s","Permanent Residence","2006 ","6","2","4",
"25 s","Permanent Residence","2007 ","8","2","6",
"25 s","Permanent Residence","2008 ","8","4","4",
"25 s","Permanent Residence","2009 ","10","3","7",
"25 s","Permanent Residence","2010 ","27","19","8",
"25 s","Permanent Residence","2011 ","91","53","38",
"25 s","Permanent Residence","2012 ","149","77","72",
"25 s","Permanent Residence","2013 ","139","74","65",
"25 s","Permanent Residence","2014 ","133","79","54",
"25 s","Permanent Residence","2015 ","118","64","54",
"25 s","Permanent Residence","2016 ","81","47","34",
"25 s","Permanent Residence","2017 ","59","34","25",
"25 s","Permanent Residence","2018 ","48","28","20",
"25 s","Permanent Residence","2019 ","31","16","15",
"25 s","Marriage Immigration","2011 ","47","3","44",
"25 s","Marriage Immigration","2012 ","869","43","826",
"25 s","Marriage Immigration","2013 ","775","32","743",
"25 s","Marriage Immigration","2014 ","572","20","552",
"25 s","Marriage Immigration","2015 ","550","14","536",
"25 s","Marriage Immigration","2016 ","623","18","605",
"25 s","Marriage Immigration","2017 ","549","16","533",
"25 s","Marriage Immigration","2018 ","604","18","586",
"25 s","Marriage Immigration","2019 ","622","27","595",
"26 s","Total","2000 ","6978","4433","2545",
"26 s","Total","2001 ","5905","3515","2390",
"26 s","Total","2002 ","5831","3410","2421",
"26 s","Total","2003 ","6736","4394","2342",
"26 s","Total","2004 ","5998","3703","2295",
"26 s","Total","2005 ","8567","5525","3042",
"26 s","Total","2006 ","10238","6733","3505",
"26 s","Total","2007 ","8940","5370","3570",
"26 s","Total","2008 ","10536","6210","4326",
"26 s","Total","2009 ","8200","4508","3692",
"26 s","Total","2010 ","10137","5840","4297",
"26 s","Total","2011 ","12499","7433","5066",
"26 s","Total","2012 ","13154","7976","5178",
"26 s","Total","2013 ","15696","9526","6170",
"26 s","Total","2014 ","15209","9342","5867",
"26 s","Total","2015 ","13168","7897","5271",
"26 s","Total","2016 ","13941","8469","5472",
"26 s","Total","2017 ","15195","8967","6228",
"26 s","Total","2018 ","16086","9521","6565",
"26 s","Total","2019 ","14028","8144","5884",
"26 s","Sightseeing Pass","2000 ","478","287","191",
"26 s","Sightseeing Pass","2001 ","598","388","210",
"26 s","Sightseeing Pass","2002 ","651","416","235",
"26 s","Sightseeing Pass","2003 ","363","193","170",
"26 s","Sightseeing Pass","2004 ","370","204","166",
"26 s","Sightseeing Pass","2005 ","374","190","184",
"26 s","Sightseeing Pass","2006 ","375","211","164",
"26 s","Sightseeing Pass","2007 ","346","184","162",
"26 s","Sightseeing Pass","2008 ","357","184","173",
"26 s","Sightseeing Pass","2009 ","512","270","242",
"26 s","Sightseeing Pass","2010 ","563","296","267",
"26 s","Sightseeing Pass","2011 ","505","264","241",
"26 s","Sightseeing Pass","2012 ","565","285","280",
"26 s","Sightseeing Pass","2013 ","413","249","164",
"26 s","Sightseeing Pass","2014 ","568","323","245",
"26 s","Sightseeing Pass","2015 ","675","414","261",
"26 s","Sightseeing Pass","2016 ","602","388","214",
"26 s","Sightseeing Pass","2017 ","567","355","212",
"26 s","Sightseeing Pass","2018 ","683","431","252",
"26 s","Sightseeing Pass","2019 ","405","193","212",
"26 s","Short-term Business","2000 ","541","410","131",
"26 s","Short-term Business","2001 ","583","394","189",
"26 s","Short-term Business","2002 ","286","182","104",
"26 s","Short-term Business","2003 ","236","169","67",
"26 s","Short-term Business","2004 ","232","171","61",
"26 s","Short-term Business","2005 ","183","124","59",
"26 s","Short-term Business","2006 ","348","257","91",
"26 s","Short-term Business","2007 ","585","412","173",
"26 s","Short-term Business","2008 ","295","225","70",
"26 s","Short-term Business","2009 ","91","78","13",
"26 s","Short-term Business","2010 ","112","89","23",
"26 s","Short-term Business","2011 ","110","95","15",
"26 s","Short-term Visitors","2000 ","1417","800","617",
"26 s","Short-term Visitors","2001 ","982","564","418",
"26 s","Short-term Visitors","2002 ","981","573","408",
"26 s","Short-term Visitors","2003 ","715","398","317",
"26 s","Short-term Visitors","2004 ","711","409","302",
"26 s","Short-term Visitors","2005 ","618","297","321",
"26 s","Short-term Visitors","2006 ","735","344","391",
"26 s","Short-term Visitors","2007 ","709","329","380",
"26 s","Short-term Visitors","2008 ","578","242","336",
"26 s","Short-term Visitors","2009 ","355","131","224",
"26 s","Short-term Visitors","2010 ","999","502","497",
"26 s","Short-term Visitors","2011 ","2532","1327","1205",
"26 s","Short-term Visitors","2012 ","2882","1683","1199",
"26 s","Short-term Visitors","2013 ","3947","2342","1605",
"26 s","Short-term Visitors","2014 ","2071","1230","841",
"26 s","Short-term Visitors","2015 ","2623","1453","1170",
"26 s","Short-term Visitors","2016 ","1743","1016","727",
"26 s","Short-term Visitors","2017 ","1512","891","621",
"26 s","Short-term Visitors","2018 ","1500","916","584",
"26 s","Short-term Visitors","2019 ","1326","845","481",
"26 s","Short-term Employment","2000 ","11","10","1",
"26 s","Short-term Employment","2001 ","3","3","0",
"26 s","Short-term Employment","2002 ","10","8","2",
"26 s","Short-term Employment","2003 ","9","4","5",
"26 s","Short-term Employment","2004 ","11","8","3",
"26 s","Short-term Employment","2005 ","15","11","4",
"26 s","Short-term Employment","2006 ","15","9","6",
"26 s","Short-term Employment","2007 ","27","21","6",
"26 s","Short-term Employment","2008 ","20","14","6",
"26 s","Short-term Employment","2009 ","8","3","5",
"26 s","Short-term Employment","2010 ","6","6","0",
"26 s","Short-term Employment","2011 ","9","5","4",
"26 s","Short-term Employment","2012 ","9","6","3",
"26 s","Short-term Employment","2013 ","3","2","1",
"26 s","Short-term Employment","2014 ","4","4","0",
"26 s","Short-term Employment","2015 ","7","6","1",
"26 s","Short-term Employment","2016 ","12","11","1",
"26 s","Short-term Employment","2017 ","18","11","7",
"26 s","Short-term Employment","2018 ","9","6","3",
"26 s","Short-term Employment","2019 ","2","2","0",
"26 s","Job Seeking","2000 ","0","0","0",
"26 s","Job Seeking","2001 ","0","0","0",
"26 s","Job Seeking","2002 ","0","0","0",
"26 s","Job Seeking","2003 ","0","0","0",
"26 s","Job Seeking","2004 ","0","0","0",
"26 s","Job Seeking","2005 ","0","0","0",
"26 s","Job Seeking","2006 ","0","0","0",
"26 s","Job Seeking","2007 ","0","0","0",
"26 s","Job Seeking","2008 ","0","0","0",
"26 s","Job Seeking","2009 ","0","0","0",
"26 s","Job Seeking","2010 ","0","0","0",
"26 s","Job Seeking","2011 ","1","","1",
"26 s","Job Seeking","2012 ","14","4","10",
"26 s","Job Seeking","2013 ","37","12","25",
"26 s","Job Seeking","2014 ","30","9","21",
"26 s","Job Seeking","2015 ","33","12","21",
"26 s","Job Seeking","2016 ","33","10","23",
"26 s","Job Seeking","2017 ","29","10","19",
"26 s","Job Seeking","2018 ","35","14","21",
"26 s","Job Seeking","2019 ","27","13","14",
"26 s","study","2000 ","74","38","36",
"26 s","study","2001 ","81","52","29",
"26 s","study","2002 ","93","59","34",
"26 s","study","2003 ","172","111","61",
"26 s","study","2004 ","219","131","88",
"26 s","study","2005 ","257","164","93",
"26 s","study","2006 ","316","185","131",
"26 s","study","2007 ","331","194","137",
"26 s","study","2008 ","382","221","161",
"26 s","study","2009 ","389","221","168",
"26 s","study","2010 ","428","269","159",
"26 s","study","2011 ","466","275","191",
"26 s","study","2012 ","501","293","208",
"26 s","study","2013 ","581","323","258",
"26 s","study","2014 ","630","341","289",
"26 s","study","2015 ","666","380","286",
"26 s","study","2016 ","713","376","337",
"26 s","study","2017 ","730","415","315",
"26 s","study","2018 ","911","496","415",
"26 s","study","2019 ","998","508","490",
"26 s","General Trainees","2000 ","66","37","29",
"26 s","General Trainees","2001 ","52","24","28",
"26 s","General Trainees","2002 ","58","36","22",
"26 s","General Trainees","2003 ","65","39","26",
"26 s","General Trainees","2004 ","80","29","51",
"26 s","General Trainees","2005 ","114","46","68",
"26 s","General Trainees","2006 ","147","68","79",
"26 s","General Trainees","2007 ","170","81","89",
"26 s","General Trainees","2008 ","228","87","141",
"26 s","General Trainees","2009 ","226","98","128",
"26 s","General Trainees","2010 ","296","123","173",
"26 s","General Trainees","2011 ","379","184","195",
"26 s","General Trainees","2012 ","346","160","186",
"26 s","General Trainees","2013 ","391","147","244",
"26 s","General Trainees","2014 ","413","163","250",
"26 s","General Trainees","2015 ","486","200","286",
"26 s","General Trainees","2016 ","626","264","362",
"26 s","General Trainees","2017 ","849","402","447",
"26 s","General Trainees","2018 ","751","362","389",
"26 s","General Trainees","2019 ","626","223","403",
"26 s","Religious Activities","2000 ","6","3","3",
"26 s","Religious Activities","2001 ","14","5","9",
"26 s","Religious Activities","2002 ","11","2","9",
"26 s","Religious Activities","2003 ","9","2","7",
"26 s","Religious Activities","2004 ","15","5","10",
"26 s","Religious Activities","2005 ","22","8","14",
"26 s","Religious Activities","2006 ","17","6","11",
"26 s","Religious Activities","2007 ","27","8","19",
"26 s","Religious Activities","2008 ","20","8","12",
"26 s","Religious Activities","2009 ","11","1","10",
"26 s","Religious Activities","2010 ","17","7","10",
"26 s","Religious Activities","2011 ","23","9","14",
"26 s","Religious Activities","2012 ","16","7","9",
"26 s","Religious Activities","2013 ","12","4","8",
"26 s","Religious Activities","2014 ","18","8","10",
"26 s","Religious Activities","2015 ","14","8","6",
"26 s","Religious Activities","2016 ","18","5","13",
"26 s","Religious Activities","2017 ","24","9","15",
"26 s","Religious Activities","2018 ","10","5","5",
"26 s","Religious Activities","2019 ","13","4","9",
"26 s","Investors","2000 ","35","33","2",
"26 s","Investors","2001 ","26","19","7",
"26 s","Investors","2002 ","22","19","3",
"26 s","Investors","2003 ","22","22","0",
"26 s","Investors","2004 ","22","17","5",
"26 s","Investors","2005 ","24","18","6",
"26 s","Investors","2006 ","18","14","4",
"26 s","Investors","2007 ","26","22","4",
"26 s","Investors","2008 ","24","18","6",
"26 s","Investors","2009 ","20","20","0",
"26 s","Investors","2010 ","17","15","2",
"26 s","Investors","2011 ","15","14","1",
"26 s","Investors","2012 ","11","10","1",
"26 s","Investors","2013 ","18","14","4",
"26 s","Investors","2014 ","12","8","4",
"26 s","Investors","2015 ","16","14","2",
"26 s","Investors","2016 ","7","5","2",
"26 s","Investors","2017 ","12","9","3",
"26 s","Investors","2018 ","7","5","2",
"26 s","Investors","2019 ","14","11","3",
"26 s","Trade and Business","2000 ","4","4","0",
"26 s","Trade and Business","2001 ","7","7","0",
"26 s","Trade and Business","2002 ","5","5","0",
"26 s","Trade and Business","2003 ","14","13","1",
"26 s","Trade and Business","2004 ","11","11","0",
"26 s","Trade and Business","2005 ","12","11","1",
"26 s","Trade and Business","2006 ","15","15","0",
"26 s","Trade and Business","2007 ","16","16","0",
"26 s","Trade and Business","2008 ","11","11","0",
"26 s","Trade and Business","2009 ","27","24","3",
"26 s","Trade and Business","2010 ","22","20","2",
"26 s","Trade and Business","2011 ","20","18","2",
"26 s","Trade and Business","2012 ","22","19","3",
"26 s","Trade and Business","2013 ","38","32","6",
"26 s","Trade and Business","2014 ","25","20","5",
"26 s","Trade and Business","2015 ","21","19","2",
"26 s","Trade and Business","2016 ","28","25","3",
"26 s","Trade and Business","2017 ","8","7","1",
"26 s","Trade and Business","2018 ","8","6","2",
"26 s","Trade and Business","2019 ","10","9","1",
"26 s","Research","2000 ","9","6","3",
"26 s","Research","2001 ","13","11","2",
"26 s","Research","2002 ","15","12","3",
"26 s","Research","2003 ","31","25","6",
"26 s","Research","2004 ","31","24","7",
"26 s","Research","2005 ","39","32","7",
"26 s","Research","2006 ","48","36","12",
"26 s","Research","2007 ","47","36","11",
"26 s","Research","2008 ","20","16","4",
"26 s","Research","2009 ","31","25","6",
"26 s","Research","2010 ","30","19","11",
"26 s","Research","2011 ","25","17","8",
"26 s","Research","2012 ","20","18","2",
"26 s","Research","2013 ","34","28","6",
"26 s","Research","2014 ","17","13","4",
"26 s","Research","2015 ","19","14","5",
"26 s","Research","2016 ","15","12","3",
"26 s","Research","2017 ","18","15","3",
"26 s","Research","2018 ","11","6","5",
"26 s","Research","2019 ","8","6","2",
"26 s","Art and Entertainment","2000 ","264","32","232",
"26 s","Art and Entertainment","2001 ","359","42","317",
"26 s","Art and Entertainment","2002 ","303","43","260",
"26 s","Art and Entertainment","2003 ","219","35","184",
"26 s","Art and Entertainment","2004 ","196","41","155",
"26 s","Art and Entertainment","2005 ","197","44","153",
"26 s","Art and Entertainment","2006 ","149","49","100",
"26 s","Art and Entertainment","2007 ","159","43","116",
"26 s","Art and Entertainment","2008 ","200","34","166",
"26 s","Art and Entertainment","2009 ","186","34","152",
"26 s","Art and Entertainment","2010 ","183","26","157",
"26 s","Art and Entertainment","2011 ","141","32","109",
"26 s","Art and Entertainment","2012 ","140","24","116",
"26 s","Art and Entertainment","2013 ","147","34","113",
"26 s","Art and Entertainment","2014 ","162","34","128",
"26 s","Art and Entertainment","2015 ","135","26","109",
"26 s","Art and Entertainment","2016 ","111","30","81",
"26 s","Art and Entertainment","2017 ","64","27","37",
"26 s","Art and Entertainment","2018 ","72","28","44",
"26 s","Art and Entertainment","2019 ","77","34","43",
"26 s","Unskilled Employment","2000 ","0","0","0",
"26 s","Unskilled Employment","2001 ","0","0","0",
"26 s","Unskilled Employment","2002 ","0","0","0",
"26 s","Unskilled Employment","2003 ","87","71","16",
"26 s","Unskilled Employment","2004 ","246","192","54",
"26 s","Unskilled Employment","2005 ","1604","1325","279",
"26 s","Unskilled Employment","2006 ","1764","1491","273",
"26 s","Unskilled Employment","2007 ","1899","1722","177",
"26 s","Unskilled Employment","2008 ","2963","2655","308",
"26 s","Unskilled Employment","2009 ","1575","1423","152",
"26 s","Unskilled Employment","2010 ","2416","2189","227",
"26 s","Unskilled Employment","2011 ","3406","3050","356",
"26 s","Unskilled Employment","2012 ","3576","3187","389",
"26 s","Unskilled Employment","2013 ","3631","3281","350",
"26 s","Unskilled Employment","2014 ","3938","3539","399",
"26 s","Unskilled Employment","2015 ","3436","3079","357",
"26 s","Unskilled Employment","2016 ","4367","3871","496",
"26 s","Unskilled Employment","2017 ","3568","3181","387",
"26 s","Unskilled Employment","2018 ","3911","3574","337",
"26 s","Unskilled Employment","2019 ","3968","3653","315",
"26 s","Visiting and Joining Family","2000 ","274","14","260",
"26 s","Visiting and Joining Family","2001 ","424","17","407",
"26 s","Visiting and Joining Family","2002 ","264","22","242",
"26 s","Visiting and Joining Family","2003 ","85","11","74",
"26 s","Visiting and Joining Family","2004 ","75","39","36",
"26 s","Visiting and Joining Family","2005 ","764","451","313",
"26 s","Visiting and Joining Family","2006 ","1470","864","606",
"26 s","Visiting and Joining Family","2007 ","243","141","102",
"26 s","Visiting and Joining Family","2008 ","44","20","24",
"26 s","Visiting and Joining Family","2009 ","81","44","37",
"26 s","Visiting and Joining Family","2010 ","220","125","95",
"26 s","Visiting and Joining Family","2011 ","203","95","108",
"26 s","Visiting and Joining Family","2012 ","98","38","60",
"26 s","Visiting and Joining Family","2013 ","67","35","32",
"26 s","Visiting and Joining Family","2014 ","77","17","60",
"26 s","Visiting and Joining Family","2015 ","119","27","92",
"26 s","Visiting and Joining Family","2016 ","241","60","181",
"26 s","Visiting and Joining Family","2017 ","196","70","126",
"26 s","Visiting and Joining Family","2018 ","184","60","124",
"26 s","Visiting and Joining Family","2019 ","202","58","144",
"26 s","Overseas Koreans","2000 ","31","23","8",
"26 s","Overseas Koreans","2001 ","39","21","18",
"26 s","Overseas Koreans","2002 ","51","21","30",
"26 s","Overseas Koreans","2003 ","59","35","24",
"26 s","Overseas Koreans","2004 ","64","35","29",
"26 s","Overseas Koreans","2005 ","63","43","20",
"26 s","Overseas Koreans","2006 ","82","43","39",
"26 s","Overseas Koreans","2007 ","91","43","48",
"26 s","Overseas Koreans","2008 ","127","75","52",
"26 s","Overseas Koreans","2009 ","192","110","82",
"26 s","Overseas Koreans","2010 ","674","335","339",
"26 s","Overseas Koreans","2011 ","921","456","465",
"26 s","Overseas Koreans","2012 ","681","320","361",
"26 s","Overseas Koreans","2013 ","735","342","393",
"26 s","Overseas Koreans","2014 ","731","331","400",
"26 s","Overseas Koreans","2015 ","862","428","434",
"26 s","Overseas Koreans","2016 ","1014","533","481",
"26 s","Overseas Koreans","2017 ","916","475","441",
"26 s","Overseas Koreans","2018 ","805","405","400",
"26 s","Overseas Koreans","2019 ","740","376","364",
"26 s","Permanent Residence","2000 ","0","0","0",
"26 s","Permanent Residence","2001 ","0","0","0",
"26 s","Permanent Residence","2002 ","0","0","0",
"26 s","Permanent Residence","2003 ","6","3","3",
"26 s","Permanent Residence","2004 ","6","3","3",
"26 s","Permanent Residence","2005 ","7","2","5",
"26 s","Permanent Residence","2006 ","3","2","1",
"26 s","Permanent Residence","2007 ","7","1","6",
"26 s","Permanent Residence","2008 ","11","8","3",
"26 s","Permanent Residence","2009 ","14","4","10",
"26 s","Permanent Residence","2010 ","31","15","16",
"26 s","Permanent Residence","2011 ","80","48","32",
"26 s","Permanent Residence","2012 ","117","67","50",
"26 s","Permanent Residence","2013 ","142","82","60",
"26 s","Permanent Residence","2014 ","161","91","70",
"26 s","Permanent Residence","2015 ","131","74","57",
"26 s","Permanent Residence","2016 ","122","79","43",
"26 s","Permanent Residence","2017 ","92","50","42",
"26 s","Permanent Residence","2018 ","79","45","34",
"26 s","Permanent Residence","2019 ","53","30","23",
"26 s","Marriage Immigration","2011 ","45","","45",
"26 s","Marriage Immigration","2012 ","811","33","778",
"26 s","Marriage Immigration","2013 ","782","42","740",
"26 s","Marriage Immigration","2014 ","603","36","567",
"26 s","Marriage Immigration","2015 ","568","35","533",
"26 s","Marriage Immigration","2016 ","586","36","550",
"26 s","Marriage Immigration","2017 ","528","34","494",
"26 s","Marriage Immigration","2018 ","554","26","528",
"26 s","Marriage Immigration","2019 ","617","40","577",
"27 s","Total","2000 ","7169","4562","2607",
"27 s","Total","2001 ","5687","3331","2356",
"27 s","Total","2002 ","5526","3315","2211",
"27 s","Total","2003 ","6259","4072","2187",
"27 s","Total","2004 ","5784","3633","2151",
"27 s","Total","2005 ","8055","5279","2776",
"27 s","Total","2006 ","10093","6706","3387",
"27 s","Total","2007 ","8590","5188","3402",
"27 s","Total","2008 ","8990","5481","3509",
"27 s","Total","2009 ","7564","4329","3235",
"27 s","Total","2010 ","9438","5608","3830",
"27 s","Total","2011 ","10937","6638","4299",
"27 s","Total","2012 ","11883","7316","4567",
"27 s","Total","2013 ","13774","8562","5212",
"27 s","Total","2014 ","13519","8377","5142",
"27 s","Total","2015 ","11825","7092","4733",
"27 s","Total","2016 ","13272","8236","5036",
"27 s","Total","2017 ","14843","8855","5988",
"27 s","Total","2018 ","15591","9267","6324",
"27 s","Total","2019 ","13643","8062","5581",
"27 s","Sightseeing Pass","2000 ","470","279","191",
"27 s","Sightseeing Pass","2001 ","600","407","193",
"27 s","Sightseeing Pass","2002 ","625","386","239",
"27 s","Sightseeing Pass","2003 ","361","228","133",
"27 s","Sightseeing Pass","2004 ","349","187","162",
"27 s","Sightseeing Pass","2005 ","341","171","170",
"27 s","Sightseeing Pass","2006 ","342","182","160",
"27 s","Sightseeing Pass","2007 ","354","199","155",
"27 s","Sightseeing Pass","2008 ","372","196","176",
"27 s","Sightseeing Pass","2009 ","432","217","215",
"27 s","Sightseeing Pass","2010 ","557","316","241",
"27 s","Sightseeing Pass","2011 ","487","259","228",
"27 s","Sightseeing Pass","2012 ","493","252","241",
"27 s","Sightseeing Pass","2013 ","415","242","173",
"27 s","Sightseeing Pass","2014 ","531","318","213",
"27 s","Sightseeing Pass","2015 ","702","430","272",
"27 s","Sightseeing Pass","2016 ","561","329","232",
"27 s","Sightseeing Pass","2017 ","676","425","251",
"27 s","Sightseeing Pass","2018 ","823","529","294",
"27 s","Sightseeing Pass","2019 ","474","267","207",
"27 s","Short-term Business","2000 ","647","454","193",
"27 s","Short-term Business","2001 ","647","410","237",
"27 s","Short-term Business","2002 ","354","248","106",
"27 s","Short-term Business","2003 ","245","166","79",
"27 s","Short-term Business","2004 ","260","185","75",
"27 s","Short-term Business","2005 ","221","162","59",
"27 s","Short-term Business","2006 ","367","269","98",
"27 s","Short-term Business","2007 ","596","422","174",
"27 s","Short-term Business","2008 ","346","267","79",
"27 s","Short-term Business","2009 ","106","83","23",
"27 s","Short-term Business","2010 ","113","98","15",
"27 s","Short-term Business","2011 ","116","98","18",
"27 s","Short-term Visitors","2000 ","1410","830","580",
"27 s","Short-term Visitors","2001 ","1090","609","481",
"27 s","Short-term Visitors","2002 ","1021","570","451",
"27 s","Short-term Visitors","2003 ","775","426","349",
"27 s","Short-term Visitors","2004 ","693","422","271",
"27 s","Short-term Visitors","2005 ","597","326","271",
"27 s","Short-term Visitors","2006 ","710","365","345",
"27 s","Short-term Visitors","2007 ","696","320","376",
"27 s","Short-term Visitors","2008 ","527","220","307",
"27 s","Short-term Visitors","2009 ","343","138","205",
"27 s","Short-term Visitors","2010 ","1071","586","485",
"27 s","Short-term Visitors","2011 ","2005","1091","914",
"27 s","Short-term Visitors","2012 ","2261","1358","903",
"27 s","Short-term Visitors","2013 ","2790","1647","1143",
"27 s","Short-term Visitors","2014 ","1450","844","606",
"27 s","Short-term Visitors","2015 ","1892","1040","852",
"27 s","Short-term Visitors","2016 ","1768","1025","743",
"27 s","Short-term Visitors","2017 ","1703","1030","673",
"27 s","Short-term Visitors","2018 ","1561","975","586",
"27 s","Short-term Visitors","2019 ","1439","906","533",
"27 s","Short-term Employment","2000 ","13","12","1",
"27 s","Short-term Employment","2001 ","2","2","0",
"27 s","Short-term Employment","2002 ","17","13","4",
"27 s","Short-term Employment","2003 ","17","9","8",
"27 s","Short-term Employment","2004 ","11","9","2",
"27 s","Short-term Employment","2005 ","9","6","3",
"27 s","Short-term Employment","2006 ","8","4","4",
"27 s","Short-term Employment","2007 ","19","7","12",
"27 s","Short-term Employment","2008 ","10","7","3",
"27 s","Short-term Employment","2009 ","10","6","4",
"27 s","Short-term Employment","2010 ","3","1","2",
"27 s","Short-term Employment","2011 ","4","3","1",
"27 s","Short-term Employment","2012 ","7","4","3",
"27 s","Short-term Employment","2013 ","7","6","1",
"27 s","Short-term Employment","2014 ","6","4","2",
"27 s","Short-term Employment","2015 ","5","2","3",
"27 s","Short-term Employment","2016 ","18","14","4",
"27 s","Short-term Employment","2017 ","9","4","5",
"27 s","Short-term Employment","2018 ","6","3","3",
"27 s","Short-term Employment","2019 ","8","7","1",
"27 s","Job Seeking","2000 ","0","0","0",
"27 s","Job Seeking","2001 ","0","0","0",
"27 s","Job Seeking","2002 ","0","0","0",
"27 s","Job Seeking","2003 ","0","0","0",
"27 s","Job Seeking","2004 ","0","0","0",
"27 s","Job Seeking","2005 ","0","0","0",
"27 s","Job Seeking","2006 ","0","0","0",
"27 s","Job Seeking","2007 ","0","0","0",
"27 s","Job Seeking","2008 ","0","0","0",
"27 s","Job Seeking","2009 ","0","0","0",
"27 s","Job Seeking","2010 ","0","0","0",
"27 s","Job Seeking","2011 ","2","1","1",
"27 s","Job Seeking","2012 ","15","8","7",
"27 s","Job Seeking","2013 ","32","7","25",
"27 s","Job Seeking","2014 ","20","10","10",
"27 s","Job Seeking","2015 ","23","8","15",
"27 s","Job Seeking","2016 ","38","14","24",
"27 s","Job Seeking","2017 ","25","7","18",
"27 s","Job Seeking","2018 ","28","7","21",
"27 s","Job Seeking","2019 ","23","13","10",
"27 s","study","2000 ","72","43","29",
"27 s","study","2001 ","59","28","31",
"27 s","study","2002 ","76","46","30",
"27 s","study","2003 ","102","62","40",
"27 s","study","2004 ","167","103","64",
"27 s","study","2005 ","176","102","74",
"27 s","study","2006 ","204","126","78",
"27 s","study","2007 ","254","149","105",
"27 s","study","2008 ","252","135","117",
"27 s","study","2009 ","314","192","122",
"27 s","study","2010 ","311","184","127",
"27 s","study","2011 ","351","214","137",
"27 s","study","2012 ","341","197","144",
"27 s","study","2013 ","386","231","155",
"27 s","study","2014 ","503","294","209",
"27 s","study","2015 ","438","254","184",
"27 s","study","2016 ","513","278","235",
"27 s","study","2017 ","580","332","248",
"27 s","study","2018 ","740","388","352",
"27 s","study","2019 ","759","417","342",
"27 s","General Trainees","2000 ","40","20","20",
"27 s","General Trainees","2001 ","48","31","17",
"27 s","General Trainees","2002 ","43","23","20",
"27 s","General Trainees","2003 ","40","24","16",
"27 s","General Trainees","2004 ","75","27","48",
"27 s","General Trainees","2005 ","88","40","48",
"27 s","General Trainees","2006 ","98","44","54",
"27 s","General Trainees","2007 ","111","49","62",
"27 s","General Trainees","2008 ","127","56","71",
"27 s","General Trainees","2009 ","172","63","109",
"27 s","General Trainees","2010 ","196","78","118",
"27 s","General Trainees","2011 ","269","120","149",
"27 s","General Trainees","2012 ","292","126","166",
"27 s","General Trainees","2013 ","270","108","162",
"27 s","General Trainees","2014 ","340","131","209",
"27 s","General Trainees","2015 ","361","123","238",
"27 s","General Trainees","2016 ","432","171","261",
"27 s","General Trainees","2017 ","602","278","324",
"27 s","General Trainees","2018 ","492","242","250",
"27 s","General Trainees","2019 ","408","137","271",
"27 s","Religious Activities","2000 ","9","4","5",
"27 s","Religious Activities","2001 ","13","4","9",
"27 s","Religious Activities","2002 ","13","10","3",
"27 s","Religious Activities","2003 ","12","6","6",
"27 s","Religious Activities","2004 ","10","6","4",
"27 s","Religious Activities","2005 ","17","4","13",
"27 s","Religious Activities","2006 ","32","16","16",
"27 s","Religious Activities","2007 ","20","6","14",
"27 s","Religious Activities","2008 ","20","7","13",
"27 s","Religious Activities","2009 ","13","7","6",
"27 s","Religious Activities","2010 ","13","6","7",
"27 s","Religious Activities","2011 ","18","10","8",
"27 s","Religious Activities","2012 ","25","12","13",
"27 s","Religious Activities","2013 ","10","4","6",
"27 s","Religious Activities","2014 ","7","4","3",
"27 s","Religious Activities","2015 ","7","5","2",
"27 s","Religious Activities","2016 ","12","6","6",
"27 s","Religious Activities","2017 ","14","8","6",
"27 s","Religious Activities","2018 ","7","3","4",
"27 s","Religious Activities","2019 ","14","4","10",
"27 s","Investors","2000 ","37","22","15",
"27 s","Investors","2001 ","37","29","8",
"27 s","Investors","2002 ","26","23","3",
"27 s","Investors","2003 ","17","16","1",
"27 s","Investors","2004 ","19","16","3",
"27 s","Investors","2005 ","28","23","5",
"27 s","Investors","2006 ","17","14","3",
"27 s","Investors","2007 ","29","27","2",
"27 s","Investors","2008 ","27","21","6",
"27 s","Investors","2009 ","17","13","4",
"27 s","Investors","2010 ","23","17","6",
"27 s","Investors","2011 ","21","21","",
"27 s","Investors","2012 ","19","17","2",
"27 s","Investors","2013 ","24","17","7",
"27 s","Investors","2014 ","21","16","5",
"27 s","Investors","2015 ","20","16","4",
"27 s","Investors","2016 ","26","22","4",
"27 s","Investors","2017 ","11","10","1",
"27 s","Investors","2018 ","14","11","3",
"27 s","Investors","2019 ","13","10","3",
"27 s","Trade and Business","2000 ","4","4","0",
"27 s","Trade and Business","2001 ","9","9","0",
"27 s","Trade and Business","2002 ","7","7","0",
"27 s","Trade and Business","2003 ","7","6","1",
"27 s","Trade and Business","2004 ","7","5","2",
"27 s","Trade and Business","2005 ","22","19","3",
"27 s","Trade and Business","2006 ","6","6","0",
"27 s","Trade and Business","2007 ","13","13","0",
"27 s","Trade and Business","2008 ","27","26","1",
"27 s","Trade and Business","2009 ","34","33","1",
"27 s","Trade and Business","2010 ","30","27","3",
"27 s","Trade and Business","2011 ","28","26","2",
"27 s","Trade and Business","2012 ","32","28","4",
"27 s","Trade and Business","2013 ","37","36","1",
"27 s","Trade and Business","2014 ","50","46","4",
"27 s","Trade and Business","2015 ","18","17","1",
"27 s","Trade and Business","2016 ","16","13","3",
"27 s","Trade and Business","2017 ","8","8","0",
"27 s","Trade and Business","2018 ","12","11","1",
"27 s","Trade and Business","2019 ","25","24","1",
"27 s","Research","2000 ","15","12","3",
"27 s","Research","2001 ","20","15","5",
"27 s","Research","2002 ","40","33","7",
"27 s","Research","2003 ","33","27","6",
"27 s","Research","2004 ","47","38","9",
"27 s","Research","2005 ","51","41","10",
"27 s","Research","2006 ","52","44","8",
"27 s","Research","2007 ","57","45","12",
"27 s","Research","2008 ","31","23","8",
"27 s","Research","2009 ","33","24","9",
"27 s","Research","2010 ","52","40","12",
"27 s","Research","2011 ","49","39","10",
"27 s","Research","2012 ","39","32","7",
"27 s","Research","2013 ","44","38","6",
"27 s","Research","2014 ","29","27","2",
"27 s","Research","2015 ","28","22","6",
"27 s","Research","2016 ","41","30","11",
"27 s","Research","2017 ","32","29","3",
"27 s","Research","2018 ","23","15","8",
"27 s","Research","2019 ","34","25","9",
"27 s","Art and Entertainment","2000 ","222","32","190",
"27 s","Art and Entertainment","2001 ","242","27","215",
"27 s","Art and Entertainment","2002 ","269","41","228",
"27 s","Art and Entertainment","2003 ","181","36","145",
"27 s","Art and Entertainment","2004 ","182","50","132",
"27 s","Art and Entertainment","2005 ","149","37","112",
"27 s","Art and Entertainment","2006 ","140","36","104",
"27 s","Art and Entertainment","2007 ","145","31","114",
"27 s","Art and Entertainment","2008 ","178","45","133",
"27 s","Art and Entertainment","2009 ","158","26","132",
"27 s","Art and Entertainment","2010 ","163","29","134",
"27 s","Art and Entertainment","2011 ","115","26","89",
"27 s","Art and Entertainment","2012 ","135","16","119",
"27 s","Art and Entertainment","2013 ","136","30","106",
"27 s","Art and Entertainment","2014 ","145","38","107",
"27 s","Art and Entertainment","2015 ","126","25","101",
"27 s","Art and Entertainment","2016 ","102","27","75",
"27 s","Art and Entertainment","2017 ","70","27","43",
"27 s","Art and Entertainment","2018 ","79","34","45",
"27 s","Art and Entertainment","2019 ","81","30","51",
"27 s","Unskilled Employment","2000 ","0","0","0",
"27 s","Unskilled Employment","2001 ","0","0","0",
"27 s","Unskilled Employment","2002 ","0","0","0",
"27 s","Unskilled Employment","2003 ","97","77","20",
"27 s","Unskilled Employment","2004 ","293","217","76",
"27 s","Unskilled Employment","2005 ","1590","1309","281",
"27 s","Unskilled Employment","2006 ","1782","1521","261",
"27 s","Unskilled Employment","2007 ","1758","1602","156",
"27 s","Unskilled Employment","2008 ","2710","2422","288",
"27 s","Unskilled Employment","2009 ","1574","1420","154",
"27 s","Unskilled Employment","2010 ","2272","2050","222",
"27 s","Unskilled Employment","2011 ","3052","2716","336",
"27 s","Unskilled Employment","2012 ","3469","3131","338",
"27 s","Unskilled Employment","2013 ","3778","3424","354",
"27 s","Unskilled Employment","2014 ","3615","3332","283",
"27 s","Unskilled Employment","2015 ","3184","2870","314",
"27 s","Unskilled Employment","2016 ","4189","3832","357",
"27 s","Unskilled Employment","2017 ","3448","3135","313",
"27 s","Unskilled Employment","2018 ","3713","3404","309",
"27 s","Unskilled Employment","2019 ","3740","3477","263",
"27 s","Visiting and Joining Family","2000 ","318","19","299",
"27 s","Visiting and Joining Family","2001 ","443","25","418",
"27 s","Visiting and Joining Family","2002 ","216","14","202",
"27 s","Visiting and Joining Family","2003 ","76","8","68",
"27 s","Visiting and Joining Family","2004 ","70","36","34",
"27 s","Visiting and Joining Family","2005 ","764","440","324",
"27 s","Visiting and Joining Family","2006 ","1629","979","650",
"27 s","Visiting and Joining Family","2007 ","327","184","143",
"27 s","Visiting and Joining Family","2008 ","20","10","10",
"27 s","Visiting and Joining Family","2009 ","45","15","30",
"27 s","Visiting and Joining Family","2010 ","172","100","72",
"27 s","Visiting and Joining Family","2011 ","164","96","68",
"27 s","Visiting and Joining Family","2012 ","87","40","47",
"27 s","Visiting and Joining Family","2013 ","61","25","36",
"27 s","Visiting and Joining Family","2014 ","87","22","65",
"27 s","Visiting and Joining Family","2015 ","111","31","80",
"27 s","Visiting and Joining Family","2016 ","304","78","226",
"27 s","Visiting and Joining Family","2017 ","259","77","182",
"27 s","Visiting and Joining Family","2018 ","220","61","159",
"27 s","Visiting and Joining Family","2019 ","218","58","160",
"27 s","Overseas Koreans","2000 ","44","28","16",
"27 s","Overseas Koreans","2001 ","48","27","21",
"27 s","Overseas Koreans","2002 ","57","35","22",
"27 s","Overseas Koreans","2003 ","63","36","27",
"27 s","Overseas Koreans","2004 ","59","30","29",
"27 s","Overseas Koreans","2005 ","76","39","37",
"27 s","Overseas Koreans","2006 ","69","38","31",
"27 s","Overseas Koreans","2007 ","106","59","47",
"27 s","Overseas Koreans","2008 ","118","66","52",
"27 s","Overseas Koreans","2009 ","140","70","70",
"27 s","Overseas Koreans","2010 ","498","246","252",
"27 s","Overseas Koreans","2011 ","675","346","329",
"27 s","Overseas Koreans","2012 ","585","267","318",
"27 s","Overseas Koreans","2013 ","630","306","324",
"27 s","Overseas Koreans","2014 ","636","276","360",
"27 s","Overseas Koreans","2015 ","798","389","409",
"27 s","Overseas Koreans","2016 ","971","496","475",
"27 s","Overseas Koreans","2017 ","906","470","436",
"27 s","Overseas Koreans","2018 ","916","464","452",
"27 s","Overseas Koreans","2019 ","833","400","433",
"27 s","Permanent Residence","2000 ","0","0","0",
"27 s","Permanent Residence","2001 ","0","0","0",
"27 s","Permanent Residence","2002 ","1","1","0",
"27 s","Permanent Residence","2003 ","4","2","2",
"27 s","Permanent Residence","2004 ","4","2","2",
"27 s","Permanent Residence","2005 ","5","3","2",
"27 s","Permanent Residence","2006 ","8","3","5",
"27 s","Permanent Residence","2007 ","12","6","6",
"27 s","Permanent Residence","2008 ","11","7","4",
"27 s","Permanent Residence","2009 ","11","6","5",
"27 s","Permanent Residence","2010 ","28","12","16",
"27 s","Permanent Residence","2011 ","82","42","40",
"27 s","Permanent Residence","2012 ","117","69","48",
"27 s","Permanent Residence","2013 ","143","80","63",
"27 s","Permanent Residence","2014 ","160","95","65",
"27 s","Permanent Residence","2015 ","136","64","72",
"27 s","Permanent Residence","2016 ","130","59","71",
"27 s","Permanent Residence","2017 ","114","59","55",
"27 s","Permanent Residence","2018 ","87","52","35",
"27 s","Permanent Residence","2019 ","62","33","29",
"27 s","Marriage Immigration","2011 ","36","3","33",
"27 s","Marriage Immigration","2012 ","752","36","716",
"27 s","Marriage Immigration","2013 ","727","42","685",
"27 s","Marriage Immigration","2014 ","529","34","495",
"27 s","Marriage Immigration","2015 ","572","28","544",
"27 s","Marriage Immigration","2016 ","549","38","511",
"27 s","Marriage Immigration","2017 ","563","32","531",
"27 s","Marriage Immigration","2018 ","530","34","496",
"27 s","Marriage Immigration","2019 ","605","46","559",
"28 s","Total","2000 ","6982","4590","2392",
"28 s","Total","2001 ","5811","3412","2399",
"28 s","Total","2002 ","5256","3199","2057",
"28 s","Total","2003 ","5879","3854","2025",
"28 s","Total","2004 ","5587","3626","1961",
"28 s","Total","2005 ","7726","5253","2473",
"28 s","Total","2006 ","9634","6606","3028",
"28 s","Total","2007 ","8372","5032","3340",
"28 s","Total","2008 ","8849","5479","3370",
"28 s","Total","2009 ","6768","4022","2746",
"28 s","Total","2010 ","8852","5363","3489",
"28 s","Total","2011 ","10099","6191","3908",
"28 s","Total","2012 ","10738","6857","3881",
"28 s","Total","2013 ","12487","8020","4467",
"28 s","Total","2014 ","12408","7798","4610",
"28 s","Total","2015 ","11558","7016","4542",
"28 s","Total","2016 ","13074","8187","4887",
"28 s","Total","2017 ","14330","8675","5655",
"28 s","Total","2018 ","15909","9715","6194",
"28 s","Total","2019 ","13796","8418","5378",
"28 s","Sightseeing Pass","2000 ","422","255","167",
"28 s","Sightseeing Pass","2001 ","621","419","202",
"28 s","Sightseeing Pass","2002 ","588","357","231",
"28 s","Sightseeing Pass","2003 ","363","215","148",
"28 s","Sightseeing Pass","2004 ","380","209","171",
"28 s","Sightseeing Pass","2005 ","331","186","145",
"28 s","Sightseeing Pass","2006 ","348","193","155",
"28 s","Sightseeing Pass","2007 ","352","196","156",
"28 s","Sightseeing Pass","2008 ","390","230","160",
"28 s","Sightseeing Pass","2009 ","394","219","175",
"28 s","Sightseeing Pass","2010 ","555","309","246",
"28 s","Sightseeing Pass","2011 ","446","237","209",
"28 s","Sightseeing Pass","2012 ","465","258","207",
"28 s","Sightseeing Pass","2013 ","388","202","186",
"28 s","Sightseeing Pass","2014 ","540","303","237",
"28 s","Sightseeing Pass","2015 ","677","393","284",
"28 s","Sightseeing Pass","2016 ","604","369","235",
"28 s","Sightseeing Pass","2017 ","734","479","255",
"28 s","Sightseeing Pass","2018 ","968","639","329",
"28 s","Sightseeing Pass","2019 ","553","294","259",
"28 s","Short-term Business","2000 ","700","464","236",
"28 s","Short-term Business","2001 ","819","513","306",
"28 s","Short-term Business","2002 ","346","231","115",
"28 s","Short-term Business","2003 ","278","192","86",
"28 s","Short-term Business","2004 ","260","193","67",
"28 s","Short-term Business","2005 ","202","140","62",
"28 s","Short-term Business","2006 ","404","296","108",
"28 s","Short-term Business","2007 ","609","455","154",
"28 s","Short-term Business","2008 ","310","239","71",
"28 s","Short-term Business","2009 ","109","87","22",
"28 s","Short-term Business","2010 ","123","103","20",
"28 s","Short-term Business","2011 ","114","96","18",
"28 s","Short-term Visitors","2000 ","1371","852","519",
"28 s","Short-term Visitors","2001 ","1087","601","486",
"28 s","Short-term Visitors","2002 ","1027","588","439",
"28 s","Short-term Visitors","2003 ","721","411","310",
"28 s","Short-term Visitors","2004 ","669","420","249",
"28 s","Short-term Visitors","2005 ","603","330","273",
"28 s","Short-term Visitors","2006 ","794","449","345",
"28 s","Short-term Visitors","2007 ","698","337","361",
"28 s","Short-term Visitors","2008 ","515","206","309",
"28 s","Short-term Visitors","2009 ","342","138","204",
"28 s","Short-term Visitors","2010 ","968","530","438",
"28 s","Short-term Visitors","2011 ","1711","931","780",
"28 s","Short-term Visitors","2012 ","1869","1142","727",
"28 s","Short-term Visitors","2013 ","2278","1396","882",
"28 s","Short-term Visitors","2014 ","1241","724","517",
"28 s","Short-term Visitors","2015 ","1795","951","844",
"28 s","Short-term Visitors","2016 ","1515","870","645",
"28 s","Short-term Visitors","2017 ","1660","996","664",
"28 s","Short-term Visitors","2018 ","1711","1045","666",
"28 s","Short-term Visitors","2019 ","1533","998","535",
"28 s","Short-term Employment","2000 ","7","7","0",
"28 s","Short-term Employment","2001 ","4","3","1",
"28 s","Short-term Employment","2002 ","10","8","2",
"28 s","Short-term Employment","2003 ","11","7","4",
"28 s","Short-term Employment","2004 ","10","6","4",
"28 s","Short-term Employment","2005 ","12","9","3",
"28 s","Short-term Employment","2006 ","9","7","2",
"28 s","Short-term Employment","2007 ","21","16","5",
"28 s","Short-term Employment","2008 ","15","10","5",
"28 s","Short-term Employment","2009 ","7","3","4",
"28 s","Short-term Employment","2010 ","5","3","2",
"28 s","Short-term Employment","2011 ","5","4","1",
"28 s","Short-term Employment","2012 ","3","2","1",
"28 s","Short-term Employment","2013 ","2","1","1",
"28 s","Short-term Employment","2014 ","3","3","0",
"28 s","Short-term Employment","2015 ","7","6","1",
"28 s","Short-term Employment","2016 ","18","15","3",
"28 s","Short-term Employment","2017 ","18","8","10",
"28 s","Short-term Employment","2018 ","5","3","2",
"28 s","Short-term Employment","2019 ","2","1","1",
"28 s","Job Seeking","2000 ","0","0","0",
"28 s","Job Seeking","2001 ","0","0","0",
"28 s","Job Seeking","2002 ","0","0","0",
"28 s","Job Seeking","2003 ","0","0","0",
"28 s","Job Seeking","2004 ","0","0","0",
"28 s","Job Seeking","2005 ","0","0","0",
"28 s","Job Seeking","2006 ","0","0","0",
"28 s","Job Seeking","2007 ","0","0","0",
"28 s","Job Seeking","2008 ","0","0","0",
"28 s","Job Seeking","2009 ","0","0","0",
"28 s","Job Seeking","2010 ","0","0","0",
"28 s","Job Seeking","2011 ","2","2","",
"28 s","Job Seeking","2012 ","10","6","4",
"28 s","Job Seeking","2013 ","14","9","5",
"28 s","Job Seeking","2014 ","13","6","7",
"28 s","Job Seeking","2015 ","27","10","17",
"28 s","Job Seeking","2016 ","18","7","11",
"28 s","Job Seeking","2017 ","19","8","11",
"28 s","Job Seeking","2018 ","37","18","19",
"28 s","Job Seeking","2019 ","13","8","5",
"28 s","study","2000 ","61","36","25",
"28 s","study","2001 ","72","45","27",
"28 s","study","2002 ","75","41","34",
"28 s","study","2003 ","70","47","23",
"28 s","study","2004 ","99","64","35",
"28 s","study","2005 ","164","110","54",
"28 s","study","2006 ","166","96","70",
"28 s","study","2007 ","175","100","75",
"28 s","study","2008 ","193","127","66",
"28 s","study","2009 ","205","116","89",
"28 s","study","2010 ","223","137","86",
"28 s","study","2011 ","264","167","97",
"28 s","study","2012 ","282","193","89",
"28 s","study","2013 ","283","189","94",
"28 s","study","2014 ","304","206","98",
"28 s","study","2015 ","353","207","146",
"28 s","study","2016 ","412","252","160",
"28 s","study","2017 ","460","252","208",
"28 s","study","2018 ","593","361","232",
"28 s","study","2019 ","641","347","294",
"28 s","General Trainees","2000 ","36","21","15",
"28 s","General Trainees","2001 ","51","30","21",
"28 s","General Trainees","2002 ","31","16","15",
"28 s","General Trainees","2003 ","34","11","23",
"28 s","General Trainees","2004 ","67","31","36",
"28 s","General Trainees","2005 ","70","32","38",
"28 s","General Trainees","2006 ","87","34","53",
"28 s","General Trainees","2007 ","80","30","50",
"28 s","General Trainees","2008 ","102","47","55",
"28 s","General Trainees","2009 ","99","32","67",
"28 s","General Trainees","2010 ","160","66","94",
"28 s","General Trainees","2011 ","233","101","132",
"28 s","General Trainees","2012 ","190","94","96",
"28 s","General Trainees","2013 ","220","101","119",
"28 s","General Trainees","2014 ","233","91","142",
"28 s","General Trainees","2015 ","253","113","140",
"28 s","General Trainees","2016 ","351","154","197",
"28 s","General Trainees","2017 ","418","179","239",
"28 s","General Trainees","2018 ","370","182","188",
"28 s","General Trainees","2019 ","271","105","166",
"28 s","Religious Activities","2000 ","5","2","3",
"28 s","Religious Activities","2001 ","7","3","4",
"28 s","Religious Activities","2002 ","8","5","3",
"28 s","Religious Activities","2003 ","7","3","4",
"28 s","Religious Activities","2004 ","5","2","3",
"28 s","Religious Activities","2005 ","11","7","4",
"28 s","Religious Activities","2006 ","12","4","8",
"28 s","Religious Activities","2007 ","23","11","12",
"28 s","Religious Activities","2008 ","17","8","9",
"28 s","Religious Activities","2009 ","12","6","6",
"28 s","Religious Activities","2010 ","18","8","10",
"28 s","Religious Activities","2011 ","8","5","3",
"28 s","Religious Activities","2012 ","20","7","13",
"28 s","Religious Activities","2013 ","6","1","5",
"28 s","Religious Activities","2014 ","12","7","5",
"28 s","Religious Activities","2015 ","10","2","8",
"28 s","Religious Activities","2016 ","14","4","10",
"28 s","Religious Activities","2017 ","11","7","4",
"28 s","Religious Activities","2018 ","5","2","3",
"28 s","Religious Activities","2019 ","15","8","7",
"28 s","Investors","2000 ","52","36","16",
"28 s","Investors","2001 ","36","25","11",
"28 s","Investors","2002 ","23","19","4",
"28 s","Investors","2003 ","17","13","4",
"28 s","Investors","2004 ","20","17","3",
"28 s","Investors","2005 ","33","27","6",
"28 s","Investors","2006 ","26","20","6",
"28 s","Investors","2007 ","35","29","6",
"28 s","Investors","2008 ","29","26","3",
"28 s","Investors","2009 ","24","23","1",
"28 s","Investors","2010 ","29","26","3",
"28 s","Investors","2011 ","36","33","3",
"28 s","Investors","2012 ","24","24","",
"28 s","Investors","2013 ","25","20","5",
"28 s","Investors","2014 ","23","18","5",
"28 s","Investors","2015 ","22","21","1",
"28 s","Investors","2016 ","28","22","6",
"28 s","Investors","2017 ","29","24","5",
"28 s","Investors","2018 ","20","17","3",
"28 s","Investors","2019 ","15","11","4",
"28 s","Trade and Business","2000 ","8","7","1",
"28 s","Trade and Business","2001 ","9","9","0",
"28 s","Trade and Business","2002 ","5","5","0",
"28 s","Trade and Business","2003 ","11","11","0",
"28 s","Trade and Business","2004 ","13","12","1",
"28 s","Trade and Business","2005 ","18","18","0",
"28 s","Trade and Business","2006 ","17","17","0",
"28 s","Trade and Business","2007 ","19","18","1",
"28 s","Trade and Business","2008 ","18","18","0",
"28 s","Trade and Business","2009 ","26","24","2",
"28 s","Trade and Business","2010 ","29","27","2",
"28 s","Trade and Business","2011 ","30","28","2",
"28 s","Trade and Business","2012 ","32","29","3",
"28 s","Trade and Business","2013 ","37","34","3",
"28 s","Trade and Business","2014 ","38","35","3",
"28 s","Trade and Business","2015 ","33","29","4",
"28 s","Trade and Business","2016 ","27","25","2",
"28 s","Trade and Business","2017 ","14","12","2",
"28 s","Trade and Business","2018 ","15","15","0",
"28 s","Trade and Business","2019 ","17","16","1",
"28 s","Research","2000 ","18","14","4",
"28 s","Research","2001 ","19","17","2",
"28 s","Research","2002 ","32","27","5",
"28 s","Research","2003 ","36","29","7",
"28 s","Research","2004 ","46","43","3",
"28 s","Research","2005 ","53","49","4",
"28 s","Research","2006 ","73","66","7",
"28 s","Research","2007 ","68","55","13",
"28 s","Research","2008 ","53","42","11",
"28 s","Research","2009 ","53","46","7",
"28 s","Research","2010 ","57","49","8",
"28 s","Research","2011 ","69","56","13",
"28 s","Research","2012 ","59","48","11",
"28 s","Research","2013 ","56","46","10",
"28 s","Research","2014 ","71","56","15",
"28 s","Research","2015 ","64","55","9",
"28 s","Research","2016 ","45","36","9",
"28 s","Research","2017 ","60","44","16",
"28 s","Research","2018 ","57","42","15",
"28 s","Research","2019 ","42","32","10",
"28 s","Art and Entertainment","2000 ","146","26","120",
"28 s","Art and Entertainment","2001 ","213","31","182",
"28 s","Art and Entertainment","2002 ","189","46","143",
"28 s","Art and Entertainment","2003 ","165","28","137",
"28 s","Art and Entertainment","2004 ","122","30","92",
"28 s","Art and Entertainment","2005 ","125","43","82",
"28 s","Art and Entertainment","2006 ","128","33","95",
"28 s","Art and Entertainment","2007 ","144","27","117",
"28 s","Art and Entertainment","2008 ","160","33","127",
"28 s","Art and Entertainment","2009 ","140","27","113",
"28 s","Art and Entertainment","2010 ","154","32","122",
"28 s","Art and Entertainment","2011 ","103","36","67",
"28 s","Art and Entertainment","2012 ","150","34","116",
"28 s","Art and Entertainment","2013 ","132","26","106",
"28 s","Art and Entertainment","2014 ","133","27","106",
"28 s","Art and Entertainment","2015 ","103","25","78",
"28 s","Art and Entertainment","2016 ","66","20","46",
"28 s","Art and Entertainment","2017 ","59","32","27",
"28 s","Art and Entertainment","2018 ","67","28","39",
"28 s","Art and Entertainment","2019 ","73","24","49",
"28 s","Unskilled Employment","2000 ","0","0","0",
"28 s","Unskilled Employment","2001 ","0","0","0",
"28 s","Unskilled Employment","2002 ","0","0","0",
"28 s","Unskilled Employment","2003 ","78","60","18",
"28 s","Unskilled Employment","2004 ","286","218","68",
"28 s","Unskilled Employment","2005 ","1593","1310","283",
"28 s","Unskilled Employment","2006 ","1747","1482","265",
"28 s","Unskilled Employment","2007 ","1599","1437","162",
"28 s","Unskilled Employment","2008 ","2552","2277","275",
"28 s","Unskilled Employment","2009 ","1541","1387","154",
"28 s","Unskilled Employment","2010 ","2153","1975","178",
"28 s","Unskilled Employment","2011 ","2860","2578","282",
"28 s","Unskilled Employment","2012 ","3249","2962","287",
"28 s","Unskilled Employment","2013 ","3600","3299","301",
"28 s","Unskilled Employment","2014 ","3469","3190","279",
"28 s","Unskilled Employment","2015 ","3137","2859","278",
"28 s","Unskilled Employment","2016 ","4138","3787","351",
"28 s","Unskilled Employment","2017 ","3216","2928","288",
"28 s","Unskilled Employment","2018 ","3644","3373","271",
"28 s","Unskilled Employment","2019 ","3729","3447","282",
"28 s","Visiting and Joining Family","2000 ","272","26","246",
"28 s","Visiting and Joining Family","2001 ","460","20","440",
"28 s","Visiting and Joining Family","2002 ","241","23","218",
"28 s","Visiting and Joining Family","2003 ","88","14","74",
"28 s","Visiting and Joining Family","2004 ","89","37","52",
"28 s","Visiting and Joining Family","2005 ","727","406","321",
"28 s","Visiting and Joining Family","2006 ","1560","932","628",
"28 s","Visiting and Joining Family","2007 ","328","167","161",
"28 s","Visiting and Joining Family","2008 ","30","13","17",
"28 s","Visiting and Joining Family","2009 ","30","13","17",
"28 s","Visiting and Joining Family","2010 ","124","59","65",
"28 s","Visiting and Joining Family","2011 ","125","65","60",
"28 s","Visiting and Joining Family","2012 ","78","35","43",
"28 s","Visiting and Joining Family","2013 ","59","33","26",
"28 s","Visiting and Joining Family","2014 ","81","18","63",
"28 s","Visiting and Joining Family","2015 ","127","36","91",
"28 s","Visiting and Joining Family","2016 ","316","80","236",
"28 s","Visiting and Joining Family","2017 ","252","63","189",
"28 s","Visiting and Joining Family","2018 ","237","72","165",
"28 s","Visiting and Joining Family","2019 ","239","64","175",
"28 s","Overseas Koreans","2000 ","48","31","17",
"28 s","Overseas Koreans","2001 ","47","29","18",
"28 s","Overseas Koreans","2002 ","66","39","27",
"28 s","Overseas Koreans","2003 ","60","40","20",
"28 s","Overseas Koreans","2004 ","51","33","18",
"28 s","Overseas Koreans","2005 ","60","30","30",
"28 s","Overseas Koreans","2006 ","62","31","31",
"28 s","Overseas Koreans","2007 ","70","35","35",
"28 s","Overseas Koreans","2008 ","111","66","45",
"28 s","Overseas Koreans","2009 ","115","62","53",
"28 s","Overseas Koreans","2010 ","365","190","175",
"28 s","Overseas Koreans","2011 ","553","284","269",
"28 s","Overseas Koreans","2012 ","490","255","235",
"28 s","Overseas Koreans","2013 ","553","268","285",
"28 s","Overseas Koreans","2014 ","562","264","298",
"28 s","Overseas Koreans","2015 ","673","308","365",
"28 s","Overseas Koreans","2016 ","911","472","439",
"28 s","Overseas Koreans","2017 ","866","464","402",
"28 s","Overseas Koreans","2018 ","922","462","460",
"28 s","Overseas Koreans","2019 ","816","437","379",
"28 s","Permanent Residence","2000 ","0","0","0",
"28 s","Permanent Residence","2001 ","0","0","0",
"28 s","Permanent Residence","2002 ","0","0","0",
"28 s","Permanent Residence","2003 ","0","0","0",
"28 s","Permanent Residence","2004 ","5","3","2",
"28 s","Permanent Residence","2005 ","1","1","0",
"28 s","Permanent Residence","2006 ","7","6","1",
"28 s","Permanent Residence","2007 ","4","0","4",
"28 s","Permanent Residence","2008 ","11","4","7",
"28 s","Permanent Residence","2009 ","16","5","11",
"28 s","Permanent Residence","2010 ","30","17","13",
"28 s","Permanent Residence","2011 ","90","47","43",
"28 s","Permanent Residence","2012 ","100","53","47",
"28 s","Permanent Residence","2013 ","154","79","75",
"28 s","Permanent Residence","2014 ","163","81","82",
"28 s","Permanent Residence","2015 ","154","77","77",
"28 s","Permanent Residence","2016 ","140","63","77",
"28 s","Permanent Residence","2017 ","136","72","64",
"28 s","Permanent Residence","2018 ","106","50","56",
"28 s","Permanent Residence","2019 ","86","50","36",
"28 s","Marriage Immigration","2011 ","34","","34",
"28 s","Marriage Immigration","2012 ","725","51","674",
"28 s","Marriage Immigration","2013 ","690","57","633",
"28 s","Marriage Immigration","2014 ","492","44","448",
"28 s","Marriage Immigration","2015 ","529","28","501",
"28 s","Marriage Immigration","2016 ","583","42","541",
"28 s","Marriage Immigration","2017 ","545","50","495",
"28 s","Marriage Immigration","2018 ","551","40","511",
"28 s","Marriage Immigration","2019 ","573","41","532",
"29 s","Total","2000 ","6871","4475","2396",
"29 s","Total","2001 ","5448","3272","2176",
"29 s","Total","2002 ","5422","3340","2082",
"29 s","Total","2003 ","5777","3857","1920",
"29 s","Total","2004 ","5547","3666","1881",
"29 s","Total","2005 ","7510","5161","2349",
"29 s","Total","2006 ","9200","6353","2847",
"29 s","Total","2007 ","7587","4694","2893",
"29 s","Total","2008 ","8270","5143","3127",
"29 s","Total","2009 ","6512","3869","2643",
"29 s","Total","2010 ","7697","4782","2915",
"29 s","Total","2011 ","9519","5990","3529",
"29 s","Total","2012 ","10077","6487","3590",
"29 s","Total","2013 ","11243","7263","3980",
"29 s","Total","2014 ","11427","7224","4203",
"29 s","Total","2015 ","10711","6619","4092",
"29 s","Total","2016 ","12728","7986","4742",
"29 s","Total","2017 ","14080","8679","5401",
"29 s","Total","2018 ","15193","9203","5990",
"29 s","Total","2019 ","13505","8150","5355",
"29 s","Sightseeing Pass","2000 ","438","266","172",
"29 s","Sightseeing Pass","2001 ","555","365","190",
"29 s","Sightseeing Pass","2002 ","593","370","223",
"29 s","Sightseeing Pass","2003 ","381","232","149",
"29 s","Sightseeing Pass","2004 ","383","209","174",
"29 s","Sightseeing Pass","2005 ","322","181","141",
"29 s","Sightseeing Pass","2006 ","298","159","139",
"29 s","Sightseeing Pass","2007 ","311","173","138",
"29 s","Sightseeing Pass","2008 ","350","178","172",
"29 s","Sightseeing Pass","2009 ","371","203","168",
"29 s","Sightseeing Pass","2010 ","506","287","219",
"29 s","Sightseeing Pass","2011 ","463","245","218",
"29 s","Sightseeing Pass","2012 ","472","240","232",
"29 s","Sightseeing Pass","2013 ","369","206","163",
"29 s","Sightseeing Pass","2014 ","483","268","215",
"29 s","Sightseeing Pass","2015 ","637","385","252",
"29 s","Sightseeing Pass","2016 ","584","358","226",
"29 s","Sightseeing Pass","2017 ","660","423","237",
"29 s","Sightseeing Pass","2018 ","967","640","327",
"29 s","Sightseeing Pass","2019 ","653","355","298",
"29 s","Short-term Business","2000 ","788","522","266",
"29 s","Short-term Business","2001 ","860","523","337",
"29 s","Short-term Business","2002 ","460","288","172",
"29 s","Short-term Business","2003 ","286","202","84",
"29 s","Short-term Business","2004 ","300","213","87",
"29 s","Short-term Business","2005 ","213","155","58",
"29 s","Short-term Business","2006 ","416","290","126",
"29 s","Short-term Business","2007 ","621","468","153",
"29 s","Short-term Business","2008 ","323","249","74",
"29 s","Short-term Business","2009 ","103","83","20",
"29 s","Short-term Business","2010 ","103","88","15",
"29 s","Short-term Business","2011 ","122","111","11",
"29 s","Short-term Visitors","2000 ","1360","808","552",
"29 s","Short-term Visitors","2001 ","1080","655","425",
"29 s","Short-term Visitors","2002 ","1113","687","426",
"29 s","Short-term Visitors","2003 ","686","407","279",
"29 s","Short-term Visitors","2004 ","671","406","265",
"29 s","Short-term Visitors","2005 ","594","342","252",
"29 s","Short-term Visitors","2006 ","687","400","287",
"29 s","Short-term Visitors","2007 ","650","324","326",
"29 s","Short-term Visitors","2008 ","522","225","297",
"29 s","Short-term Visitors","2009 ","303","116","187",
"29 s","Short-term Visitors","2010 ","819","433","386",
"29 s","Short-term Visitors","2011 ","1455","772","683",
"29 s","Short-term Visitors","2012 ","1589","968","621",
"29 s","Short-term Visitors","2013 ","1879","1130","749",
"29 s","Short-term Visitors","2014 ","1077","612","465",
"29 s","Short-term Visitors","2015 ","1647","865","782",
"29 s","Short-term Visitors","2016 ","1582","925","657",
"29 s","Short-term Visitors","2017 ","1684","1053","631",
"29 s","Short-term Visitors","2018 ","1688","996","692",
"29 s","Short-term Visitors","2019 ","1683","1088","595",
"29 s","Short-term Employment","2000 ","6","5","1",
"29 s","Short-term Employment","2001 ","5","3","2",
"29 s","Short-term Employment","2002 ","14","10","4",
"29 s","Short-term Employment","2003 ","8","6","2",
"29 s","Short-term Employment","2004 ","4","3","1",
"29 s","Short-term Employment","2005 ","9","8","1",
"29 s","Short-term Employment","2006 ","15","9","6",
"29 s","Short-term Employment","2007 ","20","14","6",
"29 s","Short-term Employment","2008 ","11","8","3",
"29 s","Short-term Employment","2009 ","6","5","1",
"29 s","Short-term Employment","2010 ","9","6","3",
"29 s","Short-term Employment","2011 ","6","6","",
"29 s","Short-term Employment","2012 ","9","7","2",
"29 s","Short-term Employment","2013 ","2","2","0",
"29 s","Short-term Employment","2014 ","3","2","1",
"29 s","Short-term Employment","2015 ","9","8","1",
"29 s","Short-term Employment","2016 ","17","15","2",
"29 s","Short-term Employment","2017 ","12","4","8",
"29 s","Short-term Employment","2018 ","4","2","2",
"29 s","Short-term Employment","2019 ","6","5","1",
"29 s","Job Seeking","2000 ","0","0","0",
"29 s","Job Seeking","2001 ","0","0","0",
"29 s","Job Seeking","2002 ","0","0","0",
"29 s","Job Seeking","2003 ","0","0","0",
"29 s","Job Seeking","2004 ","0","0","0",
"29 s","Job Seeking","2005 ","0","0","0",
"29 s","Job Seeking","2006 ","0","0","0",
"29 s","Job Seeking","2007 ","0","0","0",
"29 s","Job Seeking","2008 ","0","0","0",
"29 s","Job Seeking","2009 ","0","0","0",
"29 s","Job Seeking","2010 ","1","1","0",
"29 s","Job Seeking","2011 ","2","2","",
"29 s","Job Seeking","2012 ","9","5","4",
"29 s","Job Seeking","2013 ","14","8","6",
"29 s","Job Seeking","2014 ","14","4","10",
"29 s","Job Seeking","2015 ","15","4","11",
"29 s","Job Seeking","2016 ","22","9","13",
"29 s","Job Seeking","2017 ","15","5","10",
"29 s","Job Seeking","2018 ","26","13","13",
"29 s","Job Seeking","2019 ","23","9","14",
"29 s","study","2000 ","53","29","24",
"29 s","study","2001 ","71","45","26",
"29 s","study","2002 ","69","39","30",
"29 s","study","2003 ","77","48","29",
"29 s","study","2004 ","98","76","22",
"29 s","study","2005 ","130","96","34",
"29 s","study","2006 ","129","92","37",
"29 s","study","2007 ","162","106","56",
"29 s","study","2008 ","185","123","62",
"29 s","study","2009 ","162","96","66",
"29 s","study","2010 ","191","113","78",
"29 s","study","2011 ","206","127","79",
"29 s","study","2012 ","226","149","77",
"29 s","study","2013 ","235","166","69",
"29 s","study","2014 ","268","166","102",
"29 s","study","2015 ","270","173","97",
"29 s","study","2016 ","327","185","142",
"29 s","study","2017 ","345","219","126",
"29 s","study","2018 ","479","283","196",
"29 s","study","2019 ","509","276","233",
"29 s","General Trainees","2000 ","49","29","20",
"29 s","General Trainees","2001 ","27","9","18",
"29 s","General Trainees","2002 ","38","23","15",
"29 s","General Trainees","2003 ","30","17","13",
"29 s","General Trainees","2004 ","46","23","23",
"29 s","General Trainees","2005 ","48","22","26",
"29 s","General Trainees","2006 ","61","27","34",
"29 s","General Trainees","2007 ","58","21","37",
"29 s","General Trainees","2008 ","77","32","45",
"29 s","General Trainees","2009 ","89","47","42",
"29 s","General Trainees","2010 ","109","43","66",
"29 s","General Trainees","2011 ","171","80","91",
"29 s","General Trainees","2012 ","162","72","90",
"29 s","General Trainees","2013 ","195","89","106",
"29 s","General Trainees","2014 ","180","87","93",
"29 s","General Trainees","2015 ","219","107","112",
"29 s","General Trainees","2016 ","226","85","141",
"29 s","General Trainees","2017 ","271","125","146",
"29 s","General Trainees","2018 ","253","97","156",
"29 s","General Trainees","2019 ","222","95","127",
"29 s","Religious Activities","2000 ","8","4","4",
"29 s","Religious Activities","2001 ","8","6","2",
"29 s","Religious Activities","2002 ","12","3","9",
"29 s","Religious Activities","2003 ","7","3","4",
"29 s","Religious Activities","2004 ","9","6","3",
"29 s","Religious Activities","2005 ","6","2","4",
"29 s","Religious Activities","2006 ","13","7","6",
"29 s","Religious Activities","2007 ","22","9","13",
"29 s","Religious Activities","2008 ","23","8","15",
"29 s","Religious Activities","2009 ","12","6","6",
"29 s","Religious Activities","2010 ","15","8","7",
"29 s","Religious Activities","2011 ","11","3","8",
"29 s","Religious Activities","2012 ","17","9","8",
"29 s","Religious Activities","2013 ","5","3","2",
"29 s","Religious Activities","2014 ","4","1","3",
"29 s","Religious Activities","2015 ","9","5","4",
"29 s","Religious Activities","2016 ","9","5","4",
"29 s","Religious Activities","2017 ","9","4","5",
"29 s","Religious Activities","2018 ","4","0","4",
"29 s","Religious Activities","2019 ","15","5","10",
"29 s","Investors","2000 ","67","47","20",
"29 s","Investors","2001 ","48","40","8",
"29 s","Investors","2002 ","25","22","3",
"29 s","Investors","2003 ","23","20","3",
"29 s","Investors","2004 ","27","22","5",
"29 s","Investors","2005 ","27","23","4",
"29 s","Investors","2006 ","27","25","2",
"29 s","Investors","2007 ","29","28","1",
"29 s","Investors","2008 ","25","23","2",
"29 s","Investors","2009 ","26","25","1",
"29 s","Investors","2010 ","31","29","2",
"29 s","Investors","2011 ","35","32","3",
"29 s","Investors","2012 ","22","19","3",
"29 s","Investors","2013 ","26","23","3",
"29 s","Investors","2014 ","16","15","1",
"29 s","Investors","2015 ","12","10","2",
"29 s","Investors","2016 ","27","25","2",
"29 s","Investors","2017 ","11","10","1",
"29 s","Investors","2018 ","20","16","4",
"29 s","Investors","2019 ","25","16","9",
"29 s","Trade and Business","2000 ","9","8","1",
"29 s","Trade and Business","2001 ","9","9","0",
"29 s","Trade and Business","2002 ","12","12","0",
"29 s","Trade and Business","2003 ","17","17","0",
"29 s","Trade and Business","2004 ","16","15","1",
"29 s","Trade and Business","2005 ","22","21","1",
"29 s","Trade and Business","2006 ","18","17","1",
"29 s","Trade and Business","2007 ","17","15","2",
"29 s","Trade and Business","2008 ","18","17","1",
"29 s","Trade and Business","2009 ","27","25","2",
"29 s","Trade and Business","2010 ","44","40","4",
"29 s","Trade and Business","2011 ","37","36","1",
"29 s","Trade and Business","2012 ","30","27","3",
"29 s","Trade and Business","2013 ","45","41","4",
"29 s","Trade and Business","2014 ","53","49","4",
"29 s","Trade and Business","2015 ","31","29","2",
"29 s","Trade and Business","2016 ","19","17","2",
"29 s","Trade and Business","2017 ","15","14","1",
"29 s","Trade and Business","2018 ","15","15","0",
"29 s","Trade and Business","2019 ","20","19","1",
"29 s","Research","2000 ","23","16","7",
"29 s","Research","2001 ","26","24","2",
"29 s","Research","2002 ","34","31","3",
"29 s","Research","2003 ","37","32","5",
"29 s","Research","2004 ","47","39","8",
"29 s","Research","2005 ","65","56","9",
"29 s","Research","2006 ","74","58","16",
"29 s","Research","2007 ","53","47","6",
"29 s","Research","2008 ","63","50","13",
"29 s","Research","2009 ","63","60","3",
"29 s","Research","2010 ","67","57","10",
"29 s","Research","2011 ","80","73","7",
"29 s","Research","2012 ","79","68","11",
"29 s","Research","2013 ","69","53","16",
"29 s","Research","2014 ","75","66","9",
"29 s","Research","2015 ","67","56","11",
"29 s","Research","2016 ","77","63","14",
"29 s","Research","2017 ","67","57","10",
"29 s","Research","2018 ","61","53","8",
"29 s","Research","2019 ","71","59","12",
"29 s","Art and Entertainment","2000 ","118","19","99",
"29 s","Art and Entertainment","2001 ","155","18","137",
"29 s","Art and Entertainment","2002 ","147","40","107",
"29 s","Art and Entertainment","2003 ","126","30","96",
"29 s","Art and Entertainment","2004 ","121","34","87",
"29 s","Art and Entertainment","2005 ","116","30","86",
"29 s","Art and Entertainment","2006 ","102","34","68",
"29 s","Art and Entertainment","2007 ","119","29","90",
"29 s","Art and Entertainment","2008 ","129","40","89",
"29 s","Art and Entertainment","2009 ","111","17","94",
"29 s","Art and Entertainment","2010 ","117","28","89",
"29 s","Art and Entertainment","2011 ","94","13","81",
"29 s","Art and Entertainment","2012 ","140","33","107",
"29 s","Art and Entertainment","2013 ","151","24","127",
"29 s","Art and Entertainment","2014 ","111","26","85",
"29 s","Art and Entertainment","2015 ","90","31","59",
"29 s","Art and Entertainment","2016 ","89","33","56",
"29 s","Art and Entertainment","2017 ","54","24","30",
"29 s","Art and Entertainment","2018 ","62","30","32",
"29 s","Art and Entertainment","2019 ","56","27","29",
"29 s","Unskilled Employment","2000 ","0","0","0",
"29 s","Unskilled Employment","2001 ","0","0","0",
"29 s","Unskilled Employment","2002 ","0","0","0",
"29 s","Unskilled Employment","2003 ","110","77","33",
"29 s","Unskilled Employment","2004 ","318","236","82",
"29 s","Unskilled Employment","2005 ","1546","1292","254",
"29 s","Unskilled Employment","2006 ","1734","1465","269",
"29 s","Unskilled Employment","2007 ","1596","1445","151",
"29 s","Unskilled Employment","2008 ","2337","2101","236",
"29 s","Unskilled Employment","2009 ","1296","1185","111",
"29 s","Unskilled Employment","2010 ","1947","1795","152",
"29 s","Unskilled Employment","2011 ","2707","2465","242",
"29 s","Unskilled Employment","2012 ","3106","2868","238",
"29 s","Unskilled Employment","2013 ","3338","3091","247",
"29 s","Unskilled Employment","2014 ","3186","2969","217",
"29 s","Unskilled Employment","2015 ","2878","2673","205",
"29 s","Unskilled Employment","2016 ","3687","3364","323",
"29 s","Unskilled Employment","2017 ","2999","2761","238",
"29 s","Unskilled Employment","2018 ","3244","3039","205",
"29 s","Unskilled Employment","2019 ","3385","3182","203",
"29 s","Visiting and Joining Family","2000 ","265","13","252",
"29 s","Visiting and Joining Family","2001 ","410","24","386",
"29 s","Visiting and Joining Family","2002 ","236","24","212",
"29 s","Visiting and Joining Family","2003 ","81","23","58",
"29 s","Visiting and Joining Family","2004 ","113","66","47",
"29 s","Visiting and Joining Family","2005 ","848","485","363",
"29 s","Visiting and Joining Family","2006 ","1532","915","617",
"29 s","Visiting and Joining Family","2007 ","288","159","129",
"29 s","Visiting and Joining Family","2008 ","36","11","25",
"29 s","Visiting and Joining Family","2009 ","30","9","21",
"29 s","Visiting and Joining Family","2010 ","75","40","35",
"29 s","Visiting and Joining Family","2011 ","98","55","43",
"29 s","Visiting and Joining Family","2012 ","67","34","33",
"29 s","Visiting and Joining Family","2013 ","53","27","26",
"29 s","Visiting and Joining Family","2014 ","70","16","54",
"29 s","Visiting and Joining Family","2015 ","113","21","92",
"29 s","Visiting and Joining Family","2016 ","362","90","272",
"29 s","Visiting and Joining Family","2017 ","265","76","189",
"29 s","Visiting and Joining Family","2018 ","249","66","183",
"29 s","Visiting and Joining Family","2019 ","279","73","206",
"29 s","Overseas Koreans","2000 ","38","25","13",
"29 s","Overseas Koreans","2001 ","46","24","22",
"29 s","Overseas Koreans","2002 ","64","44","20",
"29 s","Overseas Koreans","2003 ","61","34","27",
"29 s","Overseas Koreans","2004 ","54","32","22",
"29 s","Overseas Koreans","2005 ","63","39","24",
"29 s","Overseas Koreans","2006 ","72","32","40",
"29 s","Overseas Koreans","2007 ","54","26","28",
"29 s","Overseas Koreans","2008 ","89","40","49",
"29 s","Overseas Koreans","2009 ","129","74","55",
"29 s","Overseas Koreans","2010 ","275","153","122",
"29 s","Overseas Koreans","2011 ","439","223","216",
"29 s","Overseas Koreans","2012 ","404","211","193",
"29 s","Overseas Koreans","2013 ","469","234","235",
"29 s","Overseas Koreans","2014 ","497","232","265",
"29 s","Overseas Koreans","2015 ","625","302","323",
"29 s","Overseas Koreans","2016 ","855","432","423",
"29 s","Overseas Koreans","2017 ","847","460","387",
"29 s","Overseas Koreans","2018 ","849","431","418",
"29 s","Overseas Koreans","2019 ","898","464","434",
"29 s","Permanent Residence","2000 ","0","0","0",
"29 s","Permanent Residence","2001 ","0","0","0",
"29 s","Permanent Residence","2002 ","0","0","0",
"29 s","Permanent Residence","2003 ","2","2","0",
"29 s","Permanent Residence","2004 ","8","5","3",
"29 s","Permanent Residence","2005 ","5","3","2",
"29 s","Permanent Residence","2006 ","2","1","1",
"29 s","Permanent Residence","2007 ","9","3","6",
"29 s","Permanent Residence","2008 ","9","0","9",
"29 s","Permanent Residence","2009 ","7","2","5",
"29 s","Permanent Residence","2010 ","38","19","19",
"29 s","Permanent Residence","2011 ","92","50","42",
"29 s","Permanent Residence","2012 ","121","48","73",
"29 s","Permanent Residence","2013 ","141","66","75",
"29 s","Permanent Residence","2014 ","137","74","63",
"29 s","Permanent Residence","2015 ","157","82","75",
"29 s","Permanent Residence","2016 ","157","85","72",
"29 s","Permanent Residence","2017 ","154","61","93",
"29 s","Permanent Residence","2018 ","113","52","61",
"29 s","Permanent Residence","2019 ","111","58","53",
"29 s","Marriage Immigration","2011 ","30","1","29",
"29 s","Marriage Immigration","2012 ","651","51","600",
"29 s","Marriage Immigration","2013 ","601","64","537",
"29 s","Marriage Immigration","2014 ","523","48","475",
"29 s","Marriage Immigration","2015 ","517","47","470",
"29 s","Marriage Immigration","2016 ","550","56","494",
"29 s","Marriage Immigration","2017 ","524","60","464",
"29 s","Marriage Immigration","2018 ","594","62","532",
"29 s","Marriage Immigration","2019 ","621","61","560",
"30 s","Total","2000 ","6473","4246","2227",
"30 s","Total","2001 ","5636","3523","2113",
"30 s","Total","2002 ","5386","3392","1994",
"30 s","Total","2003 ","5913","4013","1900",
"30 s","Total","2004 ","5611","3747","1864",
"30 s","Total","2005 ","7419","5207","2212",
"30 s","Total","2006 ","8967","6276","2691",
"30 s","Total","2007 ","6961","4405","2556",
"30 s","Total","2008 ","7513","4728","2785",
"30 s","Total","2009 ","6092","3730","2362",
"30 s","Total","2010 ","7520","4736","2784",
"30 s","Total","2011 ","8058","5231","2827",
"30 s","Total","2012 ","9032","5769","3263",
"30 s","Total","2013 ","10640","7095","3545",
"30 s","Total","2014 ","10562","6664","3898",
"30 s","Total","2015 ","9918","6234","3684",
"30 s","Total","2016 ","11870","7532","4338",
"30 s","Total","2017 ","13793","8439","5354",
"30 s","Total","2018 ","14784","9060","5724",
"30 s","Total","2019 ","13215","8073","5142",
"30 s","Sightseeing Pass","2000 ","397","240","157",
"30 s","Sightseeing Pass","2001 ","549","381","168",
"30 s","Sightseeing Pass","2002 ","554","362","192",
"30 s","Sightseeing Pass","2003 ","367","227","140",
"30 s","Sightseeing Pass","2004 ","388","231","157",
"30 s","Sightseeing Pass","2005 ","336","191","145",
"30 s","Sightseeing Pass","2006 ","287","142","145",
"30 s","Sightseeing Pass","2007 ","305","176","129",
"30 s","Sightseeing Pass","2008 ","360","217","143",
"30 s","Sightseeing Pass","2009 ","329","188","141",
"30 s","Sightseeing Pass","2010 ","498","292","206",
"30 s","Sightseeing Pass","2011 ","376","217","159",
"30 s","Sightseeing Pass","2012 ","429","236","193",
"30 s","Sightseeing Pass","2013 ","361","200","161",
"30 s","Sightseeing Pass","2014 ","444","257","187",
"30 s","Sightseeing Pass","2015 ","541","323","218",
"30 s","Sightseeing Pass","2016 ","560","353","207",
"30 s","Sightseeing Pass","2017 ","697","463","234",
"30 s","Sightseeing Pass","2018 ","958","628","330",
"30 s","Sightseeing Pass","2019 ","591","304","287",
"30 s","Short-term Business","2000 ","785","497","288",
"30 s","Short-term Business","2001 ","941","584","357",
"30 s","Short-term Business","2002 ","462","302","160",
"30 s","Short-term Business","2003 ","343","247","96",
"30 s","Short-term Business","2004 ","284","215","69",
"30 s","Short-term Business","2005 ","258","193","65",
"30 s","Short-term Business","2006 ","451","332","119",
"30 s","Short-term Business","2007 ","609","460","149",
"30 s","Short-term Business","2008 ","341","262","79",
"30 s","Short-term Business","2009 ","105","82","23",
"30 s","Short-term Business","2010 ","109","101","8",
"30 s","Short-term Business","2011 ","98","86","12",
"30 s","Short-term Visitors","2000 ","1341","816","525",
"30 s","Short-term Visitors","2001 ","1181","745","436",
"30 s","Short-term Visitors","2002 ","1178","712","466",
"30 s","Short-term Visitors","2003 ","743","439","304",
"30 s","Short-term Visitors","2004 ","653","404","249",
"30 s","Short-term Visitors","2005 ","585","346","239",
"30 s","Short-term Visitors","2006 ","768","428","340",
"30 s","Short-term Visitors","2007 ","591","282","309",
"30 s","Short-term Visitors","2008 ","472","220","252",
"30 s","Short-term Visitors","2009 ","282","123","159",
"30 s","Short-term Visitors","2010 ","799","422","377",
"30 s","Short-term Visitors","2011 ","1157","630","527",
"30 s","Short-term Visitors","2012 ","1342","764","578",
"30 s","Short-term Visitors","2013 ","1645","1013","632",
"30 s","Short-term Visitors","2014 ","1026","601","425",
"30 s","Short-term Visitors","2015 ","1441","788","653",
"30 s","Short-term Visitors","2016 ","1426","824","602",
"30 s","Short-term Visitors","2017 ","1694","1054","640",
"30 s","Short-term Visitors","2018 ","1644","1022","622",
"30 s","Short-term Visitors","2019 ","1729","1143","586",
"30 s","Short-term Employment","2000 ","9","8","1",
"30 s","Short-term Employment","2001 ","5","3","2",
"30 s","Short-term Employment","2002 ","20","16","4",
"30 s","Short-term Employment","2003 ","11","6","5",
"30 s","Short-term Employment","2004 ","11","7","4",
"30 s","Short-term Employment","2005 ","10","8","2",
"30 s","Short-term Employment","2006 ","12","8","4",
"30 s","Short-term Employment","2007 ","18","14","4",
"30 s","Short-term Employment","2008 ","12","10","2",
"30 s","Short-term Employment","2009 ","8","7","1",
"30 s","Short-term Employment","2010 ","5","3","2",
"30 s","Short-term Employment","2011 ","3","2","1",
"30 s","Short-term Employment","2012 ","5","4","1",
"30 s","Short-term Employment","2013 ","6","4","2",
"30 s","Short-term Employment","2014 ","2","1","1",
"30 s","Short-term Employment","2015 ","2","2","0",
"30 s","Short-term Employment","2016 ","15","14","1",
"30 s","Short-term Employment","2017 ","14","6","8",
"30 s","Short-term Employment","2018 ","18","14","4",
"30 s","Short-term Employment","2019 ","9","7","2",
"30 s","Job Seeking","2000 ","0","0","0",
"30 s","Job Seeking","2001 ","0","0","0",
"30 s","Job Seeking","2002 ","0","0","0",
"30 s","Job Seeking","2003 ","0","0","0",
"30 s","Job Seeking","2004 ","0","0","0",
"30 s","Job Seeking","2005 ","0","0","0",
"30 s","Job Seeking","2006 ","0","0","0",
"30 s","Job Seeking","2007 ","0","0","0",
"30 s","Job Seeking","2008 ","0","0","0",
"30 s","Job Seeking","2009 ","0","0","0",
"30 s","Job Seeking","2010 ","3","1","2",
"30 s","Job Seeking","2011 ","3","2","1",
"30 s","Job Seeking","2012 ","4","3","1",
"30 s","Job Seeking","2013 ","4","2","2",
"30 s","Job Seeking","2014 ","7","4","3",
"30 s","Job Seeking","2015 ","9","7","2",
"30 s","Job Seeking","2016 ","12","2","10",
"30 s","Job Seeking","2017 ","13","8","5",
"30 s","Job Seeking","2018 ","18","7","11",
"30 s","Job Seeking","2019 ","16","10","6",
"30 s","study","2000 ","46","26","20",
"30 s","study","2001 ","50","36","14",
"30 s","study","2002 ","62","45","17",
"30 s","study","2003 ","55","36","19",
"30 s","study","2004 ","76","46","30",
"30 s","study","2005 ","84","58","26",
"30 s","study","2006 ","99","65","34",
"30 s","study","2007 ","111","78","33",
"30 s","study","2008 ","140","79","61",
"30 s","study","2009 ","114","68","46",
"30 s","study","2010 ","154","104","50",
"30 s","study","2011 ","133","95","38",
"30 s","study","2012 ","189","117","72",
"30 s","study","2013 ","162","110","52",
"30 s","study","2014 ","195","126","69",
"30 s","study","2015 ","212","125","87",
"30 s","study","2016 ","264","163","101",
"30 s","study","2017 ","280","189","91",
"30 s","study","2018 ","370","231","139",
"30 s","study","2019 ","412","223","189",
"30 s","General Trainees","2000 ","23","13","10",
"30 s","General Trainees","2001 ","36","20","16",
"30 s","General Trainees","2002 ","32","21","11",
"30 s","General Trainees","2003 ","32","20","12",
"30 s","General Trainees","2004 ","50","23","27",
"30 s","General Trainees","2005 ","47","28","19",
"30 s","General Trainees","2006 ","43","27","16",
"30 s","General Trainees","2007 ","51","16","35",
"30 s","General Trainees","2008 ","56","20","36",
"30 s","General Trainees","2009 ","71","35","36",
"30 s","General Trainees","2010 ","88","37","51",
"30 s","General Trainees","2011 ","127","63","64",
"30 s","General Trainees","2012 ","137","67","70",
"30 s","General Trainees","2013 ","125","57","68",
"30 s","General Trainees","2014 ","146","63","83",
"30 s","General Trainees","2015 ","177","86","91",
"30 s","General Trainees","2016 ","176","77","99",
"30 s","General Trainees","2017 ","184","77","107",
"30 s","General Trainees","2018 ","157","76","81",
"30 s","General Trainees","2019 ","153","49","104",
"30 s","Religious Activities","2000 ","1","1","0",
"30 s","Religious Activities","2001 ","7","2","5",
"30 s","Religious Activities","2002 ","6","3","3",
"30 s","Religious Activities","2003 ","11","7","4",
"30 s","Religious Activities","2004 ","23","9","14",
"30 s","Religious Activities","2005 ","13","5","8",
"30 s","Religious Activities","2006 ","12","7","5",
"30 s","Religious Activities","2007 ","16","4","12",
"30 s","Religious Activities","2008 ","11","7","4",
"30 s","Religious Activities","2009 ","13","11","2",
"30 s","Religious Activities","2010 ","15","9","6",
"30 s","Religious Activities","2011 ","9","3","6",
"30 s","Religious Activities","2012 ","16","8","8",
"30 s","Religious Activities","2013 ","7","5","2",
"30 s","Religious Activities","2014 ","6","4","2",
"30 s","Religious Activities","2015 ","11","4","7",
"30 s","Religious Activities","2016 ","15","10","5",
"30 s","Religious Activities","2017 ","3","1","2",
"30 s","Religious Activities","2018 ","10","5","5",
"30 s","Religious Activities","2019 ","7","4","3",
"30 s","Investors","2000 ","81","46","35",
"30 s","Investors","2001 ","69","53","16",
"30 s","Investors","2002 ","40","34","6",
"30 s","Investors","2003 ","39","36","3",
"30 s","Investors","2004 ","44","38","6",
"30 s","Investors","2005 ","57","49","8",
"30 s","Investors","2006 ","28","23","5",
"30 s","Investors","2007 ","26","23","3",
"30 s","Investors","2008 ","34","31","3",
"30 s","Investors","2009 ","33","30","3",
"30 s","Investors","2010 ","23","19","4",
"30 s","Investors","2011 ","32","28","4",
"30 s","Investors","2012 ","24","23","1",
"30 s","Investors","2013 ","31","26","5",
"30 s","Investors","2014 ","18","16","2",
"30 s","Investors","2015 ","19","17","2",
"30 s","Investors","2016 ","39","36","3",
"30 s","Investors","2017 ","20","14","6",
"30 s","Investors","2018 ","24","21","3",
"30 s","Investors","2019 ","24","19","5",
"30 s","Trade and Business","2000 ","14","12","2",
"30 s","Trade and Business","2001 ","9","9","0",
"30 s","Trade and Business","2002 ","14","12","2",
"30 s","Trade and Business","2003 ","14","14","0",
"30 s","Trade and Business","2004 ","11","9","2",
"30 s","Trade and Business","2005 ","24","23","1",
"30 s","Trade and Business","2006 ","18","17","1",
"30 s","Trade and Business","2007 ","17","17","0",
"30 s","Trade and Business","2008 ","25","24","1",
"30 s","Trade and Business","2009 ","26","24","2",
"30 s","Trade and Business","2010 ","23","23","0",
"30 s","Trade and Business","2011 ","37","32","5",
"30 s","Trade and Business","2012 ","35","32","3",
"30 s","Trade and Business","2013 ","55","52","3",
"30 s","Trade and Business","2014 ","62","56","6",
"30 s","Trade and Business","2015 ","46","43","3",
"30 s","Trade and Business","2016 ","24","23","1",
"30 s","Trade and Business","2017 ","16","13","3",
"30 s","Trade and Business","2018 ","18","17","1",
"30 s","Trade and Business","2019 ","20","18","2",
"30 s","Research","2000 ","21","18","3",
"30 s","Research","2001 ","33","29","4",
"30 s","Research","2002 ","29","24","5",
"30 s","Research","2003 ","41","37","4",
"30 s","Research","2004 ","57","52","5",
"30 s","Research","2005 ","48","38","10",
"30 s","Research","2006 ","57","52","5",
"30 s","Research","2007 ","55","48","7",
"30 s","Research","2008 ","48","41","7",
"30 s","Research","2009 ","46","35","11",
"30 s","Research","2010 ","73","68","5",
"30 s","Research","2011 ","74","67","7",
"30 s","Research","2012 ","75","65","10",
"30 s","Research","2013 ","82","67","15",
"30 s","Research","2014 ","83","74","9",
"30 s","Research","2015 ","71","65","6",
"30 s","Research","2016 ","88","80","8",
"30 s","Research","2017 ","76","63","13",
"30 s","Research","2018 ","59","52","7",
"30 s","Research","2019 ","57","52","5",
"30 s","Art and Entertainment","2000 ","92","31","61",
"30 s","Art and Entertainment","2001 ","117","32","85",
"30 s","Art and Entertainment","2002 ","107","34","73",
"30 s","Art and Entertainment","2003 ","90","33","57",
"30 s","Art and Entertainment","2004 ","81","28","53",
"30 s","Art and Entertainment","2005 ","91","26","65",
"30 s","Art and Entertainment","2006 ","87","34","53",
"30 s","Art and Entertainment","2007 ","97","33","64",
"30 s","Art and Entertainment","2008 ","125","33","92",
"30 s","Art and Entertainment","2009 ","110","22","88",
"30 s","Art and Entertainment","2010 ","95","22","73",
"30 s","Art and Entertainment","2011 ","72","16","56",
"30 s","Art and Entertainment","2012 ","107","18","89",
"30 s","Art and Entertainment","2013 ","101","23","78",
"30 s","Art and Entertainment","2014 ","86","18","68",
"30 s","Art and Entertainment","2015 ","71","16","55",
"30 s","Art and Entertainment","2016 ","62","21","41",
"30 s","Art and Entertainment","2017 ","43","21","22",
"30 s","Art and Entertainment","2018 ","55","20","35",
"30 s","Art and Entertainment","2019 ","52","22","30",
"30 s","Unskilled Employment","2000 ","0","0","0",
"30 s","Unskilled Employment","2001 ","0","0","0",
"30 s","Unskilled Employment","2002 ","0","0","0",
"30 s","Unskilled Employment","2003 ","92","72","20",
"30 s","Unskilled Employment","2004 ","346","289","57",
"30 s","Unskilled Employment","2005 ","1570","1296","274",
"30 s","Unskilled Employment","2006 ","1663","1383","280",
"30 s","Unskilled Employment","2007 ","1390","1270","120",
"30 s","Unskilled Employment","2008 ","2131","1921","210",
"30 s","Unskilled Employment","2009 ","1281","1179","102",
"30 s","Unskilled Employment","2010 ","1779","1644","135",
"30 s","Unskilled Employment","2011 ","2391","2186","205",
"30 s","Unskilled Employment","2012 ","2838","2615","223",
"30 s","Unskilled Employment","2013 ","3543","3285","258",
"30 s","Unskilled Employment","2014 ","2863","2698","165",
"30 s","Unskilled Employment","2015 ","2739","2557","182",
"30 s","Unskilled Employment","2016 ","3418","3129","289",
"30 s","Unskilled Employment","2017 ","2822","2596","226",
"30 s","Unskilled Employment","2018 ","3036","2825","211",
"30 s","Unskilled Employment","2019 ","3176","3001","175",
"30 s","Visiting and Joining Family","2000 ","221","20","201",
"30 s","Visiting and Joining Family","2001 ","349","33","316",
"30 s","Visiting and Joining Family","2002 ","209","18","191",
"30 s","Visiting and Joining Family","2003 ","141","55","86",
"30 s","Visiting and Joining Family","2004 ","317","181","136",
"30 s","Visiting and Joining Family","2005 ","841","502","339",
"30 s","Visiting and Joining Family","2006 ","1599","993","606",
"30 s","Visiting and Joining Family","2007 ","279","151","128",
"30 s","Visiting and Joining Family","2008 ","30","12","18",
"30 s","Visiting and Joining Family","2009 ","38","13","25",
"30 s","Visiting and Joining Family","2010 ","96","48","48",
"30 s","Visiting and Joining Family","2011 ","75","29","46",
"30 s","Visiting and Joining Family","2012 ","49","24","25",
"30 s","Visiting and Joining Family","2013 ","47","23","24",
"30 s","Visiting and Joining Family","2014 ","71","20","51",
"30 s","Visiting and Joining Family","2015 ","119","30","89",
"30 s","Visiting and Joining Family","2016 ","313","74","239",
"30 s","Visiting and Joining Family","2017 ","298","86","212",
"30 s","Visiting and Joining Family","2018 ","250","67","183",
"30 s","Visiting and Joining Family","2019 ","259","84","175",
"30 s","Overseas Koreans","2000 ","34","21","13",
"30 s","Overseas Koreans","2001 ","36","17","19",
"30 s","Overseas Koreans","2002 ","52","31","21",
"30 s","Overseas Koreans","2003 ","54","33","21",
"30 s","Overseas Koreans","2004 ","64","35","29",
"30 s","Overseas Koreans","2005 ","58","32","26",
"30 s","Overseas Koreans","2006 ","53","32","21",
"30 s","Overseas Koreans","2007 ","52","28","24",
"30 s","Overseas Koreans","2008 ","75","35","40",
"30 s","Overseas Koreans","2009 ","79","44","35",
"30 s","Overseas Koreans","2010 ","244","132","112",
"30 s","Overseas Koreans","2011 ","311","163","148",
"30 s","Overseas Koreans","2012 ","399","209","190",
"30 s","Overseas Koreans","2013 ","466","250","216",
"30 s","Overseas Koreans","2014 ","439","205","234",
"30 s","Overseas Koreans","2015 ","593","319","274",
"30 s","Overseas Koreans","2016 ","856","440","416",
"30 s","Overseas Koreans","2017 ","902","473","429",
"30 s","Overseas Koreans","2018 ","956","491","465",
"30 s","Overseas Koreans","2019 ","926","490","436",
"30 s","Permanent Residence","2000 ","0","0","0",
"30 s","Permanent Residence","2001 ","0","0","0",
"30 s","Permanent Residence","2002 ","0","0","0",
"30 s","Permanent Residence","2003 ","4","4","0",
"30 s","Permanent Residence","2004 ","4","2","2",
"30 s","Permanent Residence","2005 ","2","0","2",
"30 s","Permanent Residence","2006 ","5","1","4",
"30 s","Permanent Residence","2007 ","4","0","4",
"30 s","Permanent Residence","2008 ","15","3","12",
"30 s","Permanent Residence","2009 ","12","0","12",
"30 s","Permanent Residence","2010 ","28","9","19",
"30 s","Permanent Residence","2011 ","65","31","34",
"30 s","Permanent Residence","2012 ","126","57","69",
"30 s","Permanent Residence","2013 ","137","65","72",
"30 s","Permanent Residence","2014 ","122","60","62",
"30 s","Permanent Residence","2015 ","143","63","80",
"30 s","Permanent Residence","2016 ","153","78","75",
"30 s","Permanent Residence","2017 ","134","65","69",
"30 s","Permanent Residence","2018 ","141","69","72",
"30 s","Permanent Residence","2019 ","141","61","80",
"30 s","Marriage Immigration","2011 ","25","2","23",
"30 s","Marriage Immigration","2012 ","610","47","563",
"30 s","Marriage Immigration","2013 ","563","50","513",
"30 s","Marriage Immigration","2014 ","515","55","460",
"30 s","Marriage Immigration","2015 ","444","49","395",
"30 s","Marriage Immigration","2016 ","493","65","428",
"30 s","Marriage Immigration","2017 ","483","60","423",
"30 s","Marriage Immigration","2018 ","523","73","450",
"30 s","Marriage Immigration","2019 ","604","75","529",
"31 s","Total","2000 ","5671","3687","1984",
"31 s","Total","2001 ","5219","3215","2004",
"31 s","Total","2002 ","5167","3293","1874",
"31 s","Total","2003 ","5621","3915","1706",
"31 s","Total","2004 ","5575","3665","1910",
"31 s","Total","2005 ","7247","4985","2262",
"31 s","Total","2006 ","8673","6159","2514",
"31 s","Total","2007 ","6831","4348","2483",
"31 s","Total","2008 ","6979","4412","2567",
"31 s","Total","2009 ","5437","3330","2107",
"31 s","Total","2010 ","7090","4458","2632",
"31 s","Total","2011 ","7883","5099","2784",
"31 s","Total","2012 ","7607","5060","2547",
"31 s","Total","2013 ","9824","6460","3364",
"31 s","Total","2014 ","10220","6504","3716",
"31 s","Total","2015 ","9260","5868","3392",
"31 s","Total","2016 ","10599","6705","3894",
"31 s","Total","2017 ","12862","7911","4951",
"31 s","Total","2018 ","13918","8442","5476",
"31 s","Total","2019 ","12414","7578","4836",
"31 s","Sightseeing Pass","2000 ","387","246","141",
"31 s","Sightseeing Pass","2001 ","535","363","172",
"31 s","Sightseeing Pass","2002 ","565","379","186",
"31 s","Sightseeing Pass","2003 ","349","221","128",
"31 s","Sightseeing Pass","2004 ","335","207","128",
"31 s","Sightseeing Pass","2005 ","349","190","159",
"31 s","Sightseeing Pass","2006 ","287","163","124",
"31 s","Sightseeing Pass","2007 ","294","157","137",
"31 s","Sightseeing Pass","2008 ","332","192","140",
"31 s","Sightseeing Pass","2009 ","353","168","185",
"31 s","Sightseeing Pass","2010 ","513","298","215",
"31 s","Sightseeing Pass","2011 ","458","262","196",
"31 s","Sightseeing Pass","2012 ","370","188","182",
"31 s","Sightseeing Pass","2013 ","325","172","153",
"31 s","Sightseeing Pass","2014 ","411","222","189",
"31 s","Sightseeing Pass","2015 ","554","304","250",
"31 s","Sightseeing Pass","2016 ","531","315","216",
"31 s","Sightseeing Pass","2017 ","634","400","234",
"31 s","Sightseeing Pass","2018 ","966","628","338",
"31 s","Sightseeing Pass","2019 ","566","316","250",
"31 s","Short-term Business","2000 ","785","495","290",
"31 s","Short-term Business","2001 ","1030","622","408",
"31 s","Short-term Business","2002 ","517","347","170",
"31 s","Short-term Business","2003 ","335","256","79",
"31 s","Short-term Business","2004 ","306","212","94",
"31 s","Short-term Business","2005 ","255","186","69",
"31 s","Short-term Business","2006 ","466","344","122",
"31 s","Short-term Business","2007 ","627","457","170",
"31 s","Short-term Business","2008 ","338","257","81",
"31 s","Short-term Business","2009 ","123","105","18",
"31 s","Short-term Business","2010 ","123","107","16",
"31 s","Short-term Business","2011 ","117","107","10",
"31 s","Short-term Visitors","2000 ","1283","775","508",
"31 s","Short-term Visitors","2001 ","1105","663","442",
"31 s","Short-term Visitors","2002 ","1198","732","466",
"31 s","Short-term Visitors","2003 ","726","421","305",
"31 s","Short-term Visitors","2004 ","672","433","239",
"31 s","Short-term Visitors","2005 ","589","338","251",
"31 s","Short-term Visitors","2006 ","743","439","304",
"31 s","Short-term Visitors","2007 ","667","363","304",
"31 s","Short-term Visitors","2008 ","456","212","244",
"31 s","Short-term Visitors","2009 ","255","105","150",
"31 s","Short-term Visitors","2010 ","759","420","339",
"31 s","Short-term Visitors","2011 ","1181","662","519",
"31 s","Short-term Visitors","2012 ","1075","659","416",
"31 s","Short-term Visitors","2013 ","1567","975","592",
"31 s","Short-term Visitors","2014 ","913","537","376",
"31 s","Short-term Visitors","2015 ","1277","705","572",
"31 s","Short-term Visitors","2016 ","1313","777","536",
"31 s","Short-term Visitors","2017 ","1649","1014","635",
"31 s","Short-term Visitors","2018 ","1630","1019","611",
"31 s","Short-term Visitors","2019 ","1796","1198","598",
"31 s","Short-term Employment","2000 ","9","9","0",
"31 s","Short-term Employment","2001 ","7","6","1",
"31 s","Short-term Employment","2002 ","11","9","2",
"31 s","Short-term Employment","2003 ","9","7","2",
"31 s","Short-term Employment","2004 ","10","10","0",
"31 s","Short-term Employment","2005 ","15","10","5",
"31 s","Short-term Employment","2006 ","7","7","0",
"31 s","Short-term Employment","2007 ","19","14","5",
"31 s","Short-term Employment","2008 ","7","6","1",
"31 s","Short-term Employment","2009 ","4","4","0",
"31 s","Short-term Employment","2010 ","12","11","1",
"31 s","Short-term Employment","2011 ","6","6","",
"31 s","Short-term Employment","2012 ","4","2","2",
"31 s","Short-term Employment","2013 ","2","1","1",
"31 s","Short-term Employment","2014 ","2","2","0",
"31 s","Short-term Employment","2015 ","3","3","0",
"31 s","Short-term Employment","2016 ","13","12","1",
"31 s","Short-term Employment","2017 ","17","8","9",
"31 s","Short-term Employment","2018 ","14","11","3",
"31 s","Short-term Employment","2019 ","20","17","3",
"31 s","Job Seeking","2000 ","0","0","0",
"31 s","Job Seeking","2001 ","0","0","0",
"31 s","Job Seeking","2002 ","0","0","0",
"31 s","Job Seeking","2003 ","0","0","0",
"31 s","Job Seeking","2004 ","0","0","0",
"31 s","Job Seeking","2005 ","0","0","0",
"31 s","Job Seeking","2006 ","0","0","0",
"31 s","Job Seeking","2007 ","0","0","0",
"31 s","Job Seeking","2008 ","0","0","0",
"31 s","Job Seeking","2009 ","0","0","0",
"31 s","Job Seeking","2010 ","0","0","0",
"31 s","Job Seeking","2012 ","2","","2",
"31 s","Job Seeking","2013 ","9","5","4",
"31 s","Job Seeking","2014 ","6","3","3",
"31 s","Job Seeking","2015 ","6","3","3",
"31 s","Job Seeking","2016 ","9","3","6",
"31 s","Job Seeking","2017 ","10","4","6",
"31 s","Job Seeking","2018 ","8","3","5",
"31 s","Job Seeking","2019 ","14","7","7",
"31 s","study","2000 ","38","22","16",
"31 s","study","2001 ","53","31","22",
"31 s","study","2002 ","42","24","18",
"31 s","study","2003 ","64","42","22",
"31 s","study","2004 ","72","49","23",
"31 s","study","2005 ","56","36","20",
"31 s","study","2006 ","82","58","24",
"31 s","study","2007 ","83","55","28",
"31 s","study","2008 ","113","74","39",
"31 s","study","2009 ","99","67","32",
"31 s","study","2010 ","132","85","47",
"31 s","study","2011 ","122","80","42",
"31 s","study","2012 ","113","77","36",
"31 s","study","2013 ","142","91","51",
"31 s","study","2014 ","181","118","63",
"31 s","study","2015 ","157","102","55",
"31 s","study","2016 ","204","128","76",
"31 s","study","2017 ","226","137","89",
"31 s","study","2018 ","318","173","145",
"31 s","study","2019 ","352","199","153",
"31 s","General Trainees","2000 ","24","19","5",
"31 s","General Trainees","2001 ","20","12","8",
"31 s","General Trainees","2002 ","28","14","14",
"31 s","General Trainees","2003 ","30","17","13",
"31 s","General Trainees","2004 ","33","13","20",
"31 s","General Trainees","2005 ","31","18","13",
"31 s","General Trainees","2006 ","46","22","24",
"31 s","General Trainees","2007 ","42","23","19",
"31 s","General Trainees","2008 ","60","28","32",
"31 s","General Trainees","2009 ","59","26","33",
"31 s","General Trainees","2010 ","69","37","32",
"31 s","General Trainees","2011 ","101","48","53",
"31 s","General Trainees","2012 ","116","61","55",
"31 s","General Trainees","2013 ","103","49","54",
"31 s","General Trainees","2014 ","103","54","49",
"31 s","General Trainees","2015 ","138","72","66",
"31 s","General Trainees","2016 ","140","73","67",
"31 s","General Trainees","2017 ","149","73","76",
"31 s","General Trainees","2018 ","114","50","64",
"31 s","General Trainees","2019 ","136","69","67",
"31 s","Religious Activities","2000 ","4","1","3",
"31 s","Religious Activities","2001 ","12","5","7",
"31 s","Religious Activities","2002 ","5","2","3",
"31 s","Religious Activities","2003 ","5","2","3",
"31 s","Religious Activities","2004 ","6","4","2",
"31 s","Religious Activities","2005 ","22","13","9",
"31 s","Religious Activities","2006 ","10","5","5",
"31 s","Religious Activities","2007 ","12","4","8",
"31 s","Religious Activities","2008 ","13","9","4",
"31 s","Religious Activities","2009 ","8","6","2",
"31 s","Religious Activities","2010 ","16","8","8",
"31 s","Religious Activities","2011 ","12","8","4",
"31 s","Religious Activities","2012 ","14","6","8",
"31 s","Religious Activities","2013 ","9","4","5",
"31 s","Religious Activities","2014 ","12","4","8",
"31 s","Religious Activities","2015 ","5","2","3",
"31 s","Religious Activities","2016 ","6","3","3",
"31 s","Religious Activities","2017 ","10","8","2",
"31 s","Religious Activities","2018 ","11","5","6",
"31 s","Religious Activities","2019 ","10","6","4",
"31 s","Investors","2000 ","77","54","23",
"31 s","Investors","2001 ","63","53","10",
"31 s","Investors","2002 ","45","41","4",
"31 s","Investors","2003 ","27","22","5",
"31 s","Investors","2004 ","36","33","3",
"31 s","Investors","2005 ","41","35","6",
"31 s","Investors","2006 ","36","34","2",
"31 s","Investors","2007 ","40","35","5",
"31 s","Investors","2008 ","36","31","5",
"31 s","Investors","2009 ","23","22","1",
"31 s","Investors","2010 ","34","29","5",
"31 s","Investors","2011 ","26","25","1",
"31 s","Investors","2012 ","28","24","4",
"31 s","Investors","2013 ","27","25","2",
"31 s","Investors","2014 ","26","25","1",
"31 s","Investors","2015 ","26","22","4",
"31 s","Investors","2016 ","30","27","3",
"31 s","Investors","2017 ","16","15","1",
"31 s","Investors","2018 ","14","11","3",
"31 s","Investors","2019 ","27","22","5",
"31 s","Trade and Business","2000 ","8","8","0",
"31 s","Trade and Business","2001 ","18","16","2",
"31 s","Trade and Business","2002 ","14","14","0",
"31 s","Trade and Business","2003 ","16","14","2",
"31 s","Trade and Business","2004 ","17","17","0",
"31 s","Trade and Business","2005 ","17","16","1",
"31 s","Trade and Business","2006 ","22","22","0",
"31 s","Trade and Business","2007 ","18","17","1",
"31 s","Trade and Business","2008 ","24","24","0",
"31 s","Trade and Business","2009 ","28","28","0",
"31 s","Trade and Business","2010 ","35","35","0",
"31 s","Trade and Business","2011 ","24","22","2",
"31 s","Trade and Business","2012 ","37","34","3",
"31 s","Trade and Business","2013 ","52","45","7",
"31 s","Trade and Business","2014 ","58","55","3",
"31 s","Trade and Business","2015 ","51","45","6",
"31 s","Trade and Business","2016 ","31","27","4",
"31 s","Trade and Business","2017 ","18","17","1",
"31 s","Trade and Business","2018 ","18","17","1",
"31 s","Trade and Business","2019 ","24","20","4",
"31 s","Research","2000 ","20","19","1",
"31 s","Research","2001 ","32","24","8",
"31 s","Research","2002 ","35","33","2",
"31 s","Research","2003 ","33","28","5",
"31 s","Research","2004 ","24","22","2",
"31 s","Research","2005 ","27","22","5",
"31 s","Research","2006 ","51","47","4",
"31 s","Research","2007 ","56","52","4",
"31 s","Research","2008 ","56","44","12",
"31 s","Research","2009 ","51","40","11",
"31 s","Research","2010 ","60","49","11",
"31 s","Research","2011 ","68","61","7",
"31 s","Research","2012 ","68","63","5",
"31 s","Research","2013 ","76","71","5",
"31 s","Research","2014 ","81","72","9",
"31 s","Research","2015 ","61","49","12",
"31 s","Research","2016 ","77","71","6",
"31 s","Research","2017 ","78","67","11",
"31 s","Research","2018 ","71","68","3",
"31 s","Research","2019 ","57","52","5",
"31 s","Art and Entertainment","2000 ","60","22","38",
"31 s","Art and Entertainment","2001 ","92","20","72",
"31 s","Art and Entertainment","2002 ","84","40","44",
"31 s","Art and Entertainment","2003 ","60","20","40",
"31 s","Art and Entertainment","2004 ","58","21","37",
"31 s","Art and Entertainment","2005 ","75","29","46",
"31 s","Art and Entertainment","2006 ","69","28","41",
"31 s","Art and Entertainment","2007 ","83","25","58",
"31 s","Art and Entertainment","2008 ","104","29","75",
"31 s","Art and Entertainment","2009 ","102","19","83",
"31 s","Art and Entertainment","2010 ","92","31","61",
"31 s","Art and Entertainment","2011 ","52","18","34",
"31 s","Art and Entertainment","2012 ","70","19","51",
"31 s","Art and Entertainment","2013 ","75","13","62",
"31 s","Art and Entertainment","2014 ","93","22","71",
"31 s","Art and Entertainment","2015 ","72","20","52",
"31 s","Art and Entertainment","2016 ","44","11","33",
"31 s","Art and Entertainment","2017 ","43","22","21",
"31 s","Art and Entertainment","2018 ","37","16","21",
"31 s","Art and Entertainment","2019 ","54","14","40",
"31 s","Unskilled Employment","2000 ","0","0","0",
"31 s","Unskilled Employment","2001 ","0","0","0",
"31 s","Unskilled Employment","2002 ","0","0","0",
"31 s","Unskilled Employment","2003 ","100","78","22",
"31 s","Unskilled Employment","2004 ","351","269","82",
"31 s","Unskilled Employment","2005 ","1476","1232","244",
"31 s","Unskilled Employment","2006 ","1541","1341","200",
"31 s","Unskilled Employment","2007 ","1385","1249","136",
"31 s","Unskilled Employment","2008 ","2000","1786","214",
"31 s","Unskilled Employment","2009 ","1120","1020","100",
"31 s","Unskilled Employment","2010 ","1614","1498","116",
"31 s","Unskilled Employment","2011 ","2246","2043","203",
"31 s","Unskilled Employment","2012 ","2528","2346","182",
"31 s","Unskilled Employment","2013 ","3162","2932","230",
"31 s","Unskilled Employment","2014 ","2464","2336","128",
"31 s","Unskilled Employment","2015 ","2544","2378","166",
"31 s","Unskilled Employment","2016 ","2861","2664","197",
"31 s","Unskilled Employment","2017 ","2543","2377","166",
"31 s","Unskilled Employment","2018 ","2577","2441","136",
"31 s","Unskilled Employment","2019 ","2727","2572","155",
"31 s","Visiting and Joining Family","2000 ","199","20","179",
"31 s","Visiting and Joining Family","2001 ","328","22","306",
"31 s","Visiting and Joining Family","2002 ","227","22","205",
"31 s","Visiting and Joining Family","2003 ","164","75","89",
"31 s","Visiting and Joining Family","2004 ","332","193","139",
"31 s","Visiting and Joining Family","2005 ","945","546","399",
"31 s","Visiting and Joining Family","2006 ","1601","915","686",
"31 s","Visiting and Joining Family","2007 ","262","146","116",
"31 s","Visiting and Joining Family","2008 ","22","2","20",
"31 s","Visiting and Joining Family","2009 ","35","13","22",
"31 s","Visiting and Joining Family","2010 ","96","44","52",
"31 s","Visiting and Joining Family","2011 ","69","37","32",
"31 s","Visiting and Joining Family","2012 ","37","14","23",
"31 s","Visiting and Joining Family","2013 ","36","15","21",
"31 s","Visiting and Joining Family","2014 ","70","16","54",
"31 s","Visiting and Joining Family","2015 ","117","22","95",
"31 s","Visiting and Joining Family","2016 ","281","75","206",
"31 s","Visiting and Joining Family","2017 ","255","84","171",
"31 s","Visiting and Joining Family","2018 ","289","91","198",
"31 s","Visiting and Joining Family","2019 ","313","80","233",
"31 s","Overseas Koreans","2000 ","35","24","11",
"31 s","Overseas Koreans","2001 ","45","28","17",
"31 s","Overseas Koreans","2002 ","61","37","24",
"31 s","Overseas Koreans","2003 ","62","37","25",
"31 s","Overseas Koreans","2004 ","53","27","26",
"31 s","Overseas Koreans","2005 ","55","33","22",
"31 s","Overseas Koreans","2006 ","62","40","22",
"31 s","Overseas Koreans","2007 ","56","29","27",
"31 s","Overseas Koreans","2008 ","71","37","34",
"31 s","Overseas Koreans","2009 ","72","43","29",
"31 s","Overseas Koreans","2010 ","203","101","102",
"31 s","Overseas Koreans","2011 ","313","170","143",
"31 s","Overseas Koreans","2012 ","310","165","145",
"31 s","Overseas Koreans","2013 ","391","194","197",
"31 s","Overseas Koreans","2014 ","448","211","237",
"31 s","Overseas Koreans","2015 ","527","269","258",
"31 s","Overseas Koreans","2016 ","792","448","344",
"31 s","Overseas Koreans","2017 ","782","406","376",
"31 s","Overseas Koreans","2018 ","920","477","443",
"31 s","Overseas Koreans","2019 ","910","474","436",
"31 s","Permanent Residence","2000 ","0","0","0",
"31 s","Permanent Residence","2001 ","0","0","0",
"31 s","Permanent Residence","2002 ","1","0","1",
"31 s","Permanent Residence","2003 ","3","1","2",
"31 s","Permanent Residence","2004 ","4","3","1",
"31 s","Permanent Residence","2005 ","6","2","4",
"31 s","Permanent Residence","2006 ","5","5","0",
"31 s","Permanent Residence","2007 ","5","3","2",
"31 s","Permanent Residence","2008 ","10","1","9",
"31 s","Permanent Residence","2009 ","11","2","9",
"31 s","Permanent Residence","2010 ","39","16","23",
"31 s","Permanent Residence","2011 ","74","37","37",
"31 s","Permanent Residence","2012 ","74","32","42",
"31 s","Permanent Residence","2013 ","132","75","57",
"31 s","Permanent Residence","2014 ","173","89","84",
"31 s","Permanent Residence","2015 ","145","67","78",
"31 s","Permanent Residence","2016 ","125","53","72",
"31 s","Permanent Residence","2017 ","160","66","94",
"31 s","Permanent Residence","2018 ","176","76","100",
"31 s","Permanent Residence","2019 ","150","67","83",
"31 s","Marriage Immigration","2011 ","24","1","23",
"31 s","Marriage Immigration","2012 ","467","44","423",
"31 s","Marriage Immigration","2013 ","550","58","492",
"31 s","Marriage Immigration","2014 ","472","54","418",
"31 s","Marriage Immigration","2015 ","419","58","361",
"31 s","Marriage Immigration","2016 ","471","58","413",
"31 s","Marriage Immigration","2017 ","473","72","401",
"31 s","Marriage Immigration","2018 ","495","76","419",
"31 s","Marriage Immigration","2019 ","564","73","491",
"32 s","Total","2000 ","5058","3272","1786",
"32 s","Total","2001 ","4953","3094","1859",
"32 s","Total","2002 ","4731","3091","1640",
"32 s","Total","2003 ","5581","3914","1667",
"32 s","Total","2004 ","5437","3621","1816",
"32 s","Total","2005 ","7268","5048","2220",
"32 s","Total","2006 ","8898","6382","2516",
"32 s","Total","2007 ","6683","4293","2390",
"32 s","Total","2008 ","6673","4275","2398",
"32 s","Total","2009 ","4976","3042","1934",
"32 s","Total","2010 ","6155","3976","2179",
"32 s","Total","2011 ","7192","4717","2475",
"32 s","Total","2012 ","7421","4890","2531",
"32 s","Total","2013 ","8503","5769","2734",
"32 s","Total","2014 ","9542","6101","3441",
"32 s","Total","2015 ","8859","5612","3247",
"32 s","Total","2016 ","9710","6264","3446",
"32 s","Total","2017 ","11932","7384","4548",
"32 s","Total","2018 ","12985","7880","5105",
"32 s","Total","2019 ","11621","7058","4563",
"32 s","Sightseeing Pass","2000 ","367","236","131",
"32 s","Sightseeing Pass","2001 ","474","320","154",
"32 s","Sightseeing Pass","2002 ","529","366","163",
"32 s","Sightseeing Pass","2003 ","346","214","132",
"32 s","Sightseeing Pass","2004 ","356","228","128",
"32 s","Sightseeing Pass","2005 ","336","212","124",
"32 s","Sightseeing Pass","2006 ","295","160","135",
"32 s","Sightseeing Pass","2007 ","320","191","129",
"32 s","Sightseeing Pass","2008 ","315","185","130",
"32 s","Sightseeing Pass","2009 ","339","188","151",
"32 s","Sightseeing Pass","2010 ","470","258","212",
"32 s","Sightseeing Pass","2011 ","386","206","180",
"32 s","Sightseeing Pass","2012 ","384","202","182",
"32 s","Sightseeing Pass","2013 ","316","155","161",
"32 s","Sightseeing Pass","2014 ","398","205","193",
"32 s","Sightseeing Pass","2015 ","565","332","233",
"32 s","Sightseeing Pass","2016 ","444","258","186",
"32 s","Sightseeing Pass","2017 ","589","374","215",
"32 s","Sightseeing Pass","2018 ","889","591","298",
"32 s","Sightseeing Pass","2019 ","580","288","292",
"32 s","Short-term Business","2000 ","771","476","295",
"32 s","Short-term Business","2001 ","1017","607","410",
"32 s","Short-term Business","2002 ","516","356","160",
"32 s","Short-term Business","2003 ","330","242","88",
"32 s","Short-term Business","2004 ","347","255","92",
"32 s","Short-term Business","2005 ","245","172","73",
"32 s","Short-term Business","2006 ","491","366","125",
"32 s","Short-term Business","2007 ","731","536","195",
"32 s","Short-term Business","2008 ","361","290","71",
"32 s","Short-term Business","2009 ","116","95","21",
"32 s","Short-term Business","2010 ","98","87","11",
"32 s","Short-term Business","2011 ","97","89","8",
"32 s","Short-term Visitors","2000 ","1141","704","437",
"32 s","Short-term Visitors","2001 ","1099","643","456",
"32 s","Short-term Visitors","2002 ","1143","718","425",
"32 s","Short-term Visitors","2003 ","736","450","286",
"32 s","Short-term Visitors","2004 ","670","421","249",
"32 s","Short-term Visitors","2005 ","578","339","239",
"32 s","Short-term Visitors","2006 ","745","452","293",
"32 s","Short-term Visitors","2007 ","620","334","286",
"32 s","Short-term Visitors","2008 ","496","248","248",
"32 s","Short-term Visitors","2009 ","237","99","138",
"32 s","Short-term Visitors","2010 ","679","385","294",
"32 s","Short-term Visitors","2011 ","1115","661","454",
"32 s","Short-term Visitors","2012 ","1144","701","443",
"32 s","Short-term Visitors","2013 ","1229","757","472",
"32 s","Short-term Visitors","2014 ","929","552","377",
"32 s","Short-term Visitors","2015 ","1266","719","547",
"32 s","Short-term Visitors","2016 ","1194","726","468",
"32 s","Short-term Visitors","2017 ","1507","964","543",
"32 s","Short-term Visitors","2018 ","1504","949","555",
"32 s","Short-term Visitors","2019 ","1735","1140","595",
"32 s","Short-term Employment","2000 ","7","7","0",
"32 s","Short-term Employment","2001 ","6","3","3",
"32 s","Short-term Employment","2002 ","11","3","8",
"32 s","Short-term Employment","2003 ","5","5","0",
"32 s","Short-term Employment","2004 ","9","8","1",
"32 s","Short-term Employment","2005 ","11","7","4",
"32 s","Short-term Employment","2006 ","7","3","4",
"32 s","Short-term Employment","2007 ","20","15","5",
"32 s","Short-term Employment","2008 ","5","4","1",
"32 s","Short-term Employment","2009 ","2","2","0",
"32 s","Short-term Employment","2010 ","6","2","4",
"32 s","Short-term Employment","2011 ","3","2","1",
"32 s","Short-term Employment","2012 ","6","4","2",
"32 s","Short-term Employment","2013 ","2","2","0",
"32 s","Short-term Employment","2014 ","4","4","0",
"32 s","Short-term Employment","2015 ","2","2","0",
"32 s","Short-term Employment","2016 ","11","11","0",
"32 s","Short-term Employment","2017 ","11","8","3",
"32 s","Short-term Employment","2018 ","17","14","3",
"32 s","Short-term Employment","2019 ","9","7","2",
"32 s","Job Seeking","2000 ","0","0","0",
"32 s","Job Seeking","2001 ","0","0","0",
"32 s","Job Seeking","2002 ","0","0","0",
"32 s","Job Seeking","2003 ","0","0","0",
"32 s","Job Seeking","2004 ","0","0","0",
"32 s","Job Seeking","2005 ","0","0","0",
"32 s","Job Seeking","2006 ","0","0","0",
"32 s","Job Seeking","2007 ","0","0","0",
"32 s","Job Seeking","2008 ","0","0","0",
"32 s","Job Seeking","2009 ","0","0","0",
"32 s","Job Seeking","2010 ","0","0","0",
"32 s","Job Seeking","2013 ","5","3","2",
"32 s","Job Seeking","2014 ","7","5","2",
"32 s","Job Seeking","2015 ","9","4","5",
"32 s","Job Seeking","2016 ","4","1","3",
"32 s","Job Seeking","2017 ","8","3","5",
"32 s","Job Seeking","2018 ","11","5","6",
"32 s","Job Seeking","2019 ","13","8","5",
"32 s","study","2000 ","31","18","13",
"32 s","study","2001 ","34","25","9",
"32 s","study","2002 ","29","24","5",
"32 s","study","2003 ","56","39","17",
"32 s","study","2004 ","54","37","17",
"32 s","study","2005 ","65","36","29",
"32 s","study","2006 ","66","47","19",
"32 s","study","2007 ","75","46","29",
"32 s","study","2008 ","79","47","32",
"32 s","study","2009 ","77","47","30",
"32 s","study","2010 ","85","56","29",
"32 s","study","2011 ","97","74","23",
"32 s","study","2012 ","111","75","36",
"32 s","study","2013 ","123","84","39",
"32 s","study","2014 ","128","83","45",
"32 s","study","2015 ","144","91","53",
"32 s","study","2016 ","176","108","68",
"32 s","study","2017 ","198","129","69",
"32 s","study","2018 ","257","161","96",
"32 s","study","2019 ","293","173","120",
"32 s","General Trainees","2000 ","22","9","13",
"32 s","General Trainees","2001 ","17","12","5",
"32 s","General Trainees","2002 ","24","14","10",
"32 s","General Trainees","2003 ","19","12","7",
"32 s","General Trainees","2004 ","43","15","28",
"32 s","General Trainees","2005 ","52","32","20",
"32 s","General Trainees","2006 ","39","25","14",
"32 s","General Trainees","2007 ","41","17","24",
"32 s","General Trainees","2008 ","51","24","27",
"32 s","General Trainees","2009 ","40","23","17",
"32 s","General Trainees","2010 ","59","26","33",
"32 s","General Trainees","2011 ","89","49","40",
"32 s","General Trainees","2012 ","82","39","43",
"32 s","General Trainees","2013 ","91","46","45",
"32 s","General Trainees","2014 ","113","62","51",
"32 s","General Trainees","2015 ","127","68","59",
"32 s","General Trainees","2016 ","123","65","58",
"32 s","General Trainees","2017 ","123","54","69",
"32 s","General Trainees","2018 ","113","63","50",
"32 s","General Trainees","2019 ","116","58","58",
"32 s","Religious Activities","2000 ","4","3","1",
"32 s","Religious Activities","2001 ","7","6","1",
"32 s","Religious Activities","2002 ","9","5","4",
"32 s","Religious Activities","2003 ","7","4","3",
"32 s","Religious Activities","2004 ","12","9","3",
"32 s","Religious Activities","2005 ","11","4","7",
"32 s","Religious Activities","2006 ","8","4","4",
"32 s","Religious Activities","2007 ","17","10","7",
"32 s","Religious Activities","2008 ","8","4","4",
"32 s","Religious Activities","2009 ","12","5","7",
"32 s","Religious Activities","2010 ","4","3","1",
"32 s","Religious Activities","2011 ","14","9","5",
"32 s","Religious Activities","2012 ","7","2","5",
"32 s","Religious Activities","2013 ","4","2","2",
"32 s","Religious Activities","2014 ","8","3","5",
"32 s","Religious Activities","2015 ","9","5","4",
"32 s","Religious Activities","2016 ","6","4","2",
"32 s","Religious Activities","2017 ","7","4","3",
"32 s","Religious Activities","2018 ","9","4","5",
"32 s","Religious Activities","2019 ","5","3","2",
"32 s","Investors","2000 ","68","44","24",
"32 s","Investors","2001 ","75","62","13",
"32 s","Investors","2002 ","37","35","2",
"32 s","Investors","2003 ","35","31","4",
"32 s","Investors","2004 ","43","38","5",
"32 s","Investors","2005 ","52","38","14",
"32 s","Investors","2006 ","28","24","4",
"32 s","Investors","2007 ","35","32","3",
"32 s","Investors","2008 ","39","36","3",
"32 s","Investors","2009 ","36","34","2",
"32 s","Investors","2010 ","29","26","3",
"32 s","Investors","2011 ","31","30","1",
"32 s","Investors","2012 ","27","24","3",
"32 s","Investors","2013 ","41","35","6",
"32 s","Investors","2014 ","17","15","2",
"32 s","Investors","2015 ","20","20","0",
"32 s","Investors","2016 ","24","22","2",
"32 s","Investors","2017 ","16","15","1",
"32 s","Investors","2018 ","20","17","3",
"32 s","Investors","2019 ","23","20","3",
"32 s","Trade and Business","2000 ","19","19","0",
"32 s","Trade and Business","2001 ","9","9","0",
"32 s","Trade and Business","2002 ","7","7","0",
"32 s","Trade and Business","2003 ","10","9","1",
"32 s","Trade and Business","2004 ","10","9","1",
"32 s","Trade and Business","2005 ","26","26","0",
"32 s","Trade and Business","2006 ","16","14","2",
"32 s","Trade and Business","2007 ","13","13","0",
"32 s","Trade and Business","2008 ","18","18","0",
"32 s","Trade and Business","2009 ","22","22","0",
"32 s","Trade and Business","2010 ","29","29","0",
"32 s","Trade and Business","2011 ","40","39","1",
"32 s","Trade and Business","2012 ","35","33","2",
"32 s","Trade and Business","2013 ","61","57","4",
"32 s","Trade and Business","2014 ","54","50","4",
"32 s","Trade and Business","2015 ","59","54","5",
"32 s","Trade and Business","2016 ","31","29","2",
"32 s","Trade and Business","2017 ","35","33","2",
"32 s","Trade and Business","2018 ","12","10","2",
"32 s","Trade and Business","2019 ","20","18","2",
"32 s","Research","2000 ","16","14","2",
"32 s","Research","2001 ","25","21","4",
"32 s","Research","2002 ","12","11","1",
"32 s","Research","2003 ","28","24","4",
"32 s","Research","2004 ","28","27","1",
"32 s","Research","2005 ","39","33","6",
"32 s","Research","2006 ","44","38","6",
"32 s","Research","2007 ","42","38","4",
"32 s","Research","2008 ","39","33","6",
"32 s","Research","2009 ","44","38","6",
"32 s","Research","2010 ","40","36","4",
"32 s","Research","2011 ","59","50","9",
"32 s","Research","2012 ","68","56","12",
"32 s","Research","2013 ","72","65","7",
"32 s","Research","2014 ","53","52","1",
"32 s","Research","2015 ","41","36","5",
"32 s","Research","2016 ","73","66","7",
"32 s","Research","2017 ","68","59","9",
"32 s","Research","2018 ","67","53","14",
"32 s","Research","2019 ","65","53","12",
"32 s","Art and Entertainment","2000 ","60","23","37",
"32 s","Art and Entertainment","2001 ","48","28","20",
"32 s","Art and Entertainment","2002 ","48","23","25",
"32 s","Art and Entertainment","2003 ","54","22","32",
"32 s","Art and Entertainment","2004 ","70","30","40",
"32 s","Art and Entertainment","2005 ","62","32","30",
"32 s","Art and Entertainment","2006 ","56","27","29",
"32 s","Art and Entertainment","2007 ","70","24","46",
"32 s","Art and Entertainment","2008 ","54","15","39",
"32 s","Art and Entertainment","2009 ","65","16","49",
"32 s","Art and Entertainment","2010 ","71","21","50",
"32 s","Art and Entertainment","2011 ","61","18","43",
"32 s","Art and Entertainment","2012 ","84","24","60",
"32 s","Art and Entertainment","2013 ","55","17","38",
"32 s","Art and Entertainment","2014 ","70","16","54",
"32 s","Art and Entertainment","2015 ","77","19","58",
"32 s","Art and Entertainment","2016 ","44","18","26",
"32 s","Art and Entertainment","2017 ","27","9","18",
"32 s","Art and Entertainment","2018 ","43","19","24",
"32 s","Art and Entertainment","2019 ","42","12","30",
"32 s","Unskilled Employment","2000 ","0","0","0",
"32 s","Unskilled Employment","2001 ","0","0","0",
"32 s","Unskilled Employment","2002 ","0","0","0",
"32 s","Unskilled Employment","2003 ","93","73","20",
"32 s","Unskilled Employment","2004 ","306","247","59",
"32 s","Unskilled Employment","2005 ","1428","1197","231",
"32 s","Unskilled Employment","2006 ","1463","1286","177",
"32 s","Unskilled Employment","2007 ","1215","1132","83",
"32 s","Unskilled Employment","2008 ","1808","1613","195",
"32 s","Unskilled Employment","2009 ","1011","921","90",
"32 s","Unskilled Employment","2010 ","1395","1303","92",
"32 s","Unskilled Employment","2011 ","1985","1843","142",
"32 s","Unskilled Employment","2012 ","2260","2078","182",
"32 s","Unskilled Employment","2013 ","2776","2577","199",
"32 s","Unskilled Employment","2014 ","2216","2075","141",
"32 s","Unskilled Employment","2015 ","2257","2109","148",
"32 s","Unskilled Employment","2016 ","2702","2484","218",
"32 s","Unskilled Employment","2017 ","2349","2193","156",
"32 s","Unskilled Employment","2018 ","2315","2179","136",
"32 s","Unskilled Employment","2019 ","2406","2286","120",
"32 s","Visiting and Joining Family","2000 ","189","21","168",
"32 s","Visiting and Joining Family","2001 ","315","20","295",
"32 s","Visiting and Joining Family","2002 ","182","15","167",
"32 s","Visiting and Joining Family","2003 ","166","84","82",
"32 s","Visiting and Joining Family","2004 ","377","221","156",
"32 s","Visiting and Joining Family","2005 ","1092","611","481",
"32 s","Visiting and Joining Family","2006 ","1997","1247","750",
"32 s","Visiting and Joining Family","2007 ","292","155","137",
"32 s","Visiting and Joining Family","2008 ","29","11","18",
"32 s","Visiting and Joining Family","2009 ","39","17","22",
"32 s","Visiting and Joining Family","2010 ","58","31","27",
"32 s","Visiting and Joining Family","2011 ","76","42","34",
"32 s","Visiting and Joining Family","2012 ","33","12","21",
"32 s","Visiting and Joining Family","2013 ","32","11","21",
"32 s","Visiting and Joining Family","2014 ","80","15","65",
"32 s","Visiting and Joining Family","2015 ","108","16","92",
"32 s","Visiting and Joining Family","2016 ","235","69","166",
"32 s","Visiting and Joining Family","2017 ","209","62","147",
"32 s","Visiting and Joining Family","2018 ","258","79","179",
"32 s","Visiting and Joining Family","2019 ","276","69","207",
"32 s","Overseas Koreans","2000 ","29","17","12",
"32 s","Overseas Koreans","2001 ","42","33","9",
"32 s","Overseas Koreans","2002 ","60","39","21",
"32 s","Overseas Koreans","2003 ","69","46","23",
"32 s","Overseas Koreans","2004 ","64","41","23",
"32 s","Overseas Koreans","2005 ","60","36","24",
"32 s","Overseas Koreans","2006 ","59","33","26",
"32 s","Overseas Koreans","2007 ","53","27","26",
"32 s","Overseas Koreans","2008 ","71","27","44",
"32 s","Overseas Koreans","2009 ","86","40","46",
"32 s","Overseas Koreans","2010 ","156","93","63",
"32 s","Overseas Koreans","2011 ","251","126","125",
"32 s","Overseas Koreans","2012 ","295","166","129",
"32 s","Overseas Koreans","2013 ","316","172","144",
"32 s","Overseas Koreans","2014 ","397","189","208",
"32 s","Overseas Koreans","2015 ","578","313","265",
"32 s","Overseas Koreans","2016 ","751","413","338",
"32 s","Overseas Koreans","2017 ","781","415","366",
"32 s","Overseas Koreans","2018 ","782","419","363",
"32 s","Overseas Koreans","2019 ","911","463","448",
"32 s","Permanent Residence","2000 ","0","0","0",
"32 s","Permanent Residence","2001 ","0","0","0",
"32 s","Permanent Residence","2002 ","0","0","0",
"32 s","Permanent Residence","2003 ","5","4","1",
"32 s","Permanent Residence","2004 ","5","3","2",
"32 s","Permanent Residence","2005 ","5","3","2",
"32 s","Permanent Residence","2006 ","0","0","0",
"32 s","Permanent Residence","2007 ","7","2","5",
"32 s","Permanent Residence","2008 ","16","1","15",
"32 s","Permanent Residence","2009 ","8","2","6",
"32 s","Permanent Residence","2010 ","37","11","26",
"32 s","Permanent Residence","2011 ","66","20","46",
"32 s","Permanent Residence","2012 ","78","35","43",
"32 s","Permanent Residence","2013 ","110","50","60",
"32 s","Permanent Residence","2014 ","136","66","70",
"32 s","Permanent Residence","2015 ","133","67","66",
"32 s","Permanent Residence","2016 ","147","63","84",
"32 s","Permanent Residence","2017 ","151","64","87",
"32 s","Permanent Residence","2018 ","141","56","85",
"32 s","Permanent Residence","2019 ","164","70","94",
"32 s","Marriage Immigration","2011 ","22","3","19",
"32 s","Marriage Immigration","2012 ","487","63","424",
"32 s","Marriage Immigration","2013 ","442","65","377",
"32 s","Marriage Immigration","2014 ","404","56","348",
"32 s","Marriage Immigration","2015 ","416","48","368",
"32 s","Marriage Immigration","2016 ","406","67","339",
"32 s","Marriage Immigration","2017 ","397","51","346",
"32 s","Marriage Immigration","2018 ","474","72","402",
"32 s","Marriage Immigration","2019 ","517","116","401",
"33 s","Total","2000 ","4545","2910","1635",
"33 s","Total","2001 ","4434","2768","1666",
"33 s","Total","2002 ","4500","2938","1562",
"33 s","Total","2003 ","5314","3715","1599",
"33 s","Total","2004 ","5633","3802","1831",
"33 s","Total","2005 ","7499","5195","2304",
"33 s","Total","2006 ","9137","6367","2770",
"33 s","Total","2007 ","6652","4336","2316",
"33 s","Total","2008 ","6366","4179","2187",
"33 s","Total","2009 ","4787","2944","1843",
"33 s","Total","2010 ","5658","3700","1958",
"33 s","Total","2011 ","6274","4151","2123",
"33 s","Total","2012 ","6550","4245","2305",
"33 s","Total","2013 ","8117","5503","2614",
"33 s","Total","2014 ","8457","5404","3053",
"33 s","Total","2015 ","8254","5223","3031",
"33 s","Total","2016 ","9126","5797","3329",
"33 s","Total","2017 ","10834","6713","4121",
"33 s","Total","2018 ","11877","7173","4704",
"33 s","Total","2019 ","10680","6429","4251",
"33 s","Sightseeing Pass","2000 ","332","201","131",
"33 s","Sightseeing Pass","2001 ","443","291","152",
"33 s","Sightseeing Pass","2002 ","512","338","174",
"33 s","Sightseeing Pass","2003 ","335","214","121",
"33 s","Sightseeing Pass","2004 ","341","212","129",
"33 s","Sightseeing Pass","2005 ","328","199","129",
"33 s","Sightseeing Pass","2006 ","316","174","142",
"33 s","Sightseeing Pass","2007 ","301","178","123",
"33 s","Sightseeing Pass","2008 ","349","205","144",
"33 s","Sightseeing Pass","2009 ","319","189","130",
"33 s","Sightseeing Pass","2010 ","431","261","170",
"33 s","Sightseeing Pass","2011 ","313","178","135",
"33 s","Sightseeing Pass","2012 ","362","180","182",
"33 s","Sightseeing Pass","2013 ","359","176","183",
"33 s","Sightseeing Pass","2014 ","359","197","162",
"33 s","Sightseeing Pass","2015 ","589","329","260",
"33 s","Sightseeing Pass","2016 ","469","298","171",
"33 s","Sightseeing Pass","2017 ","508","316","192",
"33 s","Sightseeing Pass","2018 ","763","485","278",
"33 s","Sightseeing Pass","2019 ","517","276","241",
"33 s","Short-term Business","2000 ","720","465","255",
"33 s","Short-term Business","2001 ","940","569","371",
"33 s","Short-term Business","2002 ","462","327","135",
"33 s","Short-term Business","2003 ","343","258","85",
"33 s","Short-term Business","2004 ","363","275","88",
"33 s","Short-term Business","2005 ","274","212","62",
"33 s","Short-term Business","2006 ","559","427","132",
"33 s","Short-term Business","2007 ","743","556","187",
"33 s","Short-term Business","2008 ","385","308","77",
"33 s","Short-term Business","2009 ","120","98","22",
"33 s","Short-term Business","2010 ","107","94","13",
"33 s","Short-term Business","2011 ","95","84","11",
"33 s","Short-term Visitors","2000 ","1108","672","436",
"33 s","Short-term Visitors","2001 ","1034","626","408",
"33 s","Short-term Visitors","2002 ","1088","670","418",
"33 s","Short-term Visitors","2003 ","778","475","303",
"33 s","Short-term Visitors","2004 ","660","423","237",
"33 s","Short-term Visitors","2005 ","602","367","235",
"33 s","Short-term Visitors","2006 ","736","438","298",
"33 s","Short-term Visitors","2007 ","610","330","280",
"33 s","Short-term Visitors","2008 ","424","220","204",
"33 s","Short-term Visitors","2009 ","258","119","139",
"33 s","Short-term Visitors","2010 ","671","381","290",
"33 s","Short-term Visitors","2011 ","967","538","429",
"33 s","Short-term Visitors","2012 ","1089","671","418",
"33 s","Short-term Visitors","2013 ","1268","799","469",
"33 s","Short-term Visitors","2014 ","745","434","311",
"33 s","Short-term Visitors","2015 ","1140","641","499",
"33 s","Short-term Visitors","2016 ","1149","696","453",
"33 s","Short-term Visitors","2017 ","1425","890","535",
"33 s","Short-term Visitors","2018 ","1451","935","516",
"33 s","Short-term Visitors","2019 ","1618","1055","563",
"33 s","Short-term Employment","2000 ","7","7","0",
"33 s","Short-term Employment","2001 ","2","0","2",
"33 s","Short-term Employment","2002 ","6","2","4",
"33 s","Short-term Employment","2003 ","8","5","3",
"33 s","Short-term Employment","2004 ","5","5","0",
"33 s","Short-term Employment","2005 ","15","12","3",
"33 s","Short-term Employment","2006 ","9","7","2",
"33 s","Short-term Employment","2007 ","11","5","6",
"33 s","Short-term Employment","2008 ","9","5","4",
"33 s","Short-term Employment","2009 ","5","4","1",
"33 s","Short-term Employment","2010 ","3","2","1",
"33 s","Short-term Employment","2011 ","6","6","",
"33 s","Short-term Employment","2012 ","5","4","1",
"33 s","Short-term Employment","2014 ","1","1","0",
"33 s","Short-term Employment","2015 ","7","6","1",
"33 s","Short-term Employment","2016 ","11","9","2",
"33 s","Short-term Employment","2017 ","12","4","8",
"33 s","Short-term Employment","2018 ","15","7","8",
"33 s","Short-term Employment","2019 ","13","10","3",
"33 s","Job Seeking","2000 ","0","0","0",
"33 s","Job Seeking","2001 ","0","0","0",
"33 s","Job Seeking","2002 ","0","0","0",
"33 s","Job Seeking","2003 ","0","0","0",
"33 s","Job Seeking","2004 ","0","0","0",
"33 s","Job Seeking","2005 ","0","0","0",
"33 s","Job Seeking","2006 ","0","0","0",
"33 s","Job Seeking","2007 ","0","0","0",
"33 s","Job Seeking","2008 ","0","0","0",
"33 s","Job Seeking","2009 ","0","0","0",
"33 s","Job Seeking","2010 ","0","0","0",
"33 s","Job Seeking","2013 ","2","0","2",
"33 s","Job Seeking","2014 ","5","2","3",
"33 s","Job Seeking","2015 ","3","2","1",
"33 s","Job Seeking","2016 ","5","3","2",
"33 s","Job Seeking","2017 ","5","4","1",
"33 s","Job Seeking","2018 ","2","2","0",
"33 s","Job Seeking","2019 ","7","5","2",
"33 s","study","2000 ","19","12","7",
"33 s","study","2001 ","32","24","8",
"33 s","study","2002 ","30","19","11",
"33 s","study","2003 ","31","23","8",
"33 s","study","2004 ","45","33","12",
"33 s","study","2005 ","51","33","18",
"33 s","study","2006 ","65","43","22",
"33 s","study","2007 ","76","52","24",
"33 s","study","2008 ","64","44","20",
"33 s","study","2009 ","58","36","22",
"33 s","study","2010 ","61","43","18",
"33 s","study","2011 ","81","52","29",
"33 s","study","2012 ","76","48","28",
"33 s","study","2013 ","110","77","33",
"33 s","study","2014 ","102","65","37",
"33 s","study","2015 ","122","83","39",
"33 s","study","2016 ","145","86","59",
"33 s","study","2017 ","158","109","49",
"33 s","study","2018 ","198","130","68",
"33 s","study","2019 ","249","145","104",
"33 s","General Trainees","2000 ","12","5","7",
"33 s","General Trainees","2001 ","21","13","8",
"33 s","General Trainees","2002 ","23","14","9",
"33 s","General Trainees","2003 ","12","6","6",
"33 s","General Trainees","2004 ","21","12","9",
"33 s","General Trainees","2005 ","28","14","14",
"33 s","General Trainees","2006 ","27","12","15",
"33 s","General Trainees","2007 ","31","14","17",
"33 s","General Trainees","2008 ","38","19","19",
"33 s","General Trainees","2009 ","45","21","24",
"33 s","General Trainees","2010 ","49","27","22",
"33 s","General Trainees","2011 ","98","42","56",
"33 s","General Trainees","2012 ","76","34","42",
"33 s","General Trainees","2013 ","62","32","30",
"33 s","General Trainees","2014 ","99","54","45",
"33 s","General Trainees","2015 ","108","55","53",
"33 s","General Trainees","2016 ","90","44","46",
"33 s","General Trainees","2017 ","105","46","59",
"33 s","General Trainees","2018 ","78","44","34",
"33 s","General Trainees","2019 ","96","46","50",
"33 s","Religious Activities","2000 ","6","2","4",
"33 s","Religious Activities","2001 ","8","6","2",
"33 s","Religious Activities","2002 ","6","6","0",
"33 s","Religious Activities","2003 ","5","4","1",
"33 s","Religious Activities","2004 ","6","4","2",
"33 s","Religious Activities","2005 ","9","5","4",
"33 s","Religious Activities","2006 ","13","12","1",
"33 s","Religious Activities","2007 ","18","11","7",
"33 s","Religious Activities","2008 ","11","7","4",
"33 s","Religious Activities","2009 ","9","3","6",
"33 s","Religious Activities","2010 ","11","7","4",
"33 s","Religious Activities","2011 ","13","5","8",
"33 s","Religious Activities","2012 ","6","3","3",
"33 s","Religious Activities","2013 ","10","7","3",
"33 s","Religious Activities","2014 ","11","6","5",
"33 s","Religious Activities","2015 ","10","6","4",
"33 s","Religious Activities","2016 ","6","5","1",
"33 s","Religious Activities","2017 ","4","4","0",
"33 s","Religious Activities","2018 ","7","4","3",
"33 s","Religious Activities","2019 ","9","3","6",
"33 s","Investors","2000 ","62","38","24",
"33 s","Investors","2001 ","56","42","14",
"33 s","Investors","2002 ","51","45","6",
"33 s","Investors","2003 ","45","43","2",
"33 s","Investors","2004 ","49","44","5",
"33 s","Investors","2005 ","55","47","8",
"33 s","Investors","2006 ","39","31","8",
"33 s","Investors","2007 ","47","44","3",
"33 s","Investors","2008 ","48","46","2",
"33 s","Investors","2009 ","28","26","2",
"33 s","Investors","2010 ","38","35","3",
"33 s","Investors","2011 ","36","31","5",
"33 s","Investors","2012 ","33","28","5",
"33 s","Investors","2013 ","26","23","3",
"33 s","Investors","2014 ","26","24","2",
"33 s","Investors","2015 ","27","22","5",
"33 s","Investors","2016 ","17","17","0",
"33 s","Investors","2017 ","18","16","2",
"33 s","Investors","2018 ","23","20","3",
"33 s","Investors","2019 ","15","11","4",
"33 s","Trade and Business","2000 ","4","4","0",
"33 s","Trade and Business","2001 ","19","19","0",
"33 s","Trade and Business","2002 ","13","12","1",
"33 s","Trade and Business","2003 ","10","9","1",
"33 s","Trade and Business","2004 ","15","15","0",
"33 s","Trade and Business","2005 ","29","27","2",
"33 s","Trade and Business","2006 ","17","17","0",
"33 s","Trade and Business","2007 ","17","16","1",
"33 s","Trade and Business","2008 ","22","22","0",
"33 s","Trade and Business","2009 ","22","22","0",
"33 s","Trade and Business","2010 ","31","29","2",
"33 s","Trade and Business","2011 ","32","30","2",
"33 s","Trade and Business","2012 ","51","50","1",
"33 s","Trade and Business","2013 ","58","56","2",
"33 s","Trade and Business","2014 ","70","66","4",
"33 s","Trade and Business","2015 ","42","39","3",
"33 s","Trade and Business","2016 ","47","43","4",
"33 s","Trade and Business","2017 ","21","20","1",
"33 s","Trade and Business","2018 ","21","21","0",
"33 s","Trade and Business","2019 ","24","22","2",
"33 s","Research","2000 ","22","19","3",
"33 s","Research","2001 ","26","21","5",
"33 s","Research","2002 ","25","20","5",
"33 s","Research","2003 ","26","22","4",
"33 s","Research","2004 ","36","31","5",
"33 s","Research","2005 ","22","20","2",
"33 s","Research","2006 ","31","27","4",
"33 s","Research","2007 ","36","29","7",
"33 s","Research","2008 ","27","24","3",
"33 s","Research","2009 ","35","29","6",
"33 s","Research","2010 ","46","41","5",
"33 s","Research","2011 ","45","35","10",
"33 s","Research","2012 ","44","41","3",
"33 s","Research","2013 ","57","52","5",
"33 s","Research","2014 ","41","40","1",
"33 s","Research","2015 ","43","41","2",
"33 s","Research","2016 ","54","48","6",
"33 s","Research","2017 ","57","52","5",
"33 s","Research","2018 ","51","42","9",
"33 s","Research","2019 ","54","47","7",
"33 s","Art and Entertainment","2000 ","38","13","25",
"33 s","Art and Entertainment","2001 ","42","17","25",
"33 s","Art and Entertainment","2002 ","42","17","25",
"33 s","Art and Entertainment","2003 ","46","22","24",
"33 s","Art and Entertainment","2004 ","55","23","32",
"33 s","Art and Entertainment","2005 ","48","23","25",
"33 s","Art and Entertainment","2006 ","51","26","25",
"33 s","Art and Entertainment","2007 ","55","21","34",
"33 s","Art and Entertainment","2008 ","76","26","50",
"33 s","Art and Entertainment","2009 ","48","14","34",
"33 s","Art and Entertainment","2010 ","42","13","29",
"33 s","Art and Entertainment","2011 ","53","18","35",
"33 s","Art and Entertainment","2012 ","64","18","46",
"33 s","Art and Entertainment","2013 ","55","19","36",
"33 s","Art and Entertainment","2014 ","62","15","47",
"33 s","Art and Entertainment","2015 ","30","6","24",
"33 s","Art and Entertainment","2016 ","42","15","27",
"33 s","Art and Entertainment","2017 ","30","16","14",
"33 s","Art and Entertainment","2018 ","25","12","13",
"33 s","Art and Entertainment","2019 ","25","14","11",
"33 s","Unskilled Employment","2000 ","0","0","0",
"33 s","Unskilled Employment","2001 ","0","0","0",
"33 s","Unskilled Employment","2002 ","0","0","0",
"33 s","Unskilled Employment","2003 ","89","68","21",
"33 s","Unskilled Employment","2004 ","314","258","56",
"33 s","Unskilled Employment","2005 ","1280","1106","174",
"33 s","Unskilled Employment","2006 ","1306","1170","136",
"33 s","Unskilled Employment","2007 ","1065","993","72",
"33 s","Unskilled Employment","2008 ","1713","1554","159",
"33 s","Unskilled Employment","2009 ","908","828","80",
"33 s","Unskilled Employment","2010 ","1241","1162","79",
"33 s","Unskilled Employment","2011 ","1708","1585","123",
"33 s","Unskilled Employment","2012 ","1778","1658","120",
"33 s","Unskilled Employment","2013 ","2448","2284","164",
"33 s","Unskilled Employment","2014 ","1963","1849","114",
"33 s","Unskilled Employment","2015 ","2068","1912","156",
"33 s","Unskilled Employment","2016 ","2329","2160","169",
"33 s","Unskilled Employment","2017 ","2047","1925","122",
"33 s","Unskilled Employment","2018 ","2003","1901","102",
"33 s","Unskilled Employment","2019 ","2016","1900","116",
"33 s","Visiting and Joining Family","2000 ","165","16","149",
"33 s","Visiting and Joining Family","2001 ","272","15","257",
"33 s","Visiting and Joining Family","2002 ","205","29","176",
"33 s","Visiting and Joining Family","2003 ","205","95","110",
"33 s","Visiting and Joining Family","2004 ","442","264","178",
"33 s","Visiting and Joining Family","2005 ","1322","757","565",
"33 s","Visiting and Joining Family","2006 ","2316","1362","954",
"33 s","Visiting and Joining Family","2007 ","349","206","143",
"33 s","Visiting and Joining Family","2008 ","24","8","16",
"33 s","Visiting and Joining Family","2009 ","26","11","15",
"33 s","Visiting and Joining Family","2010 ","58","27","31",
"33 s","Visiting and Joining Family","2011 ","51","25","26",
"33 s","Visiting and Joining Family","2012 ","36","17","19",
"33 s","Visiting and Joining Family","2013 ","39","15","24",
"33 s","Visiting and Joining Family","2014 ","47","9","38",
"33 s","Visiting and Joining Family","2015 ","109","26","83",
"33 s","Visiting and Joining Family","2016 ","249","64","185",
"33 s","Visiting and Joining Family","2017 ","195","51","144",
"33 s","Visiting and Joining Family","2018 ","213","56","157",
"33 s","Visiting and Joining Family","2019 ","255","68","187",
"33 s","Overseas Koreans","2000 ","29","18","11",
"33 s","Overseas Koreans","2001 ","27","17","10",
"33 s","Overseas Koreans","2002 ","62","41","21",
"33 s","Overseas Koreans","2003 ","47","29","18",
"33 s","Overseas Koreans","2004 ","49","34","15",
"33 s","Overseas Koreans","2005 ","65","40","25",
"33 s","Overseas Koreans","2006 ","43","30","13",
"33 s","Overseas Koreans","2007 ","52","31","21",
"33 s","Overseas Koreans","2008 ","72","31","41",
"33 s","Overseas Koreans","2009 ","69","36","33",
"33 s","Overseas Koreans","2010 ","163","82","81",
"33 s","Overseas Koreans","2011 ","192","105","87",
"33 s","Overseas Koreans","2012 ","233","123","110",
"33 s","Overseas Koreans","2013 ","339","199","140",
"33 s","Overseas Koreans","2014 ","351","189","162",
"33 s","Overseas Koreans","2015 ","518","287","231",
"33 s","Overseas Koreans","2016 ","714","394","320",
"33 s","Overseas Koreans","2017 ","720","400","320",
"33 s","Overseas Koreans","2018 ","749","416","333",
"33 s","Overseas Koreans","2019 ","794","417","377",
"33 s","Permanent Residence","2000 ","0","0","0",
"33 s","Permanent Residence","2001 ","0","0","0",
"33 s","Permanent Residence","2002 ","1","1","0",
"33 s","Permanent Residence","2003 ","3","1","2",
"33 s","Permanent Residence","2004 ","7","6","1",
"33 s","Permanent Residence","2005 ","7","3","4",
"33 s","Permanent Residence","2006 ","4","3","1",
"33 s","Permanent Residence","2007 ","6","2","4",
"33 s","Permanent Residence","2008 ","17","2","15",
"33 s","Permanent Residence","2009 ","20","4","16",
"33 s","Permanent Residence","2010 ","36","11","25",
"33 s","Permanent Residence","2011 ","74","30","44",
"33 s","Permanent Residence","2012 ","113","49","64",
"33 s","Permanent Residence","2013 ","110","45","65",
"33 s","Permanent Residence","2014 ","96","52","44",
"33 s","Permanent Residence","2015 ","164","67","97",
"33 s","Permanent Residence","2016 ","164","88","76",
"33 s","Permanent Residence","2017 ","134","76","58",
"33 s","Permanent Residence","2018 ","153","62","91",
"33 s","Permanent Residence","2019 ","153","60","93",
"33 s","Marriage Immigration","2011 ","17","1","16",
"33 s","Marriage Immigration","2012 ","426","43","383",
"33 s","Marriage Immigration","2013 ","412","44","368",
"33 s","Marriage Immigration","2014 ","355","60","295",
"33 s","Marriage Immigration","2015 ","362","65","297",
"33 s","Marriage Immigration","2016 ","388","63","325",
"33 s","Marriage Immigration","2017 ","364","60","304",
"33 s","Marriage Immigration","2018 ","432","86","346",
"33 s","Marriage Immigration","2019 ","449","88","361",
"34 s","Total","2000 ","4438","2826","1612",
"34 s","Total","2001 ","4026","2526","1500",
"34 s","Total","2002 ","4181","2738","1443",
"34 s","Total","2003 ","4874","3444","1430",
"34 s","Total","2004 ","5352","3553","1799",
"34 s","Total","2005 ","7623","5279","2344",
"34 s","Total","2006 ","9272","6499","2773",
"34 s","Total","2007 ","6867","4506","2361",
"34 s","Total","2008 ","6247","4061","2186",
"34 s","Total","2009 ","4640","2900","1740",
"34 s","Total","2010 ","5504","3534","1970",
"34 s","Total","2011 ","5699","3761","1938",
"34 s","Total","2012 ","5803","3758","2045",
"34 s","Total","2013 ","7857","5359","2498",
"34 s","Total","2014 ","8223","5240","2983",
"34 s","Total","2015 ","7198","4615","2583",
"34 s","Total","2016 ","8590","5405","3185",
"34 s","Total","2017 ","10467","6410","4057",
"34 s","Total","2018 ","11259","6850","4409",
"34 s","Total","2019 ","10145","5974","4171",
"34 s","Sightseeing Pass","2000 ","313","192","121",
"34 s","Sightseeing Pass","2001 ","427","306","121",
"34 s","Sightseeing Pass","2002 ","484","335","149",
"34 s","Sightseeing Pass","2003 ","331","210","121",
"34 s","Sightseeing Pass","2004 ","364","218","146",
"34 s","Sightseeing Pass","2005 ","351","213","138",
"34 s","Sightseeing Pass","2006 ","285","177","108",
"34 s","Sightseeing Pass","2007 ","316","182","134",
"34 s","Sightseeing Pass","2008 ","350","220","130",
"34 s","Sightseeing Pass","2009 ","321","174","147",
"34 s","Sightseeing Pass","2010 ","448","251","197",
"34 s","Sightseeing Pass","2011 ","342","178","164",
"34 s","Sightseeing Pass","2012 ","321","171","150",
"34 s","Sightseeing Pass","2013 ","319","170","149",
"34 s","Sightseeing Pass","2014 ","383","211","172",
"34 s","Sightseeing Pass","2015 ","481","249","232",
"34 s","Sightseeing Pass","2016 ","538","319","219",
"34 s","Sightseeing Pass","2017 ","498","325","173",
"34 s","Sightseeing Pass","2018 ","750","485","265",
"34 s","Sightseeing Pass","2019 ","454","236","218",
"34 s","Short-term Business","2000 ","766","451","315",
"34 s","Short-term Business","2001 ","849","539","310",
"34 s","Short-term Business","2002 ","448","302","146",
"34 s","Short-term Business","2003 ","353","261","92",
"34 s","Short-term Business","2004 ","353","263","90",
"34 s","Short-term Business","2005 ","267","193","74",
"34 s","Short-term Business","2006 ","604","442","162",
"34 s","Short-term Business","2007 ","779","578","201",
"34 s","Short-term Business","2008 ","359","284","75",
"34 s","Short-term Business","2009 ","109","85","24",
"34 s","Short-term Business","2010 ","92","79","13",
"34 s","Short-term Business","2011 ","86","76","10",
"34 s","Short-term Visitors","2000 ","1077","647","430",
"34 s","Short-term Visitors","2001 ","939","563","376",
"34 s","Short-term Visitors","2002 ","1031","637","394",
"34 s","Short-term Visitors","2003 ","711","451","260",
"34 s","Short-term Visitors","2004 ","643","416","227",
"34 s","Short-term Visitors","2005 ","580","354","226",
"34 s","Short-term Visitors","2006 ","739","456","283",
"34 s","Short-term Visitors","2007 ","614","342","272",
"34 s","Short-term Visitors","2008 ","415","222","193",
"34 s","Short-term Visitors","2009 ","269","141","128",
"34 s","Short-term Visitors","2010 ","672","398","274",
"34 s","Short-term Visitors","2011 ","860","486","374",
"34 s","Short-term Visitors","2012 ","997","622","375",
"34 s","Short-term Visitors","2013 ","1248","791","457",
"34 s","Short-term Visitors","2014 ","786","472","314",
"34 s","Short-term Visitors","2015 ","997","590","407",
"34 s","Short-term Visitors","2016 ","1176","696","480",
"34 s","Short-term Visitors","2017 ","1382","866","516",
"34 s","Short-term Visitors","2018 ","1359","888","471",
"34 s","Short-term Visitors","2019 ","1629","1085","544",
"34 s","Short-term Employment","2000 ","6","6","0",
"34 s","Short-term Employment","2001 ","2","2","0",
"34 s","Short-term Employment","2002 ","11","10","1",
"34 s","Short-term Employment","2003 ","9","9","0",
"34 s","Short-term Employment","2004 ","3","2","1",
"34 s","Short-term Employment","2005 ","11","11","0",
"34 s","Short-term Employment","2006 ","5","2","3",
"34 s","Short-term Employment","2007 ","8","7","1",
"34 s","Short-term Employment","2008 ","4","3","1",
"34 s","Short-term Employment","2009 ","7","4","3",
"34 s","Short-term Employment","2010 ","4","3","1",
"34 s","Short-term Employment","2011 ","3","3","",
"34 s","Short-term Employment","2012 ","4","4","",
"34 s","Short-term Employment","2013 ","3","3","0",
"34 s","Short-term Employment","2014 ","1","1","0",
"34 s","Short-term Employment","2015 ","5","5","0",
"34 s","Short-term Employment","2016 ","14","14","0",
"34 s","Short-term Employment","2017 ","9","5","4",
"34 s","Short-term Employment","2018 ","11","7","4",
"34 s","Short-term Employment","2019 ","8","6","2",
"34 s","Job Seeking","2000 ","0","0","0",
"34 s","Job Seeking","2001 ","0","0","0",
"34 s","Job Seeking","2002 ","0","0","0",
"34 s","Job Seeking","2003 ","0","0","0",
"34 s","Job Seeking","2004 ","0","0","0",
"34 s","Job Seeking","2005 ","0","0","0",
"34 s","Job Seeking","2006 ","0","0","0",
"34 s","Job Seeking","2007 ","0","0","0",
"34 s","Job Seeking","2008 ","0","0","0",
"34 s","Job Seeking","2009 ","0","0","0",
"34 s","Job Seeking","2010 ","0","0","0",
"34 s","Job Seeking","2011 ","2","","2",
"34 s","Job Seeking","2013 ","1","0","1",
"34 s","Job Seeking","2014 ","5","3","2",
"34 s","Job Seeking","2015 ","4","2","2",
"34 s","Job Seeking","2016 ","2","2","0",
"34 s","Job Seeking","2017 ","4","2","2",
"34 s","Job Seeking","2018 ","8","3","5",
"34 s","Job Seeking","2019 ","6","2","4",
"34 s","study","2000 ","29","16","13",
"34 s","study","2001 ","21","14","7",
"34 s","study","2002 ","36","28","8",
"34 s","study","2003 ","37","26","11",
"34 s","study","2004 ","39","24","15",
"34 s","study","2005 ","47","31","16",
"34 s","study","2006 ","37","27","10",
"34 s","study","2007 ","53","23","30",
"34 s","study","2008 ","49","30","19",
"34 s","study","2009 ","49","33","16",
"34 s","study","2010 ","59","32","27",
"34 s","study","2011 ","60","46","14",
"34 s","study","2012 ","71","44","27",
"34 s","study","2013 ","85","62","23",
"34 s","study","2014 ","105","70","35",
"34 s","study","2015 ","100","64","36",
"34 s","study","2016 ","98","55","43",
"34 s","study","2017 ","146","89","57",
"34 s","study","2018 ","175","108","67",
"34 s","study","2019 ","186","96","90",
"34 s","General Trainees","2000 ","15","10","5",
"34 s","General Trainees","2001 ","8","7","1",
"34 s","General Trainees","2002 ","13","9","4",
"34 s","General Trainees","2003 ","13","6","7",
"34 s","General Trainees","2004 ","29","16","13",
"34 s","General Trainees","2005 ","43","19","24",
"34 s","General Trainees","2006 ","21","14","7",
"34 s","General Trainees","2007 ","22","15","7",
"34 s","General Trainees","2008 ","33","13","20",
"34 s","General Trainees","2009 ","32","12","20",
"34 s","General Trainees","2010 ","52","27","25",
"34 s","General Trainees","2011 ","59","36","23",
"34 s","General Trainees","2012 ","58","34","24",
"34 s","General Trainees","2013 ","67","35","32",
"34 s","General Trainees","2014 ","74","42","32",
"34 s","General Trainees","2015 ","78","38","40",
"34 s","General Trainees","2016 ","82","39","43",
"34 s","General Trainees","2017 ","78","34","44",
"34 s","General Trainees","2018 ","88","45","43",
"34 s","General Trainees","2019 ","72","40","32",
"34 s","Religious Activities","2000 ","8","4","4",
"34 s","Religious Activities","2001 ","6","3","3",
"34 s","Religious Activities","2002 ","2","1","1",
"34 s","Religious Activities","2003 ","3","2","1",
"34 s","Religious Activities","2004 ","7","5","2",
"34 s","Religious Activities","2005 ","10","8","2",
"34 s","Religious Activities","2006 ","6","3","3",
"34 s","Religious Activities","2007 ","11","9","2",
"34 s","Religious Activities","2008 ","12","7","5",
"34 s","Religious Activities","2009 ","8","2","6",
"34 s","Religious Activities","2010 ","6","3","3",
"34 s","Religious Activities","2011 ","5","3","2",
"34 s","Religious Activities","2012 ","4","2","2",
"34 s","Religious Activities","2013 ","8","3","5",
"34 s","Religious Activities","2014 ","7","4","3",
"34 s","Religious Activities","2015 ","5","3","2",
"34 s","Religious Activities","2016 ","8","3","5",
"34 s","Religious Activities","2017 ","6","5","1",
"34 s","Religious Activities","2018 ","7","3","4",
"34 s","Religious Activities","2019 ","5","4","1",
"34 s","Investors","2000 ","103","58","45",
"34 s","Investors","2001 ","63","50","13",
"34 s","Investors","2002 ","38","35","3",
"34 s","Investors","2003 ","39","32","7",
"34 s","Investors","2004 ","53","45","8",
"34 s","Investors","2005 ","55","49","6",
"34 s","Investors","2006 ","39","33","6",
"34 s","Investors","2007 ","38","35","3",
"34 s","Investors","2008 ","37","33","4",
"34 s","Investors","2009 ","24","22","2",
"34 s","Investors","2010 ","36","35","1",
"34 s","Investors","2011 ","38","36","2",
"34 s","Investors","2012 ","30","27","3",
"34 s","Investors","2013 ","37","34","3",
"34 s","Investors","2014 ","21","19","2",
"34 s","Investors","2015 ","26","24","2",
"34 s","Investors","2016 ","12","10","2",
"34 s","Investors","2017 ","26","24","2",
"34 s","Investors","2018 ","24","23","1",
"34 s","Investors","2019 ","21","15","6",
"34 s","Trade and Business","2000 ","11","11","0",
"34 s","Trade and Business","2001 ","18","15","3",
"34 s","Trade and Business","2002 ","5","5","0",
"34 s","Trade and Business","2003 ","13","12","1",
"34 s","Trade and Business","2004 ","5","5","0",
"34 s","Trade and Business","2005 ","15","15","0",
"34 s","Trade and Business","2006 ","22","22","0",
"34 s","Trade and Business","2007 ","14","13","1",
"34 s","Trade and Business","2008 ","20","19","1",
"34 s","Trade and Business","2009 ","23","22","1",
"34 s","Trade and Business","2010 ","29","25","4",
"34 s","Trade and Business","2011 ","30","29","1",
"34 s","Trade and Business","2012 ","35","35","",
"34 s","Trade and Business","2013 ","51","48","3",
"34 s","Trade and Business","2014 ","58","56","2",
"34 s","Trade and Business","2015 ","46","41","5",
"34 s","Trade and Business","2016 ","43","40","3",
"34 s","Trade and Business","2017 ","31","27","4",
"34 s","Trade and Business","2018 ","28","25","3",
"34 s","Trade and Business","2019 ","21","20","1",
"34 s","Research","2000 ","23","20","3",
"34 s","Research","2001 ","24","19","5",
"34 s","Research","2002 ","31","28","3",
"34 s","Research","2003 ","23","19","4",
"34 s","Research","2004 ","29","24","5",
"34 s","Research","2005 ","22","19","3",
"34 s","Research","2006 ","32","25","7",
"34 s","Research","2007 ","36","30","6",
"34 s","Research","2008 ","24","23","1",
"34 s","Research","2009 ","37","35","2",
"34 s","Research","2010 ","31","25","6",
"34 s","Research","2011 ","41","38","3",
"34 s","Research","2012 ","47","40","7",
"34 s","Research","2013 ","47","42","5",
"34 s","Research","2014 ","37","31","6",
"34 s","Research","2015 ","44","36","8",
"34 s","Research","2016 ","36","29","7",
"34 s","Research","2017 ","27","22","5",
"34 s","Research","2018 ","50","46","4",
"34 s","Research","2019 ","38","31","7",
"34 s","Art and Entertainment","2000 ","34","15","19",
"34 s","Art and Entertainment","2001 ","34","17","17",
"34 s","Art and Entertainment","2002 ","39","20","19",
"34 s","Art and Entertainment","2003 ","34","19","15",
"34 s","Art and Entertainment","2004 ","38","18","20",
"34 s","Art and Entertainment","2005 ","35","23","12",
"34 s","Art and Entertainment","2006 ","44","20","24",
"34 s","Art and Entertainment","2007 ","47","23","24",
"34 s","Art and Entertainment","2008 ","55","26","29",
"34 s","Art and Entertainment","2009 ","36","11","25",
"34 s","Art and Entertainment","2010 ","51","16","35",
"34 s","Art and Entertainment","2011 ","38","17","21",
"34 s","Art and Entertainment","2012 ","59","13","46",
"34 s","Art and Entertainment","2013 ","35","7","28",
"34 s","Art and Entertainment","2014 ","43","16","27",
"34 s","Art and Entertainment","2015 ","32","14","18",
"34 s","Art and Entertainment","2016 ","24","13","11",
"34 s","Art and Entertainment","2017 ","21","11","10",
"34 s","Art and Entertainment","2018 ","30","12","18",
"34 s","Art and Entertainment","2019 ","21","6","15",
"34 s","Unskilled Employment","2000 ","0","0","0",
"34 s","Unskilled Employment","2001 ","0","0","0",
"34 s","Unskilled Employment","2002 ","0","0","0",
"34 s","Unskilled Employment","2003 ","78","60","18",
"34 s","Unskilled Employment","2004 ","291","234","57",
"34 s","Unskilled Employment","2005 ","1271","1122","149",
"34 s","Unskilled Employment","2006 ","1313","1160","153",
"34 s","Unskilled Employment","2007 ","1073","1009","64",
"34 s","Unskilled Employment","2008 ","1523","1398","125",
"34 s","Unskilled Employment","2009 ","869","792","77",
"34 s","Unskilled Employment","2010 ","1110","1035","75",
"34 s","Unskilled Employment","2011 ","1511","1400","111",
"34 s","Unskilled Employment","2012 ","1518","1412","106",
"34 s","Unskilled Employment","2013 ","2364","2227","137",
"34 s","Unskilled Employment","2014 ","1604","1510","94",
"34 s","Unskilled Employment","2015 ","1796","1680","116",
"34 s","Unskilled Employment","2016 ","2031","1909","122",
"34 s","Unskilled Employment","2017 ","1872","1761","111",
"34 s","Unskilled Employment","2018 ","1745","1695","50",
"34 s","Unskilled Employment","2019 ","1764","1692","72",
"34 s","Visiting and Joining Family","2000 ","146","9","137",
"34 s","Visiting and Joining Family","2001 ","262","13","249",
"34 s","Visiting and Joining Family","2002 ","189","18","171",
"34 s","Visiting and Joining Family","2003 ","189","95","94",
"34 s","Visiting and Joining Family","2004 ","438","255","183",
"34 s","Visiting and Joining Family","2005 ","1553","849","704",
"34 s","Visiting and Joining Family","2006 ","2612","1539","1073",
"34 s","Visiting and Joining Family","2007 ","350","202","148",
"34 s","Visiting and Joining Family","2008 ","37","18","19",
"34 s","Visiting and Joining Family","2009 ","40","17","23",
"34 s","Visiting and Joining Family","2010 ","61","33","28",
"34 s","Visiting and Joining Family","2011 ","50","24","26",
"34 s","Visiting and Joining Family","2012 ","27","14","13",
"34 s","Visiting and Joining Family","2013 ","42","19","23",
"34 s","Visiting and Joining Family","2014 ","64","19","45",
"34 s","Visiting and Joining Family","2015 ","61","16","45",
"34 s","Visiting and Joining Family","2016 ","245","67","178",
"34 s","Visiting and Joining Family","2017 ","215","54","161",
"34 s","Visiting and Joining Family","2018 ","214","67","147",
"34 s","Visiting and Joining Family","2019 ","280","84","196",
"34 s","Overseas Koreans","2000 ","19","13","6",
"34 s","Overseas Koreans","2001 ","27","13","14",
"34 s","Overseas Koreans","2002 ","44","28","16",
"34 s","Overseas Koreans","2003 ","43","21","22",
"34 s","Overseas Koreans","2004 ","54","32","22",
"34 s","Overseas Koreans","2005 ","59","31","28",
"34 s","Overseas Koreans","2006 ","56","31","25",
"34 s","Overseas Koreans","2007 ","73","41","32",
"34 s","Overseas Koreans","2008 ","83","40","43",
"34 s","Overseas Koreans","2009 ","64","33","31",
"34 s","Overseas Koreans","2010 ","124","65","59",
"34 s","Overseas Koreans","2011 ","175","90","85",
"34 s","Overseas Koreans","2012 ","219","122","97",
"34 s","Overseas Koreans","2013 ","326","192","134",
"34 s","Overseas Koreans","2014 ","348","180","168",
"34 s","Overseas Koreans","2015 ","459","262","197",
"34 s","Overseas Koreans","2016 ","681","365","316",
"34 s","Overseas Koreans","2017 ","696","399","297",
"34 s","Overseas Koreans","2018 ","717","394","323",
"34 s","Overseas Koreans","2019 ","783","433","350",
"34 s","Permanent Residence","2000 ","0","0","0",
"34 s","Permanent Residence","2001 ","0","0","0",
"34 s","Permanent Residence","2002 ","0","0","0",
"34 s","Permanent Residence","2003 ","4","4","0",
"34 s","Permanent Residence","2004 ","5","3","2",
"34 s","Permanent Residence","2005 ","3","3","0",
"34 s","Permanent Residence","2006 ","4","1","3",
"34 s","Permanent Residence","2007 ","6","3","3",
"34 s","Permanent Residence","2008 ","13","4","9",
"34 s","Permanent Residence","2009 ","17","2","15",
"34 s","Permanent Residence","2010 ","27","9","18",
"34 s","Permanent Residence","2011 ","64","31","33",
"34 s","Permanent Residence","2012 ","97","37","60",
"34 s","Permanent Residence","2013 ","129","57","72",
"34 s","Permanent Residence","2014 ","131","52","79",
"34 s","Permanent Residence","2015 ","130","62","68",
"34 s","Permanent Residence","2016 ","151","69","82",
"34 s","Permanent Residence","2017 ","149","67","82",
"34 s","Permanent Residence","2018 ","148","65","83",
"34 s","Permanent Residence","2019 ","141","68","73",
"34 s","Marriage Immigration","2011 ","17","2","15",
"34 s","Marriage Immigration","2012 ","388","59","329",
"34 s","Marriage Immigration","2013 ","373","61","312",
"34 s","Marriage Immigration","2014 ","369","69","300",
"34 s","Marriage Immigration","2015 ","288","41","247",
"34 s","Marriage Immigration","2016 ","337","54","283",
"34 s","Marriage Immigration","2017 ","345","71","274",
"34 s","Marriage Immigration","2018 ","389","69","320",
"34 s","Marriage Immigration","2019 ","489","75","414",
"35 s","Total","2000 ","4302","2744","1558",
"35 s","Total","2001 ","4189","2628","1561",
"35 s","Total","2002 ","3710","2400","1310",
"35 s","Total","2003 ","4434","3147","1287",
"35 s","Total","2004 ","5027","3297","1730",
"35 s","Total","2005 ","7327","4965","2362",
"35 s","Total","2006 ","9281","6400","2881",
"35 s","Total","2007 ","6935","4476","2459",
"35 s","Total","2008 ","6426","4106","2320",
"35 s","Total","2009 ","4575","2876","1699",
"35 s","Total","2010 ","5019","3230","1789",
"35 s","Total","2011 ","5350","3589","1761",
"35 s","Total","2012 ","5269","3463","1806",
"35 s","Total","2013 ","6916","4686","2230",
"35 s","Total","2014 ","7777","4944","2833",
"35 s","Total","2015 ","6948","4478","2470",
"35 s","Total","2016 ","7457","4765","2692",
"35 s","Total","2017 ","10180","6327","3853",
"35 s","Total","2018 ","10775","6476","4299",
"35 s","Total","2019 ","9146","5503","3643",
"35 s","Sightseeing Pass","2000 ","280","175","105",
"35 s","Sightseeing Pass","2001 ","438","295","143",
"35 s","Sightseeing Pass","2002 ","457","315","142",
"35 s","Sightseeing Pass","2003 ","366","245","121",
"35 s","Sightseeing Pass","2004 ","346","204","142",
"35 s","Sightseeing Pass","2005 ","278","171","107",
"35 s","Sightseeing Pass","2006 ","296","170","126",
"35 s","Sightseeing Pass","2007 ","320","194","126",
"35 s","Sightseeing Pass","2008 ","341","209","132",
"35 s","Sightseeing Pass","2009 ","357","194","163",
"35 s","Sightseeing Pass","2010 ","491","279","212",
"35 s","Sightseeing Pass","2011 ","333","186","147",
"35 s","Sightseeing Pass","2012 ","325","168","157",
"35 s","Sightseeing Pass","2013 ","299","159","140",
"35 s","Sightseeing Pass","2014 ","363","206","157",
"35 s","Sightseeing Pass","2015 ","458","258","200",
"35 s","Sightseeing Pass","2016 ","410","237","173",
"35 s","Sightseeing Pass","2017 ","555","333","222",
"35 s","Sightseeing Pass","2018 ","823","534","289",
"35 s","Sightseeing Pass","2019 ","441","207","234",
"35 s","Short-term Business","2000 ","880","529","351",
"35 s","Short-term Business","2001 ","999","626","373",
"35 s","Short-term Business","2002 ","425","272","153",
"35 s","Short-term Business","2003 ","327","256","71",
"35 s","Short-term Business","2004 ","330","239","91",
"35 s","Short-term Business","2005 ","265","205","60",
"35 s","Short-term Business","2006 ","632","477","155",
"35 s","Short-term Business","2007 ","819","623","196",
"35 s","Short-term Business","2008 ","371","297","74",
"35 s","Short-term Business","2009 ","125","108","17",
"35 s","Short-term Business","2010 ","115","97","18",
"35 s","Short-term Business","2011 ","95","82","13",
"35 s","Short-term Visitors","2000 ","1104","691","413",
"35 s","Short-term Visitors","2001 ","1015","617","398",
"35 s","Short-term Visitors","2002 ","1000","634","366",
"35 s","Short-term Visitors","2003 ","670","410","260",
"35 s","Short-term Visitors","2004 ","604","398","206",
"35 s","Short-term Visitors","2005 ","609","356","253",
"35 s","Short-term Visitors","2006 ","766","486","280",
"35 s","Short-term Visitors","2007 ","591","343","248",
"35 s","Short-term Visitors","2008 ","411","227","184",
"35 s","Short-term Visitors","2009 ","203","98","105",
"35 s","Short-term Visitors","2010 ","586","336","250",
"35 s","Short-term Visitors","2011 ","862","510","352",
"35 s","Short-term Visitors","2012 ","885","555","330",
"35 s","Short-term Visitors","2013 ","1142","707","435",
"35 s","Short-term Visitors","2014 ","772","473","299",
"35 s","Short-term Visitors","2015 ","1071","633","438",
"35 s","Short-term Visitors","2016 ","997","591","406",
"35 s","Short-term Visitors","2017 ","1377","881","496",
"35 s","Short-term Visitors","2018 ","1390","892","498",
"35 s","Short-term Visitors","2019 ","1489","991","498",
"35 s","Short-term Employment","2000 ","5","5","0",
"35 s","Short-term Employment","2001 ","9","5","4",
"35 s","Short-term Employment","2002 ","6","4","2",
"35 s","Short-term Employment","2003 ","13","12","1",
"35 s","Short-term Employment","2004 ","5","3","2",
"35 s","Short-term Employment","2005 ","5","4","1",
"35 s","Short-term Employment","2006 ","5","3","2",
"35 s","Short-term Employment","2007 ","11","9","2",
"35 s","Short-term Employment","2008 ","5","4","1",
"35 s","Short-term Employment","2009 ","3","3","0",
"35 s","Short-term Employment","2010 ","3","0","3",
"35 s","Short-term Employment","2011 ","1","","1",
"35 s","Short-term Employment","2012 ","5","4","1",
"35 s","Short-term Employment","2013 ","2","2","0",
"35 s","Short-term Employment","2014 ","2","1","1",
"35 s","Short-term Employment","2015 ","2","2","0",
"35 s","Short-term Employment","2016 ","12","12","0",
"35 s","Short-term Employment","2017 ","6","5","1",
"35 s","Short-term Employment","2018 ","13","12","1",
"35 s","Short-term Employment","2019 ","14","11","3",
"35 s","Job Seeking","2000 ","0","0","0",
"35 s","Job Seeking","2001 ","0","0","0",
"35 s","Job Seeking","2002 ","0","0","0",
"35 s","Job Seeking","2003 ","0","0","0",
"35 s","Job Seeking","2004 ","0","0","0",
"35 s","Job Seeking","2005 ","0","0","0",
"35 s","Job Seeking","2006 ","0","0","0",
"35 s","Job Seeking","2007 ","0","0","0",
"35 s","Job Seeking","2008 ","0","0","0",
"35 s","Job Seeking","2009 ","0","0","0",
"35 s","Job Seeking","2010 ","0","0","0",
"35 s","Job Seeking","2013 ","2","1","1",
"35 s","Job Seeking","2014 ","2","1","1",
"35 s","Job Seeking","2015 ","1","1","0",
"35 s","Job Seeking","2016 ","4","2","2",
"35 s","Job Seeking","2017 ","7","4","3",
"35 s","Job Seeking","2018 ","2","1","1",
"35 s","Job Seeking","2019 ","3","2","1",
"35 s","study","2000 ","30","23","7",
"35 s","study","2001 ","33","18","15",
"35 s","study","2002 ","28","20","8",
"35 s","study","2003 ","24","16","8",
"35 s","study","2004 ","34","24","10",
"35 s","study","2005 ","33","25","8",
"35 s","study","2006 ","44","30","14",
"35 s","study","2007 ","31","21","10",
"35 s","study","2008 ","52","28","24",
"35 s","study","2009 ","55","42","13",
"35 s","study","2010 ","45","32","13",
"35 s","study","2011 ","67","51","16",
"35 s","study","2012 ","67","44","23",
"35 s","study","2013 ","65","39","26",
"35 s","study","2014 ","92","60","32",
"35 s","study","2015 ","98","67","31",
"35 s","study","2016 ","111","75","36",
"35 s","study","2017 ","123","85","38",
"35 s","study","2018 ","159","84","75",
"35 s","study","2019 ","183","110","73",
"35 s","General Trainees","2000 ","12","9","3",
"35 s","General Trainees","2001 ","21","12","9",
"35 s","General Trainees","2002 ","12","7","5",
"35 s","General Trainees","2003 ","8","6","2",
"35 s","General Trainees","2004 ","21","12","9",
"35 s","General Trainees","2005 ","24","16","8",
"35 s","General Trainees","2006 ","15","8","7",
"35 s","General Trainees","2007 ","31","16","15",
"35 s","General Trainees","2008 ","33","22","11",
"35 s","General Trainees","2009 ","24","17","7",
"35 s","General Trainees","2010 ","33","19","14",
"35 s","General Trainees","2011 ","54","29","25",
"35 s","General Trainees","2012 ","45","25","20",
"35 s","General Trainees","2013 ","57","30","27",
"35 s","General Trainees","2014 ","62","34","28",
"35 s","General Trainees","2015 ","69","38","31",
"35 s","General Trainees","2016 ","63","36","27",
"35 s","General Trainees","2017 ","82","47","35",
"35 s","General Trainees","2018 ","73","42","31",
"35 s","General Trainees","2019 ","81","46","35",
"35 s","Religious Activities","2000 ","7","4","3",
"35 s","Religious Activities","2001 ","4","4","0",
"35 s","Religious Activities","2002 ","5","3","2",
"35 s","Religious Activities","2003 ","3","3","0",
"35 s","Religious Activities","2004 ","6","6","0",
"35 s","Religious Activities","2005 ","10","3","7",
"35 s","Religious Activities","2006 ","13","9","4",
"35 s","Religious Activities","2007 ","8","7","1",
"35 s","Religious Activities","2008 ","5","4","1",
"35 s","Religious Activities","2009 ","7","5","2",
"35 s","Religious Activities","2010 ","6","4","2",
"35 s","Religious Activities","2011 ","7","7","",
"35 s","Religious Activities","2012 ","6","5","1",
"35 s","Religious Activities","2013 ","7","4","3",
"35 s","Religious Activities","2014 ","13","8","5",
"35 s","Religious Activities","2015 ","8","3","5",
"35 s","Religious Activities","2016 ","10","4","6",
"35 s","Religious Activities","2017 ","5","2","3",
"35 s","Religious Activities","2018 ","5","3","2",
"35 s","Religious Activities","2019 ","3","3","0",
"35 s","Investors","2000 ","95","56","39",
"35 s","Investors","2001 ","66","51","15",
"35 s","Investors","2002 ","54","48","6",
"35 s","Investors","2003 ","39","35","4",
"35 s","Investors","2004 ","47","41","6",
"35 s","Investors","2005 ","50","44","6",
"35 s","Investors","2006 ","34","31","3",
"35 s","Investors","2007 ","50","46","4",
"35 s","Investors","2008 ","43","40","3",
"35 s","Investors","2009 ","41","38","3",
"35 s","Investors","2010 ","26","23","3",
"35 s","Investors","2011 ","27","26","1",
"35 s","Investors","2012 ","36","34","2",
"35 s","Investors","2013 ","41","37","4",
"35 s","Investors","2014 ","22","21","1",
"35 s","Investors","2015 ","24","20","4",
"35 s","Investors","2016 ","28","22","6",
"35 s","Investors","2017 ","21","20","1",
"35 s","Investors","2018 ","27","24","3",
"35 s","Investors","2019 ","21","17","4",
"35 s","Trade and Business","2000 ","3","3","0",
"35 s","Trade and Business","2001 ","10","9","1",
"35 s","Trade and Business","2002 ","16","16","0",
"35 s","Trade and Business","2003 ","15","15","0",
"35 s","Trade and Business","2004 ","10","10","0",
"35 s","Trade and Business","2005 ","20","20","0",
"35 s","Trade and Business","2006 ","14","14","0",
"35 s","Trade and Business","2007 ","12","12","0",
"35 s","Trade and Business","2008 ","23","23","0",
"35 s","Trade and Business","2009 ","23","23","0",
"35 s","Trade and Business","2010 ","29","27","2",
"35 s","Trade and Business","2011 ","24","23","1",
"35 s","Trade and Business","2012 ","35","34","1",
"35 s","Trade and Business","2013 ","54","50","4",
"35 s","Trade and Business","2014 ","60","59","1",
"35 s","Trade and Business","2015 ","48","44","4",
"35 s","Trade and Business","2016 ","45","44","1",
"35 s","Trade and Business","2017 ","25","23","2",
"35 s","Trade and Business","2018 ","19","18","1",
"35 s","Trade and Business","2019 ","19","19","0",
"35 s","Research","2000 ","19","18","1",
"35 s","Research","2001 ","21","18","3",
"35 s","Research","2002 ","27","26","1",
"35 s","Research","2003 ","15","14","1",
"35 s","Research","2004 ","21","20","1",
"35 s","Research","2005 ","20","18","2",
"35 s","Research","2006 ","31","24","7",
"35 s","Research","2007 ","27","25","2",
"35 s","Research","2008 ","19","16","3",
"35 s","Research","2009 ","11","8","3",
"35 s","Research","2010 ","20","17","3",
"35 s","Research","2011 ","30","30","",
"35 s","Research","2012 ","35","31","4",
"35 s","Research","2013 ","26","24","2",
"35 s","Research","2014 ","40","38","2",
"35 s","Research","2015 ","34","32","2",
"35 s","Research","2016 ","38","32","6",
"35 s","Research","2017 ","45","39","6",
"35 s","Research","2018 ","37","30","7",
"35 s","Research","2019 ","34","29","5",
"35 s","Art and Entertainment","2000 ","27","14","13",
"35 s","Art and Entertainment","2001 ","34","26","8",
"35 s","Art and Entertainment","2002 ","25","20","5",
"35 s","Art and Entertainment","2003 ","32","19","13",
"35 s","Art and Entertainment","2004 ","41","23","18",
"35 s","Art and Entertainment","2005 ","53","22","31",
"35 s","Art and Entertainment","2006 ","38","22","16",
"35 s","Art and Entertainment","2007 ","38","13","25",
"35 s","Art and Entertainment","2008 ","41","20","21",
"35 s","Art and Entertainment","2009 ","38","14","24",
"35 s","Art and Entertainment","2010 ","39","13","26",
"35 s","Art and Entertainment","2011 ","33","12","21",
"35 s","Art and Entertainment","2012 ","36","11","25",
"35 s","Art and Entertainment","2013 ","37","7","30",
"35 s","Art and Entertainment","2014 ","31","11","20",
"35 s","Art and Entertainment","2015 ","23","13","10",
"35 s","Art and Entertainment","2016 ","26","11","15",
"35 s","Art and Entertainment","2017 ","15","9","6",
"35 s","Art and Entertainment","2018 ","33","14","19",
"35 s","Art and Entertainment","2019 ","25","10","15",
"35 s","Unskilled Employment","2000 ","0","0","0",
"35 s","Unskilled Employment","2001 ","0","0","0",
"35 s","Unskilled Employment","2002 ","0","0","0",
"35 s","Unskilled Employment","2003 ","57","39","18",
"35 s","Unskilled Employment","2004 ","245","192","53",
"35 s","Unskilled Employment","2005 ","1175","1040","135",
"35 s","Unskilled Employment","2006 ","1103","990","113",
"35 s","Unskilled Employment","2007 ","897","848","49",
"35 s","Unskilled Employment","2008 ","1355","1226","129",
"35 s","Unskilled Employment","2009 ","788","728","60",
"35 s","Unskilled Employment","2010 ","951","904","47",
"35 s","Unskilled Employment","2011 ","1344","1266","78",
"35 s","Unskilled Employment","2012 ","1352","1276","76",
"35 s","Unskilled Employment","2013 ","2010","1903","107",
"35 s","Unskilled Employment","2014 ","1417","1354","63",
"35 s","Unskilled Employment","2015 ","1573","1482","91",
"35 s","Unskilled Employment","2016 ","1725","1626","99",
"35 s","Unskilled Employment","2017 ","1741","1654","87",
"35 s","Unskilled Employment","2018 ","1569","1502","67",
"35 s","Unskilled Employment","2019 ","1438","1381","57",
"35 s","Visiting and Joining Family","2000 ","153","11","142",
"35 s","Visiting and Joining Family","2001 ","242","15","227",
"35 s","Visiting and Joining Family","2002 ","163","14","149",
"35 s","Visiting and Joining Family","2003 ","168","73","95",
"35 s","Visiting and Joining Family","2004 ","438","235","203",
"35 s","Visiting and Joining Family","2005 ","1598","834","764",
"35 s","Visiting and Joining Family","2006 ","2838","1626","1212",
"35 s","Visiting and Joining Family","2007 ","396","207","189",
"35 s","Visiting and Joining Family","2008 ","35","18","17",
"35 s","Visiting and Joining Family","2009 ","27","13","14",
"35 s","Visiting and Joining Family","2010 ","49","27","22",
"35 s","Visiting and Joining Family","2011 ","41","19","22",
"35 s","Visiting and Joining Family","2012 ","27","17","10",
"35 s","Visiting and Joining Family","2013 ","29","9","20",
"35 s","Visiting and Joining Family","2014 ","52","13","39",
"35 s","Visiting and Joining Family","2015 ","72","13","59",
"35 s","Visiting and Joining Family","2016 ","176","64","112",
"35 s","Visiting and Joining Family","2017 ","198","62","136",
"35 s","Visiting and Joining Family","2018 ","212","71","141",
"35 s","Visiting and Joining Family","2019 ","198","49","149",
"35 s","Overseas Koreans","2000 ","24","12","12",
"35 s","Overseas Koreans","2001 ","33","21","12",
"35 s","Overseas Koreans","2002 ","48","31","17",
"35 s","Overseas Koreans","2003 ","32","21","11",
"35 s","Overseas Koreans","2004 ","42","25","17",
"35 s","Overseas Koreans","2005 ","45","27","18",
"35 s","Overseas Koreans","2006 ","57","32","25",
"35 s","Overseas Koreans","2007 ","62","33","29",
"35 s","Overseas Koreans","2008 ","64","31","33",
"35 s","Overseas Koreans","2009 ","62","28","34",
"35 s","Overseas Koreans","2010 ","128","69","59",
"35 s","Overseas Koreans","2011 ","168","93","75",
"35 s","Overseas Koreans","2012 ","194","104","90",
"35 s","Overseas Koreans","2013 ","272","138","134",
"35 s","Overseas Koreans","2014 ","317","166","151",
"35 s","Overseas Koreans","2015 ","420","239","181",
"35 s","Overseas Koreans","2016 ","636","367","269",
"35 s","Overseas Koreans","2017 ","643","393","250",
"35 s","Overseas Koreans","2018 ","703","377","326",
"35 s","Overseas Koreans","2019 ","769","434","335",
"35 s","Permanent Residence","2000 ","0","0","0",
"35 s","Permanent Residence","2001 ","0","0","0",
"35 s","Permanent Residence","2002 ","0","0","0",
"35 s","Permanent Residence","2003 ","0","0","0",
"35 s","Permanent Residence","2004 ","4","3","1",
"35 s","Permanent Residence","2005 ","2","2","0",
"35 s","Permanent Residence","2006 ","4","2","2",
"35 s","Permanent Residence","2007 ","5","1","4",
"35 s","Permanent Residence","2008 ","15","2","13",
"35 s","Permanent Residence","2009 ","12","2","10",
"35 s","Permanent Residence","2010 ","24","9","15",
"35 s","Permanent Residence","2011 ","70","31","39",
"35 s","Permanent Residence","2012 ","83","37","46",
"35 s","Permanent Residence","2013 ","114","46","68",
"35 s","Permanent Residence","2014 ","125","55","70",
"35 s","Permanent Residence","2015 ","130","56","74",
"35 s","Permanent Residence","2016 ","131","56","75",
"35 s","Permanent Residence","2017 ","160","74","86",
"35 s","Permanent Residence","2018 ","133","55","78",
"35 s","Permanent Residence","2019 ","147","68","79",
"35 s","Marriage Immigration","2011 ","14","","14",
"35 s","Marriage Immigration","2012 ","318","39","279",
"35 s","Marriage Immigration","2013 ","292","50","242",
"35 s","Marriage Immigration","2014 ","309","55","254",
"35 s","Marriage Immigration","2015 ","263","52","211",
"35 s","Marriage Immigration","2016 ","289","48","241",
"35 s","Marriage Immigration","2017 ","311","63","248",
"35 s","Marriage Immigration","2018 ","339","63","276",
"35 s","Marriage Immigration","2019 ","396","81","315",
"36 s","Total","2000 ","4229","2629","1600",
"36 s","Total","2001 ","4065","2513","1552",
"36 s","Total","2002 ","3768","2438","1330",
"36 s","Total","2003 ","3762","2693","1069",
"36 s","Total","2004 ","4634","3101","1533",
"36 s","Total","2005 ","6787","4591","2196",
"36 s","Total","2006 ","8548","5809","2739",
"36 s","Total","2007 ","7072","4536","2536",
"36 s","Total","2008 ","6440","4122","2318",
"36 s","Total","2009 ","4700","2948","1752",
"36 s","Total","2010 ","5206","3337","1869",
"36 s","Total","2011 ","5101","3402","1699",
"36 s","Total","2012 ","4792","3105","1687",
"36 s","Total","2013 ","6232","4203","2029",
"36 s","Total","2014 ","6679","4171","2508",
"36 s","Total","2015 ","6344","4004","2340",
"36 s","Total","2016 ","7221","4583","2638",
"36 s","Total","2017 ","8743","5307","3436",
"36 s","Total","2018 ","10034","6011","4023",
"36 s","Total","2019 ","8647","5108","3539",
"36 s","Sightseeing Pass","2000 ","323","206","117",
"36 s","Sightseeing Pass","2001 ","416","277","139",
"36 s","Sightseeing Pass","2002 ","479","311","168",
"36 s","Sightseeing Pass","2003 ","308","216","92",
"36 s","Sightseeing Pass","2004 ","358","235","123",
"36 s","Sightseeing Pass","2005 ","322","208","114",
"36 s","Sightseeing Pass","2006 ","294","162","132",
"36 s","Sightseeing Pass","2007 ","319","187","132",
"36 s","Sightseeing Pass","2008 ","333","210","123",
"36 s","Sightseeing Pass","2009 ","333","184","149",
"36 s","Sightseeing Pass","2010 ","491","296","195",
"36 s","Sightseeing Pass","2011 ","349","183","166",
"36 s","Sightseeing Pass","2012 ","291","144","147",
"36 s","Sightseeing Pass","2013 ","258","149","109",
"36 s","Sightseeing Pass","2014 ","335","177","158",
"36 s","Sightseeing Pass","2015 ","445","260","185",
"36 s","Sightseeing Pass","2016 ","436","256","180",
"36 s","Sightseeing Pass","2017 ","511","315","196",
"36 s","Sightseeing Pass","2018 ","812","526","286",
"36 s","Sightseeing Pass","2019 ","445","223","222",
"36 s","Short-term Business","2000 ","904","527","377",
"36 s","Short-term Business","2001 ","1067","641","426",
"36 s","Short-term Business","2002 ","457","298","159",
"36 s","Short-term Business","2003 ","300","228","72",
"36 s","Short-term Business","2004 ","310","236","74",
"36 s","Short-term Business","2005 ","271","199","72",
"36 s","Short-term Business","2006 ","547","431","116",
"36 s","Short-term Business","2007 ","868","666","202",
"36 s","Short-term Business","2008 ","348","298","50",
"36 s","Short-term Business","2009 ","120","104","16",
"36 s","Short-term Business","2010 ","110","98","12",
"36 s","Short-term Business","2011 ","94","86","8",
"36 s","Short-term Visitors","2000 ","1207","739","468",
"36 s","Short-term Visitors","2001 ","1034","634","400",
"36 s","Short-term Visitors","2002 ","1079","694","385",
"36 s","Short-term Visitors","2003 ","611","378","233",
"36 s","Short-term Visitors","2004 ","578","390","188",
"36 s","Short-term Visitors","2005 ","532","336","196",
"36 s","Short-term Visitors","2006 ","813","512","301",
"36 s","Short-term Visitors","2007 ","584","363","221",
"36 s","Short-term Visitors","2008 ","410","235","175",
"36 s","Short-term Visitors","2009 ","224","114","110",
"36 s","Short-term Visitors","2010 ","633","378","255",
"36 s","Short-term Visitors","2011 ","846","507","339",
"36 s","Short-term Visitors","2012 ","861","533","328",
"36 s","Short-term Visitors","2013 ","1066","683","383",
"36 s","Short-term Visitors","2014 ","700","447","253",
"36 s","Short-term Visitors","2015 ","1061","630","431",
"36 s","Short-term Visitors","2016 ","1031","648","383",
"36 s","Short-term Visitors","2017 ","1144","759","385",
"36 s","Short-term Visitors","2018 ","1349","899","450",
"36 s","Short-term Visitors","2019 ","1483","1009","474",
"36 s","Short-term Employment","2000 ","4","3","1",
"36 s","Short-term Employment","2001 ","2","1","1",
"36 s","Short-term Employment","2002 ","7","5","2",
"36 s","Short-term Employment","2003 ","7","7","0",
"36 s","Short-term Employment","2004 ","4","4","0",
"36 s","Short-term Employment","2005 ","2","1","1",
"36 s","Short-term Employment","2006 ","8","6","2",
"36 s","Short-term Employment","2007 ","7","7","0",
"36 s","Short-term Employment","2008 ","9","6","3",
"36 s","Short-term Employment","2009 ","2","2","0",
"36 s","Short-term Employment","2010 ","2","2","0",
"36 s","Short-term Employment","2011 ","1","1","",
"36 s","Short-term Employment","2012 ","1","1","",
"36 s","Short-term Employment","2014 ","1","1","0",
"36 s","Short-term Employment","2015 ","3","2","1",
"36 s","Short-term Employment","2016 ","20","20","0",
"36 s","Short-term Employment","2017 ","6","2","4",
"36 s","Short-term Employment","2018 ","17","10","7",
"36 s","Short-term Employment","2019 ","9","9","0",
"36 s","Job Seeking","2000 ","0","0","0",
"36 s","Job Seeking","2001 ","0","0","0",
"36 s","Job Seeking","2002 ","0","0","0",
"36 s","Job Seeking","2003 ","0","0","0",
"36 s","Job Seeking","2004 ","0","0","0",
"36 s","Job Seeking","2005 ","0","0","0",
"36 s","Job Seeking","2006 ","0","0","0",
"36 s","Job Seeking","2007 ","0","0","0",
"36 s","Job Seeking","2008 ","0","0","0",
"36 s","Job Seeking","2009 ","0","0","0",
"36 s","Job Seeking","2010 ","0","0","0",
"36 s","Job Seeking","2013 ","2","1","1",
"36 s","Job Seeking","2014 ","1","0","1",
"36 s","Job Seeking","2015 ","3","1","2",
"36 s","Job Seeking","2016 ","2","1","1",
"36 s","Job Seeking","2017 ","1","1","0",
"36 s","Job Seeking","2018 ","3","1","2",
"36 s","Job Seeking","2019 ","7","4","3",
"36 s","study","2000 ","31","23","8",
"36 s","study","2001 ","19","13","6",
"36 s","study","2002 ","25","18","7",
"36 s","study","2003 ","20","16","4",
"36 s","study","2004 ","15","12","3",
"36 s","study","2005 ","28","17","11",
"36 s","study","2006 ","35","21","14",
"36 s","study","2007 ","29","18","11",
"36 s","study","2008 ","36","25","11",
"36 s","study","2009 ","32","23","9",
"36 s","study","2010 ","52","41","11",
"36 s","study","2011 ","43","28","15",
"36 s","study","2012 ","47","37","10",
"36 s","study","2013 ","53","38","15",
"36 s","study","2014 ","63","41","22",
"36 s","study","2015 ","70","51","19",
"36 s","study","2016 ","87","64","23",
"36 s","study","2017 ","82","56","26",
"36 s","study","2018 ","137","73","64",
"36 s","study","2019 ","173","103","70",
"36 s","General Trainees","2000 ","13","12","1",
"36 s","General Trainees","2001 ","15","8","7",
"36 s","General Trainees","2002 ","14","9","5",
"36 s","General Trainees","2003 ","8","4","4",
"36 s","General Trainees","2004 ","14","4","10",
"36 s","General Trainees","2005 ","25","13","12",
"36 s","General Trainees","2006 ","28","12","16",
"36 s","General Trainees","2007 ","23","11","12",
"36 s","General Trainees","2008 ","25","11","14",
"36 s","General Trainees","2009 ","20","11","9",
"36 s","General Trainees","2010 ","40","21","19",
"36 s","General Trainees","2011 ","61","38","23",
"36 s","General Trainees","2012 ","44","25","19",
"36 s","General Trainees","2013 ","40","18","22",
"36 s","General Trainees","2014 ","45","30","15",
"36 s","General Trainees","2015 ","73","46","27",
"36 s","General Trainees","2016 ","55","29","26",
"36 s","General Trainees","2017 ","58","33","25",
"36 s","General Trainees","2018 ","61","27","34",
"36 s","General Trainees","2019 ","48","27","21",
"36 s","Religious Activities","2000 ","8","6","2",
"36 s","Religious Activities","2001 ","11","6","5",
"36 s","Religious Activities","2002 ","5","1","4",
"36 s","Religious Activities","2003 ","4","3","1",
"36 s","Religious Activities","2004 ","7","6","1",
"36 s","Religious Activities","2005 ","11","8","3",
"36 s","Religious Activities","2006 ","13","6","7",
"36 s","Religious Activities","2007 ","21","18","3",
"36 s","Religious Activities","2008 ","7","3","4",
"36 s","Religious Activities","2009 ","11","7","4",
"36 s","Religious Activities","2010 ","6","3","3",
"36 s","Religious Activities","2011 ","8","4","4",
"36 s","Religious Activities","2012 ","7","4","3",
"36 s","Religious Activities","2013 ","8","3","5",
"36 s","Religious Activities","2014 ","5","2","3",
"36 s","Religious Activities","2015 ","8","6","2",
"36 s","Religious Activities","2016 ","3","3","0",
"36 s","Religious Activities","2017 ","8","4","4",
"36 s","Religious Activities","2018 ","8","6","2",
"36 s","Religious Activities","2019 ","7","5","2",
"36 s","Investors","2000 ","98","54","44",
"36 s","Investors","2001 ","63","39","24",
"36 s","Investors","2002 ","30","29","1",
"36 s","Investors","2003 ","34","32","2",
"36 s","Investors","2004 ","50","43","7",
"36 s","Investors","2005 ","64","57","7",
"36 s","Investors","2006 ","47","40","7",
"36 s","Investors","2007 ","44","42","2",
"36 s","Investors","2008 ","52","47","5",
"36 s","Investors","2009 ","39","38","1",
"36 s","Investors","2010 ","42","39","3",
"36 s","Investors","2011 ","35","31","4",
"36 s","Investors","2012 ","19","19","",
"36 s","Investors","2013 ","39","36","3",
"36 s","Investors","2014 ","20","19","1",
"36 s","Investors","2015 ","17","15","2",
"36 s","Investors","2016 ","38","33","5",
"36 s","Investors","2017 ","11","9","2",
"36 s","Investors","2018 ","22","19","3",
"36 s","Investors","2019 ","21","19","2",
"36 s","Trade and Business","2000 ","13","12","1",
"36 s","Trade and Business","2001 ","21","21","0",
"36 s","Trade and Business","2002 ","12","12","0",
"36 s","Trade and Business","2003 ","13","13","0",
"36 s","Trade and Business","2004 ","14","14","0",
"36 s","Trade and Business","2005 ","16","16","0",
"36 s","Trade and Business","2006 ","12","12","0",
"36 s","Trade and Business","2007 ","21","20","1",
"36 s","Trade and Business","2008 ","26","26","0",
"36 s","Trade and Business","2009 ","24","22","2",
"36 s","Trade and Business","2010 ","27","27","0",
"36 s","Trade and Business","2011 ","41","40","1",
"36 s","Trade and Business","2012 ","35","35","",
"36 s","Trade and Business","2013 ","62","57","5",
"36 s","Trade and Business","2014 ","55","52","3",
"36 s","Trade and Business","2015 ","56","54","2",
"36 s","Trade and Business","2016 ","44","39","5",
"36 s","Trade and Business","2017 ","27","25","2",
"36 s","Trade and Business","2018 ","18","16","2",
"36 s","Trade and Business","2019 ","22","21","1",
"36 s","Research","2000 ","26","23","3",
"36 s","Research","2001 ","22","22","0",
"36 s","Research","2002 ","28","24","4",
"36 s","Research","2003 ","16","15","1",
"36 s","Research","2004 ","23","18","5",
"36 s","Research","2005 ","23","17","6",
"36 s","Research","2006 ","19","13","6",
"36 s","Research","2007 ","28","21","7",
"36 s","Research","2008 ","18","16","2",
"36 s","Research","2009 ","13","11","2",
"36 s","Research","2010 ","22","21","1",
"36 s","Research","2011 ","19","19","",
"36 s","Research","2012 ","25","23","2",
"36 s","Research","2013 ","31","25","6",
"36 s","Research","2014 ","15","15","0",
"36 s","Research","2015 ","31","27","4",
"36 s","Research","2016 ","26","23","3",
"36 s","Research","2017 ","17","14","3",
"36 s","Research","2018 ","27","21","6",
"36 s","Research","2019 ","33","26","7",
"36 s","Art and Entertainment","2000 ","33","22","11",
"36 s","Art and Entertainment","2001 ","24","15","9",
"36 s","Art and Entertainment","2002 ","33","26","7",
"36 s","Art and Entertainment","2003 ","21","12","9",
"36 s","Art and Entertainment","2004 ","34","18","16",
"36 s","Art and Entertainment","2005 ","31","23","8",
"36 s","Art and Entertainment","2006 ","32","20","12",
"36 s","Art and Entertainment","2007 ","30","18","12",
"36 s","Art and Entertainment","2008 ","35","16","19",
"36 s","Art and Entertainment","2009 ","28","15","13",
"36 s","Art and Entertainment","2010 ","33","10","23",
"36 s","Art and Entertainment","2011 ","23","9","14",
"36 s","Art and Entertainment","2012 ","31","7","24",
"36 s","Art and Entertainment","2013 ","32","10","22",
"36 s","Art and Entertainment","2014 ","32","10","22",
"36 s","Art and Entertainment","2015 ","23","7","16",
"36 s","Art and Entertainment","2016 ","17","11","6",
"36 s","Art and Entertainment","2017 ","16","9","7",
"36 s","Art and Entertainment","2018 ","15","8","7",
"36 s","Art and Entertainment","2019 ","12","8","4",
"36 s","Unskilled Employment","2000 ","0","0","0",
"36 s","Unskilled Employment","2001 ","0","0","0",
"36 s","Unskilled Employment","2002 ","0","0","0",
"36 s","Unskilled Employment","2003 ","49","29","20",
"36 s","Unskilled Employment","2004 ","193","152","41",
"36 s","Unskilled Employment","2005 ","980","884","96",
"36 s","Unskilled Employment","2006 ","976","878","98",
"36 s","Unskilled Employment","2007 ","711","671","40",
"36 s","Unskilled Employment","2008 ","1190","1087","103",
"36 s","Unskilled Employment","2009 ","682","646","36",
"36 s","Unskilled Employment","2010 ","839","801","38",
"36 s","Unskilled Employment","2011 ","1177","1130","47",
"36 s","Unskilled Employment","2012 ","1105","1040","65",
"36 s","Unskilled Employment","2013 ","1698","1594","104",
"36 s","Unskilled Employment","2014 ","887","841","46",
"36 s","Unskilled Employment","2015 ","1156","1101","55",
"36 s","Unskilled Employment","2016 ","1429","1355","74",
"36 s","Unskilled Employment","2017 ","1380","1294","86",
"36 s","Unskilled Employment","2018 ","1248","1189","59",
"36 s","Unskilled Employment","2019 ","1180","1143","37",
"36 s","Visiting and Joining Family","2000 ","141","3","138",
"36 s","Visiting and Joining Family","2001 ","260","18","242",
"36 s","Visiting and Joining Family","2002 ","170","12","158",
"36 s","Visiting and Joining Family","2003 ","141","76","65",
"36 s","Visiting and Joining Family","2004 ","482","286","196",
"36 s","Visiting and Joining Family","2005 ","1638","838","800",
"36 s","Visiting and Joining Family","2006 ","2795","1574","1221",
"36 s","Visiting and Joining Family","2007 ","417","224","193",
"36 s","Visiting and Joining Family","2008 ","31","13","18",
"36 s","Visiting and Joining Family","2009 ","38","16","22",
"36 s","Visiting and Joining Family","2010 ","62","24","38",
"36 s","Visiting and Joining Family","2011 ","49","25","24",
"36 s","Visiting and Joining Family","2012 ","23","8","15",
"36 s","Visiting and Joining Family","2013 ","22","6","16",
"36 s","Visiting and Joining Family","2014 ","50","13","37",
"36 s","Visiting and Joining Family","2015 ","82","15","67",
"36 s","Visiting and Joining Family","2016 ","207","55","152",
"36 s","Visiting and Joining Family","2017 ","169","57","112",
"36 s","Visiting and Joining Family","2018 ","201","55","146",
"36 s","Visiting and Joining Family","2019 ","206","57","149",
"36 s","Overseas Koreans","2000 ","21","12","9",
"36 s","Overseas Koreans","2001 ","16","10","6",
"36 s","Overseas Koreans","2002 ","33","23","10",
"36 s","Overseas Koreans","2003 ","34","22","12",
"36 s","Overseas Koreans","2004 ","28","17","11",
"36 s","Overseas Koreans","2005 ","45","26","19",
"36 s","Overseas Koreans","2006 ","51","26","25",
"36 s","Overseas Koreans","2007 ","74","45","29",
"36 s","Overseas Koreans","2008 ","64","37","27",
"36 s","Overseas Koreans","2009 ","68","33","35",
"36 s","Overseas Koreans","2010 ","139","69","70",
"36 s","Overseas Koreans","2011 ","169","99","70",
"36 s","Overseas Koreans","2012 ","176","89","87",
"36 s","Overseas Koreans","2013 ","250","132","118",
"36 s","Overseas Koreans","2014 ","268","142","126",
"36 s","Overseas Koreans","2015 ","425","248","177",
"36 s","Overseas Koreans","2016 ","631","359","272",
"36 s","Overseas Koreans","2017 ","571","316","255",
"36 s","Overseas Koreans","2018 ","671","370","301",
"36 s","Overseas Koreans","2019 ","759","419","340",
"36 s","Permanent Residence","2000 ","0","0","0",
"36 s","Permanent Residence","2001 ","0","0","0",
"36 s","Permanent Residence","2002 ","1","0","1",
"36 s","Permanent Residence","2003 ","4","2","2",
"36 s","Permanent Residence","2004 ","3","3","0",
"36 s","Permanent Residence","2005 ","4","2","2",
"36 s","Permanent Residence","2006 ","2","2","0",
"36 s","Permanent Residence","2007 ","5","1","4",
"36 s","Permanent Residence","2008 ","11","5","6",
"36 s","Permanent Residence","2009 ","15","4","11",
"36 s","Permanent Residence","2010 ","23","7","16",
"36 s","Permanent Residence","2011 ","77","25","52",
"36 s","Permanent Residence","2012 ","85","34","51",
"36 s","Permanent Residence","2013 ","90","36","54",
"36 s","Permanent Residence","2014 ","112","48","64",
"36 s","Permanent Residence","2015 ","139","70","69",
"36 s","Permanent Residence","2016 ","136","50","86",
"36 s","Permanent Residence","2017 ","125","52","73",
"36 s","Permanent Residence","2018 ","149","54","95",
"36 s","Permanent Residence","2019 ","135","64","71",
"36 s","Marriage Immigration","2011 ","11","3","8",
"36 s","Marriage Immigration","2012 ","263","34","229",
"36 s","Marriage Immigration","2013 ","277","38","239",
"36 s","Marriage Immigration","2014 ","251","47","204",
"36 s","Marriage Immigration","2015 ","225","39","186",
"36 s","Marriage Immigration","2016 ","250","55","195",
"36 s","Marriage Immigration","2017 ","255","52","203",
"36 s","Marriage Immigration","2018 ","309","61","248",
"36 s","Marriage Immigration","2019 ","353","74","279",
"37 s","Total","2000 ","4132","2613","1519",
"37 s","Total","2001 ","4064","2456","1608",
"37 s","Total","2002 ","3605","2346","1259",
"37 s","Total","2003 ","3756","2604","1152",
"37 s","Total","2004 ","3970","2622","1348",
"37 s","Total","2005 ","6074","4069","2005",
"37 s","Total","2006 ","8072","5289","2783",
"37 s","Total","2007 ","6662","4080","2582",
"37 s","Total","2008 ","6344","3961","2383",
"37 s","Total","2009 ","4645","2842","1803",
"37 s","Total","2010 ","5387","3386","2001",
"37 s","Total","2011 ","5177","3398","1779",
"37 s","Total","2012 ","4504","2867","1637",
"37 s","Total","2013 ","5994","4048","1946",
"37 s","Total","2014 ","6350","3931","2419",
"37 s","Total","2015 ","5807","3740","2067",
"37 s","Total","2016 ","6740","4226","2514",
"37 s","Total","2017 ","8552","5182","3370",
"37 s","Total","2018 ","9064","5387","3677",
"37 s","Total","2019 ","8282","4785","3497",
"37 s","Sightseeing Pass","2000 ","298","189","109",
"37 s","Sightseeing Pass","2001 ","401","260","141",
"37 s","Sightseeing Pass","2002 ","420","295","125",
"37 s","Sightseeing Pass","2003 ","299","195","104",
"37 s","Sightseeing Pass","2004 ","294","191","103",
"37 s","Sightseeing Pass","2005 ","347","227","120",
"37 s","Sightseeing Pass","2006 ","287","171","116",
"37 s","Sightseeing Pass","2007 ","312","192","120",
"37 s","Sightseeing Pass","2008 ","364","221","143",
"37 s","Sightseeing Pass","2009 ","333","190","143",
"37 s","Sightseeing Pass","2010 ","490","310","180",
"37 s","Sightseeing Pass","2011 ","354","192","162",
"37 s","Sightseeing Pass","2012 ","362","180","182",
"37 s","Sightseeing Pass","2013 ","277","145","132",
"37 s","Sightseeing Pass","2014 ","300","160","140",
"37 s","Sightseeing Pass","2015 ","434","276","158",
"37 s","Sightseeing Pass","2016 ","387","227","160",
"37 s","Sightseeing Pass","2017 ","438","274","164",
"37 s","Sightseeing Pass","2018 ","694","449","245",
"37 s","Sightseeing Pass","2019 ","458","209","249",
"37 s","Short-term Business","2000 ","999","604","395",
"37 s","Short-term Business","2001 ","1173","728","445",
"37 s","Short-term Business","2002 ","457","305","152",
"37 s","Short-term Business","2003 ","322","243","79",
"37 s","Short-term Business","2004 ","252","186","66",
"37 s","Short-term Business","2005 ","249","192","57",
"37 s","Short-term Business","2006 ","577","419","158",
"37 s","Short-term Business","2007 ","768","578","190",
"37 s","Short-term Business","2008 ","380","302","78",
"37 s","Short-term Business","2009 ","96","78","18",
"37 s","Short-term Business","2010 ","110","98","12",
"37 s","Short-term Business","2011 ","77","67","10",
"37 s","Short-term Visitors","2000 ","1257","760","497",
"37 s","Short-term Visitors","2001 ","1089","652","437",
"37 s","Short-term Visitors","2002 ","1096","718","378",
"37 s","Short-term Visitors","2003 ","613","401","212",
"37 s","Short-term Visitors","2004 ","510","356","154",
"37 s","Short-term Visitors","2005 ","529","333","196",
"37 s","Short-term Visitors","2006 ","723","481","242",
"37 s","Short-term Visitors","2007 ","562","339","223",
"37 s","Short-term Visitors","2008 ","380","218","162",
"37 s","Short-term Visitors","2009 ","218","112","106",
"37 s","Short-term Visitors","2010 ","748","434","314",
"37 s","Short-term Visitors","2011 ","963","571","392",
"37 s","Short-term Visitors","2012 ","794","493","301",
"37 s","Short-term Visitors","2013 ","1077","677","400",
"37 s","Short-term Visitors","2014 ","721","442","279",
"37 s","Short-term Visitors","2015 ","982","594","388",
"37 s","Short-term Visitors","2016 ","1049","667","382",
"37 s","Short-term Visitors","2017 ","1215","815","400",
"37 s","Short-term Visitors","2018 ","1159","728","431",
"37 s","Short-term Visitors","2019 ","1390","922","468",
"37 s","Short-term Employment","2000 ","4","4","0",
"37 s","Short-term Employment","2001 ","3","3","0",
"37 s","Short-term Employment","2002 ","6","3","3",
"37 s","Short-term Employment","2003 ","6","4","2",
"37 s","Short-term Employment","2004 ","6","5","1",
"37 s","Short-term Employment","2005 ","6","3","3",
"37 s","Short-term Employment","2006 ","4","3","1",
"37 s","Short-term Employment","2007 ","7","5","2",
"37 s","Short-term Employment","2008 ","2","2","0",
"37 s","Short-term Employment","2009 ","4","3","1",
"37 s","Short-term Employment","2010 ","0","0","0",
"37 s","Short-term Employment","2011 ","1","1","",
"37 s","Short-term Employment","2012 ","1","1","",
"37 s","Short-term Employment","2013 ","3","2","1",
"37 s","Short-term Employment","2014 ","3","3","0",
"37 s","Short-term Employment","2015 ","1","1","0",
"37 s","Short-term Employment","2016 ","19","19","0",
"37 s","Short-term Employment","2017 ","10","8","2",
"37 s","Short-term Employment","2018 ","11","6","5",
"37 s","Short-term Employment","2019 ","8","8","0",
"37 s","Job Seeking","2000 ","0","0","0",
"37 s","Job Seeking","2001 ","0","0","0",
"37 s","Job Seeking","2002 ","0","0","0",
"37 s","Job Seeking","2003 ","0","0","0",
"37 s","Job Seeking","2004 ","0","0","0",
"37 s","Job Seeking","2005 ","0","0","0",
"37 s","Job Seeking","2006 ","0","0","0",
"37 s","Job Seeking","2007 ","0","0","0",
"37 s","Job Seeking","2008 ","0","0","0",
"37 s","Job Seeking","2009 ","0","0","0",
"37 s","Job Seeking","2010 ","0","0","0",
"37 s","Job Seeking","2012 ","2","2","",
"37 s","Job Seeking","2013 ","1","0","1",
"37 s","Job Seeking","2015 ","2","1","1",
"37 s","Job Seeking","2016 ","2","2","0",
"37 s","Job Seeking","2017 ","2","2","0",
"37 s","Job Seeking","2018 ","4","3","1",
"37 s","Job Seeking","2019 ","5","5","0",
"37 s","study","2000 ","25","22","3",
"37 s","study","2001 ","20","14","6",
"37 s","study","2002 ","20","14","6",
"37 s","study","2003 ","29","24","5",
"37 s","study","2004 ","29","20","9",
"37 s","study","2005 ","23","17","6",
"37 s","study","2006 ","24","11","13",
"37 s","study","2007 ","22","16","6",
"37 s","study","2008 ","22","15","7",
"37 s","study","2009 ","31","18","13",
"37 s","study","2010 ","28","21","7",
"37 s","study","2011 ","32","21","11",
"37 s","study","2012 ","29","21","8",
"37 s","study","2013 ","39","28","11",
"37 s","study","2014 ","45","30","15",
"37 s","study","2015 ","66","44","22",
"37 s","study","2016 ","68","47","21",
"37 s","study","2017 ","88","55","33",
"37 s","study","2018 ","111","70","41",
"37 s","study","2019 ","175","102","73",
"37 s","General Trainees","2000 ","6","6","0",
"37 s","General Trainees","2001 ","7","3","4",
"37 s","General Trainees","2002 ","8","6","2",
"37 s","General Trainees","2003 ","7","6","1",
"37 s","General Trainees","2004 ","14","8","6",
"37 s","General Trainees","2005 ","11","7","4",
"37 s","General Trainees","2006 ","10","4","6",
"37 s","General Trainees","2007 ","18","7","11",
"37 s","General Trainees","2008 ","20","11","9",
"37 s","General Trainees","2009 ","25","14","11",
"37 s","General Trainees","2010 ","35","16","19",
"37 s","General Trainees","2011 ","61","40","21",
"37 s","General Trainees","2012 ","36","23","13",
"37 s","General Trainees","2013 ","30","19","11",
"37 s","General Trainees","2014 ","40","21","19",
"37 s","General Trainees","2015 ","43","29","14",
"37 s","General Trainees","2016 ","37","17","20",
"37 s","General Trainees","2017 ","33","15","18",
"37 s","General Trainees","2018 ","31","18","13",
"37 s","General Trainees","2019 ","45","22","23",
"37 s","Religious Activities","2000 ","9","6","3",
"37 s","Religious Activities","2001 ","7","3","4",
"37 s","Religious Activities","2002 ","8","4","4",
"37 s","Religious Activities","2003 ","9","6","3",
"37 s","Religious Activities","2004 ","3","1","2",
"37 s","Religious Activities","2005 ","7","5","2",
"37 s","Religious Activities","2006 ","7","5","2",
"37 s","Religious Activities","2007 ","8","5","3",
"37 s","Religious Activities","2008 ","11","7","4",
"37 s","Religious Activities","2009 ","4","2","2",
"37 s","Religious Activities","2010 ","10","6","4",
"37 s","Religious Activities","2011 ","7","5","2",
"37 s","Religious Activities","2012 ","4","1","3",
"37 s","Religious Activities","2013 ","6","4","2",
"37 s","Religious Activities","2014 ","5","3","2",
"37 s","Religious Activities","2015 ","6","3","3",
"37 s","Religious Activities","2016 ","10","5","5",
"37 s","Religious Activities","2017 ","6","5","1",
"37 s","Religious Activities","2018 ","4","4","0",
"37 s","Religious Activities","2019 ","8","5","3",
"37 s","Investors","2000 ","111","59","52",
"37 s","Investors","2001 ","82","56","26",
"37 s","Investors","2002 ","45","41","4",
"37 s","Investors","2003 ","40","37","3",
"37 s","Investors","2004 ","46","41","5",
"37 s","Investors","2005 ","73","59","14",
"37 s","Investors","2006 ","46","40","6",
"37 s","Investors","2007 ","41","39","2",
"37 s","Investors","2008 ","44","43","1",
"37 s","Investors","2009 ","41","36","5",
"37 s","Investors","2010 ","43","38","5",
"37 s","Investors","2011 ","30","28","2",
"37 s","Investors","2012 ","44","41","3",
"37 s","Investors","2013 ","36","35","1",
"37 s","Investors","2014 ","27","25","2",
"37 s","Investors","2015 ","26","21","5",
"37 s","Investors","2016 ","14","14","0",
"37 s","Investors","2017 ","21","20","1",
"37 s","Investors","2018 ","25","23","2",
"37 s","Investors","2019 ","23","20","3",
"37 s","Trade and Business","2000 ","11","11","0",
"37 s","Trade and Business","2001 ","14","14","0",
"37 s","Trade and Business","2002 ","14","14","0",
"37 s","Trade and Business","2003 ","18","17","1",
"37 s","Trade and Business","2004 ","15","14","1",
"37 s","Trade and Business","2005 ","24","24","0",
"37 s","Trade and Business","2006 ","15","15","0",
"37 s","Trade and Business","2007 ","15","15","0",
"37 s","Trade and Business","2008 ","23","22","1",
"37 s","Trade and Business","2009 ","21","21","0",
"37 s","Trade and Business","2010 ","28","27","1",
"37 s","Trade and Business","2011 ","29","28","1",
"37 s","Trade and Business","2012 ","40","40","",
"37 s","Trade and Business","2013 ","52","50","2",
"37 s","Trade and Business","2014 ","54","53","1",
"37 s","Trade and Business","2015 ","50","48","2",
"37 s","Trade and Business","2016 ","48","46","2",
"37 s","Trade and Business","2017 ","31","29","2",
"37 s","Trade and Business","2018 ","22","21","1",
"37 s","Trade and Business","2019 ","15","14","1",
"37 s","Research","2000 ","22","17","5",
"37 s","Research","2001 ","31","25","6",
"37 s","Research","2002 ","22","16","6",
"37 s","Research","2003 ","21","20","1",
"37 s","Research","2004 ","33","31","2",
"37 s","Research","2005 ","21","14","7",
"37 s","Research","2006 ","17","14","3",
"37 s","Research","2007 ","26","25","1",
"37 s","Research","2008 ","9","7","2",
"37 s","Research","2009 ","16","16","0",
"37 s","Research","2010 ","18","14","4",
"37 s","Research","2011 ","15","11","4",
"37 s","Research","2012 ","21","16","5",
"37 s","Research","2013 ","29","24","5",
"37 s","Research","2014 ","27","22","5",
"37 s","Research","2015 ","27","23","4",
"37 s","Research","2016 ","23","23","0",
"37 s","Research","2017 ","24","22","2",
"37 s","Research","2018 ","36","33","3",
"37 s","Research","2019 ","19","16","3",
"37 s","Art and Entertainment","2000 ","27","23","4",
"37 s","Art and Entertainment","2001 ","23","17","6",
"37 s","Art and Entertainment","2002 ","18","13","5",
"37 s","Art and Entertainment","2003 ","30","23","7",
"37 s","Art and Entertainment","2004 ","31","20","11",
"37 s","Art and Entertainment","2005 ","29","17","12",
"37 s","Art and Entertainment","2006 ","32","19","13",
"37 s","Art and Entertainment","2007 ","27","12","15",
"37 s","Art and Entertainment","2008 ","32","11","21",
"37 s","Art and Entertainment","2009 ","22","8","14",
"37 s","Art and Entertainment","2010 ","21","8","13",
"37 s","Art and Entertainment","2011 ","27","10","17",
"37 s","Art and Entertainment","2012 ","25","12","13",
"37 s","Art and Entertainment","2013 ","29","14","15",
"37 s","Art and Entertainment","2014 ","27","14","13",
"37 s","Art and Entertainment","2015 ","19","11","8",
"37 s","Art and Entertainment","2016 ","20","8","12",
"37 s","Art and Entertainment","2017 ","11","10","1",
"37 s","Art and Entertainment","2018 ","18","8","10",
"37 s","Art and Entertainment","2019 ","21","10","11",
"37 s","Unskilled Employment","2000 ","0","0","0",
"37 s","Unskilled Employment","2001 ","0","0","0",
"37 s","Unskilled Employment","2002 ","0","0","0",
"37 s","Unskilled Employment","2003 ","52","31","21",
"37 s","Unskilled Employment","2004 ","146","112","34",
"37 s","Unskilled Employment","2005 ","801","730","71",
"37 s","Unskilled Employment","2006 ","764","684","80",
"37 s","Unskilled Employment","2007 ","544","512","32",
"37 s","Unskilled Employment","2008 ","1024","966","58",
"37 s","Unskilled Employment","2009 ","565","522","43",
"37 s","Unskilled Employment","2010 ","726","693","33",
"37 s","Unskilled Employment","2011 ","1053","1012","41",
"37 s","Unskilled Employment","2012 ","917","861","56",
"37 s","Unskilled Employment","2013 ","1485","1397","88",
"37 s","Unskilled Employment","2014 ","796","759","37",
"37 s","Unskilled Employment","2015 ","1033","988","45",
"37 s","Unskilled Employment","2016 ","1202","1153","49",
"37 s","Unskilled Employment","2017 ","1244","1161","83",
"37 s","Unskilled Employment","2018 ","1030","995","35",
"37 s","Unskilled Employment","2019 ","1008","982","26",
"37 s","Visiting and Joining Family","2000 ","155","13","142",
"37 s","Visiting and Joining Family","2001 ","264","7","257",
"37 s","Visiting and Joining Family","2002 ","173","8","165",
"37 s","Visiting and Joining Family","2003 ","177","91","86",
"37 s","Visiting and Joining Family","2004 ","413","223","190",
"37 s","Visiting and Joining Family","2005 ","1608","897","711",
"37 s","Visiting and Joining Family","2006 ","2874","1591","1283",
"37 s","Visiting and Joining Family","2007 ","407","231","176",
"37 s","Visiting and Joining Family","2008 ","33","15","18",
"37 s","Visiting and Joining Family","2009 ","34","16","18",
"37 s","Visiting and Joining Family","2010 ","74","34","40",
"37 s","Visiting and Joining Family","2011 ","62","30","32",
"37 s","Visiting and Joining Family","2012 ","37","15","22",
"37 s","Visiting and Joining Family","2013 ","14","3","11",
"37 s","Visiting and Joining Family","2014 ","34","10","24",
"37 s","Visiting and Joining Family","2015 ","58","12","46",
"37 s","Visiting and Joining Family","2016 ","192","60","132",
"37 s","Visiting and Joining Family","2017 ","160","44","116",
"37 s","Visiting and Joining Family","2018 ","183","57","126",
"37 s","Visiting and Joining Family","2019 ","223","66","157",
"37 s","Overseas Koreans","2000 ","24","11","13",
"37 s","Overseas Koreans","2001 ","32","23","9",
"37 s","Overseas Koreans","2002 ","40","24","16",
"37 s","Overseas Koreans","2003 ","33","19","14",
"37 s","Overseas Koreans","2004 ","44","26","18",
"37 s","Overseas Koreans","2005 ","28","12","16",
"37 s","Overseas Koreans","2006 ","36","20","16",
"37 s","Overseas Koreans","2007 ","42","23","19",
"37 s","Overseas Koreans","2008 ","56","35","21",
"37 s","Overseas Koreans","2009 ","76","44","32",
"37 s","Overseas Koreans","2010 ","134","81","53",
"37 s","Overseas Koreans","2011 ","166","97","69",
"37 s","Overseas Koreans","2012 ","192","102","90",
"37 s","Overseas Koreans","2013 ","229","128","101",
"37 s","Overseas Koreans","2014 ","258","145","113",
"37 s","Overseas Koreans","2015 ","417","240","177",
"37 s","Overseas Koreans","2016 ","573","340","233",
"37 s","Overseas Koreans","2017 ","608","348","260",
"37 s","Overseas Koreans","2018 ","664","359","305",
"37 s","Overseas Koreans","2019 ","732","406","326",
"37 s","Permanent Residence","2000 ","0","0","0",
"37 s","Permanent Residence","2001 ","0","0","0",
"37 s","Permanent Residence","2002 ","0","0","0",
"37 s","Permanent Residence","2003 ","5","2","3",
"37 s","Permanent Residence","2004 ","2","2","0",
"37 s","Permanent Residence","2005 ","1","1","0",
"37 s","Permanent Residence","2006 ","1","1","0",
"37 s","Permanent Residence","2007 ","5","3","2",
"37 s","Permanent Residence","2008 ","9","1","8",
"37 s","Permanent Residence","2009 ","13","2","11",
"37 s","Permanent Residence","2010 ","42","19","23",
"37 s","Permanent Residence","2011 ","56","24","32",
"37 s","Permanent Residence","2012 ","71","27","44",
"37 s","Permanent Residence","2013 ","98","48","50",
"37 s","Permanent Residence","2014 ","101","33","68",
"37 s","Permanent Residence","2015 ","120","56","64",
"37 s","Permanent Residence","2016 ","133","58","75",
"37 s","Permanent Residence","2017 ","138","65","73",
"37 s","Permanent Residence","2018 ","127","59","68",
"37 s","Permanent Residence","2019 ","153","60","93",
"37 s","Marriage Immigration","2011 ","8","1","7",
"37 s","Marriage Immigration","2012 ","264","41","223",
"37 s","Marriage Immigration","2013 ","264","44","220",
"37 s","Marriage Immigration","2014 ","217","47","170",
"37 s","Marriage Immigration","2015 ","199","44","155",
"37 s","Marriage Immigration","2016 ","207","53","154",
"37 s","Marriage Immigration","2017 ","221","43","178",
"37 s","Marriage Immigration","2018 ","248","58","190",
"37 s","Marriage Immigration","2019 ","309","72","237",
"38 s","Total","2000 ","3060","1868","1192",
"38 s","Total","2001 ","4118","2454","1664",
"38 s","Total","2002 ","3692","2381","1311",
"38 s","Total","2003 ","3582","2479","1103",
"38 s","Total","2004 ","4088","2612","1476",
"38 s","Total","2005 ","5141","3313","1828",
"38 s","Total","2006 ","6839","4496","2343",
"38 s","Total","2007 ","6188","3811","2377",
"38 s","Total","2008 ","5991","3664","2327",
"38 s","Total","2009 ","4813","2867","1946",
"38 s","Total","2010 ","5414","3375","2039",
"38 s","Total","2011 ","4991","3156","1835",
"38 s","Total","2012 ","4232","2639","1593",
"38 s","Total","2013 ","5393","3525","1868",
"38 s","Total","2014 ","6284","3843","2441",
"38 s","Total","2015 ","5162","3202","1960",
"38 s","Total","2016 ","6032","3700","2332",
"38 s","Total","2017 ","7929","4789","3140",
"38 s","Total","2018 ","8800","5217","3583",
"38 s","Total","2019 ","7143","4152","2991",
"38 s","Sightseeing Pass","2000 ","229","140","89",
"38 s","Sightseeing Pass","2001 ","396","279","117",
"38 s","Sightseeing Pass","2002 ","448","296","152",
"38 s","Sightseeing Pass","2003 ","313","204","109",
"38 s","Sightseeing Pass","2004 ","321","207","114",
"38 s","Sightseeing Pass","2005 ","278","147","131",
"38 s","Sightseeing Pass","2006 ","277","171","106",
"38 s","Sightseeing Pass","2007 ","303","196","107",
"38 s","Sightseeing Pass","2008 ","336","230","106",
"38 s","Sightseeing Pass","2009 ","361","241","120",
"38 s","Sightseeing Pass","2010 ","500","292","208",
"38 s","Sightseeing Pass","2011 ","319","157","162",
"38 s","Sightseeing Pass","2012 ","301","160","141",
"38 s","Sightseeing Pass","2013 ","288","160","128",
"38 s","Sightseeing Pass","2014 ","317","174","143",
"38 s","Sightseeing Pass","2015 ","381","221","160",
"38 s","Sightseeing Pass","2016 ","371","209","162",
"38 s","Sightseeing Pass","2017 ","447","264","183",
"38 s","Sightseeing Pass","2018 ","806","521","285",
"38 s","Sightseeing Pass","2019 ","444","223","221",
"38 s","Short-term Business","2000 ","708","413","295",
"38 s","Short-term Business","2001 ","1233","742","491",
"38 s","Short-term Business","2002 ","501","323","178",
"38 s","Short-term Business","2003 ","304","236","68",
"38 s","Short-term Business","2004 ","285","211","74",
"38 s","Short-term Business","2005 ","237","188","49",
"38 s","Short-term Business","2006 ","511","383","128",
"38 s","Short-term Business","2007 ","676","527","149",
"38 s","Short-term Business","2008 ","392","313","79",
"38 s","Short-term Business","2009 ","123","101","22",
"38 s","Short-term Business","2010 ","103","91","12",
"38 s","Short-term Business","2011 ","75","65","10",
"38 s","Short-term Visitors","2000 ","958","592","366",
"38 s","Short-term Visitors","2001 ","1138","688","450",
"38 s","Short-term Visitors","2002 ","1252","806","446",
"38 s","Short-term Visitors","2003 ","622","379","243",
"38 s","Short-term Visitors","2004 ","491","327","164",
"38 s","Short-term Visitors","2005 ","476","289","187",
"38 s","Short-term Visitors","2006 ","655","436","219",
"38 s","Short-term Visitors","2007 ","561","320","241",
"38 s","Short-term Visitors","2008 ","388","201","187",
"38 s","Short-term Visitors","2009 ","239","104","135",
"38 s","Short-term Visitors","2010 ","846","478","368",
"38 s","Short-term Visitors","2011 ","1053","606","447",
"38 s","Short-term Visitors","2012 ","818","479","339",
"38 s","Short-term Visitors","2013 ","1012","637","375",
"38 s","Short-term Visitors","2014 ","790","486","304",
"38 s","Short-term Visitors","2015 ","890","509","381",
"38 s","Short-term Visitors","2016 ","1012","630","382",
"38 s","Short-term Visitors","2017 ","1216","800","416",
"38 s","Short-term Visitors","2018 ","1220","780","440",
"38 s","Short-term Visitors","2019 ","1261","845","416",
"38 s","Short-term Employment","2000 ","2","1","1",
"38 s","Short-term Employment","2001 ","2","2","0",
"38 s","Short-term Employment","2002 ","7","6","1",
"38 s","Short-term Employment","2003 ","5","5","0",
"38 s","Short-term Employment","2004 ","9","7","2",
"38 s","Short-term Employment","2005 ","5","4","1",
"38 s","Short-term Employment","2006 ","4","4","0",
"38 s","Short-term Employment","2007 ","11","8","3",
"38 s","Short-term Employment","2008 ","6","6","0",
"38 s","Short-term Employment","2009 ","3","3","0",
"38 s","Short-term Employment","2010 ","3","3","0",
"38 s","Short-term Employment","2011 ","1","","1",
"38 s","Short-term Employment","2012 ","6","5","1",
"38 s","Short-term Employment","2013 ","2","2","0",
"38 s","Short-term Employment","2015 ","3","3","0",
"38 s","Short-term Employment","2016 ","12","11","1",
"38 s","Short-term Employment","2017 ","3","3","0",
"38 s","Short-term Employment","2018 ","15","12","3",
"38 s","Short-term Employment","2019 ","6","3","3",
"38 s","Job Seeking","2000 ","0","0","0",
"38 s","Job Seeking","2001 ","0","0","0",
"38 s","Job Seeking","2002 ","0","0","0",
"38 s","Job Seeking","2003 ","0","0","0",
"38 s","Job Seeking","2004 ","0","0","0",
"38 s","Job Seeking","2005 ","0","0","0",
"38 s","Job Seeking","2006 ","0","0","0",
"38 s","Job Seeking","2007 ","0","0","0",
"38 s","Job Seeking","2008 ","0","0","0",
"38 s","Job Seeking","2009 ","0","0","0",
"38 s","Job Seeking","2010 ","0","0","0",
"38 s","Job Seeking","2015 ","1","1","0",
"38 s","Job Seeking","2016 ","2","0","2",
"38 s","Job Seeking","2018 ","5","2","3",
"38 s","Job Seeking","2019 ","1","1","0",
"38 s","study","2000 ","9","8","1",
"38 s","study","2001 ","18","14","4",
"38 s","study","2002 ","16","9","7",
"38 s","study","2003 ","23","15","8",
"38 s","study","2004 ","24","19","5",
"38 s","study","2005 ","17","13","4",
"38 s","study","2006 ","20","16","4",
"38 s","study","2007 ","18","13","5",
"38 s","study","2008 ","32","18","14",
"38 s","study","2009 ","18","16","2",
"38 s","study","2010 ","21","15","6",
"38 s","study","2011 ","25","14","11",
"38 s","study","2012 ","32","24","8",
"38 s","study","2013 ","32","24","8",
"38 s","study","2014 ","47","31","16",
"38 s","study","2015 ","41","26","15",
"38 s","study","2016 ","56","40","16",
"38 s","study","2017 ","61","37","24",
"38 s","study","2018 ","87","51","36",
"38 s","study","2019 ","127","73","54",
"38 s","General Trainees","2000 ","5","5","0",
"38 s","General Trainees","2001 ","7","5","2",
"38 s","General Trainees","2002 ","7","6","1",
"38 s","General Trainees","2003 ","13","9","4",
"38 s","General Trainees","2004 ","10","3","7",
"38 s","General Trainees","2005 ","16","10","6",
"38 s","General Trainees","2006 ","14","10","4",
"38 s","General Trainees","2007 ","20","15","5",
"38 s","General Trainees","2008 ","16","8","8",
"38 s","General Trainees","2009 ","25","12","13",
"38 s","General Trainees","2010 ","33","20","13",
"38 s","General Trainees","2011 ","37","22","15",
"38 s","General Trainees","2012 ","28","15","13",
"38 s","General Trainees","2013 ","39","25","14",
"38 s","General Trainees","2014 ","36","21","15",
"38 s","General Trainees","2015 ","41","29","12",
"38 s","General Trainees","2016 ","35","19","16",
"38 s","General Trainees","2017 ","26","11","15",
"38 s","General Trainees","2018 ","43","24","19",
"38 s","General Trainees","2019 ","44","23","21",
"38 s","Religious Activities","2000 ","3","1","2",
"38 s","Religious Activities","2001 ","8","1","7",
"38 s","Religious Activities","2002 ","10","5","5",
"38 s","Religious Activities","2003 ","12","10","2",
"38 s","Religious Activities","2004 ","9","7","2",
"38 s","Religious Activities","2005 ","2","2","0",
"38 s","Religious Activities","2006 ","9","7","2",
"38 s","Religious Activities","2007 ","9","8","1",
"38 s","Religious Activities","2008 ","11","8","3",
"38 s","Religious Activities","2009 ","6","3","3",
"38 s","Religious Activities","2010 ","10","9","1",
"38 s","Religious Activities","2011 ","6","1","5",
"38 s","Religious Activities","2012 ","2","","2",
"38 s","Religious Activities","2013 ","6","4","2",
"38 s","Religious Activities","2014 ","9","8","1",
"38 s","Religious Activities","2015 ","4","4","0",
"38 s","Religious Activities","2016 ","6","2","4",
"38 s","Religious Activities","2017 ","7","7","0",
"38 s","Religious Activities","2018 ","9","8","1",
"38 s","Religious Activities","2019 ","4","2","2",
"38 s","Investors","2000 ","73","40","33",
"38 s","Investors","2001 ","81","53","28",
"38 s","Investors","2002 ","52","50","2",
"38 s","Investors","2003 ","43","39","4",
"38 s","Investors","2004 ","48","40","8",
"38 s","Investors","2005 ","68","54","14",
"38 s","Investors","2006 ","46","44","2",
"38 s","Investors","2007 ","48","44","4",
"38 s","Investors","2008 ","45","42","3",
"38 s","Investors","2009 ","36","34","2",
"38 s","Investors","2010 ","44","35","9",
"38 s","Investors","2011 ","29","22","7",
"38 s","Investors","2012 ","40","36","4",
"38 s","Investors","2013 ","33","32","1",
"38 s","Investors","2014 ","25","24","1",
"38 s","Investors","2015 ","20","17","3",
"38 s","Investors","2016 ","25","20","5",
"38 s","Investors","2017 ","18","15","3",
"38 s","Investors","2018 ","28","21","7",
"38 s","Investors","2019 ","22","20","2",
"38 s","Trade and Business","2000 ","12","11","1",
"38 s","Trade and Business","2001 ","15","15","0",
"38 s","Trade and Business","2002 ","11","11","0",
"38 s","Trade and Business","2003 ","9","9","0",
"38 s","Trade and Business","2004 ","15","15","0",
"38 s","Trade and Business","2005 ","23","21","2",
"38 s","Trade and Business","2006 ","21","20","1",
"38 s","Trade and Business","2007 ","30","29","1",
"38 s","Trade and Business","2008 ","20","20","0",
"38 s","Trade and Business","2009 ","17","17","0",
"38 s","Trade and Business","2010 ","22","22","0",
"38 s","Trade and Business","2011 ","46","43","3",
"38 s","Trade and Business","2012 ","28","27","1",
"38 s","Trade and Business","2013 ","58","57","1",
"38 s","Trade and Business","2014 ","59","57","2",
"38 s","Trade and Business","2015 ","31","31","0",
"38 s","Trade and Business","2016 ","48","47","1",
"38 s","Trade and Business","2017 ","29","27","2",
"38 s","Trade and Business","2018 ","32","28","4",
"38 s","Trade and Business","2019 ","17","15","2",
"38 s","Research","2000 ","19","15","4",
"38 s","Research","2001 ","23","22","1",
"38 s","Research","2002 ","31","30","1",
"38 s","Research","2003 ","25","19","6",
"38 s","Research","2004 ","24","19","5",
"38 s","Research","2005 ","23","22","1",
"38 s","Research","2006 ","26","24","2",
"38 s","Research","2007 ","19","18","1",
"38 s","Research","2008 ","19","15","4",
"38 s","Research","2009 ","7","6","1",
"38 s","Research","2010 ","16","16","0",
"38 s","Research","2011 ","20","16","4",
"38 s","Research","2012 ","19","18","1",
"38 s","Research","2013 ","14","14","0",
"38 s","Research","2014 ","16","15","1",
"38 s","Research","2015 ","19","15","4",
"38 s","Research","2016 ","20","17","3",
"38 s","Research","2017 ","18","15","3",
"38 s","Research","2018 ","25","21","4",
"38 s","Research","2019 ","20","16","4",
"38 s","Art and Entertainment","2000 ","16","14","2",
"38 s","Art and Entertainment","2001 ","19","15","4",
"38 s","Art and Entertainment","2002 ","19","16","3",
"38 s","Art and Entertainment","2003 ","25","15","10",
"38 s","Art and Entertainment","2004 ","23","20","3",
"38 s","Art and Entertainment","2005 ","27","20","7",
"38 s","Art and Entertainment","2006 ","30","18","12",
"38 s","Art and Entertainment","2007 ","27","13","14",
"38 s","Art and Entertainment","2008 ","31","14","17",
"38 s","Art and Entertainment","2009 ","24","15","9",
"38 s","Art and Entertainment","2010 ","28","16","12",
"38 s","Art and Entertainment","2011 ","14","7","7",
"38 s","Art and Entertainment","2012 ","21","11","10",
"38 s","Art and Entertainment","2013 ","15","10","5",
"38 s","Art and Entertainment","2014 ","23","8","15",
"38 s","Art and Entertainment","2015 ","17","7","10",
"38 s","Art and Entertainment","2016 ","16","7","9",
"38 s","Art and Entertainment","2017 ","7","3","4",
"38 s","Art and Entertainment","2018 ","19","11","8",
"38 s","Art and Entertainment","2019 ","6","4","2",
"38 s","Unskilled Employment","2000 ","0","0","0",
"38 s","Unskilled Employment","2001 ","0","0","0",
"38 s","Unskilled Employment","2002 ","0","0","0",
"38 s","Unskilled Employment","2003 ","34","22","12",
"38 s","Unskilled Employment","2004 ","160","122","38",
"38 s","Unskilled Employment","2005 ","613","573","40",
"38 s","Unskilled Employment","2006 ","614","557","57",
"38 s","Unskilled Employment","2007 ","413","392","21",
"38 s","Unskilled Employment","2008 ","816","770","46",
"38 s","Unskilled Employment","2009 ","458","428","30",
"38 s","Unskilled Employment","2010 ","570","547","23",
"38 s","Unskilled Employment","2011 ","805","779","26",
"38 s","Unskilled Employment","2012 ","739","700","39",
"38 s","Unskilled Employment","2013 ","1126","1064","62",
"38 s","Unskilled Employment","2014 ","635","598","37",
"38 s","Unskilled Employment","2015 ","851","832","19",
"38 s","Unskilled Employment","2016 ","902","865","37",
"38 s","Unskilled Employment","2017 ","1014","964","50",
"38 s","Unskilled Employment","2018 ","792","762","30",
"38 s","Unskilled Employment","2019 ","758","738","20",
"38 s","Visiting and Joining Family","2000 ","108","3","105",
"38 s","Visiting and Joining Family","2001 ","300","12","288",
"38 s","Visiting and Joining Family","2002 ","152","8","144",
"38 s","Visiting and Joining Family","2003 ","161","84","77",
"38 s","Visiting and Joining Family","2004 ","508","266","242",
"38 s","Visiting and Joining Family","2005 ","1416","733","683",
"38 s","Visiting and Joining Family","2006 ","2657","1473","1184",
"38 s","Visiting and Joining Family","2007 ","408","223","185",
"38 s","Visiting and Joining Family","2008 ","29","11","18",
"38 s","Visiting and Joining Family","2009 ","53","23","30",
"38 s","Visiting and Joining Family","2010 ","64","34","30",
"38 s","Visiting and Joining Family","2011 ","60","36","24",
"38 s","Visiting and Joining Family","2012 ","31","13","18",
"38 s","Visiting and Joining Family","2013 ","17","6","11",
"38 s","Visiting and Joining Family","2014 ","42","6","36",
"38 s","Visiting and Joining Family","2015 ","64","8","56",
"38 s","Visiting and Joining Family","2016 ","188","44","144",
"38 s","Visiting and Joining Family","2017 ","132","41","91",
"38 s","Visiting and Joining Family","2018 ","173","51","122",
"38 s","Visiting and Joining Family","2019 ","195","59","136",
"38 s","Overseas Koreans","2000 ","28","14","14",
"38 s","Overseas Koreans","2001 ","23","11","12",
"38 s","Overseas Koreans","2002 ","38","19","19",
"38 s","Overseas Koreans","2003 ","38","26","12",
"38 s","Overseas Koreans","2004 ","24","9","15",
"38 s","Overseas Koreans","2005 ","25","15","10",
"38 s","Overseas Koreans","2006 ","36","23","13",
"38 s","Overseas Koreans","2007 ","55","33","22",
"38 s","Overseas Koreans","2008 ","73","41","32",
"38 s","Overseas Koreans","2009 ","65","38","27",
"38 s","Overseas Koreans","2010 ","157","92","65",
"38 s","Overseas Koreans","2011 ","199","112","87",
"38 s","Overseas Koreans","2012 ","198","124","74",
"38 s","Overseas Koreans","2013 ","223","121","102",
"38 s","Overseas Koreans","2014 ","281","149","132",
"38 s","Overseas Koreans","2015 ","344","188","156",
"38 s","Overseas Koreans","2016 ","576","341","235",
"38 s","Overseas Koreans","2017 ","608","363","245",
"38 s","Overseas Koreans","2018 ","599","348","251",
"38 s","Overseas Koreans","2019 ","716","407","309",
"38 s","Permanent Residence","2000 ","0","0","0",
"38 s","Permanent Residence","2001 ","0","0","0",
"38 s","Permanent Residence","2002 ","0","0","0",
"38 s","Permanent Residence","2003 ","3","3","0",
"38 s","Permanent Residence","2004 ","7","5","2",
"38 s","Permanent Residence","2005 ","5","5","0",
"38 s","Permanent Residence","2006 ","4","3","1",
"38 s","Permanent Residence","2007 ","3","2","1",
"38 s","Permanent Residence","2008 ","7","1","6",
"38 s","Permanent Residence","2009 ","17","7","10",
"38 s","Permanent Residence","2010 ","29","13","16",
"38 s","Permanent Residence","2011 ","55","27","28",
"38 s","Permanent Residence","2012 ","89","40","49",
"38 s","Permanent Residence","2013 ","103","44","59",
"38 s","Permanent Residence","2014 ","88","36","52",
"38 s","Permanent Residence","2015 ","113","36","77",
"38 s","Permanent Residence","2016 ","98","48","50",
"38 s","Permanent Residence","2017 ","116","53","63",
"38 s","Permanent Residence","2018 ","133","57","76",
"38 s","Permanent Residence","2019 ","129","52","77",
"38 s","Marriage Immigration","2011 ","11","1","10",
"38 s","Marriage Immigration","2012 ","253","47","206",
"38 s","Marriage Immigration","2013 ","256","44","212",
"38 s","Marriage Immigration","2014 ","201","49","152",
"38 s","Marriage Immigration","2015 ","171","38","133",
"38 s","Marriage Immigration","2016 ","193","34","159",
"38 s","Marriage Immigration","2017 ","188","39","149",
"38 s","Marriage Immigration","2018 ","247","52","195",
"38 s","Marriage Immigration","2019 ","217","50","167",
"39 s","Total","2000 ","2733","1702","1031",
"39 s","Total","2001 ","3026","1904","1122",
"39 s","Total","2002 ","3579","2300","1279",
"39 s","Total","2003 ","3442","2302","1140",
"39 s","Total","2004 ","3922","2387","1535",
"39 s","Total","2005 ","5089","3034","2055",
"39 s","Total","2006 ","5643","3456","2187",
"39 s","Total","2007 ","5709","3423","2286",
"39 s","Total","2008 ","5509","3315","2194",
"39 s","Total","2009 ","4281","2508","1773",
"39 s","Total","2010 ","5386","3216","2170",
"39 s","Total","2011 ","4878","2961","1917",
"39 s","Total","2012 ","4171","2500","1671",
"39 s","Total","2013 ","5132","3146","1986",
"39 s","Total","2014 ","5723","3451","2272",
"39 s","Total","2015 ","4939","3009","1930",
"39 s","Total","2016 ","5464","3237","2227",
"39 s","Total","2017 ","7178","4240","2938",
"39 s","Total","2018 ","7972","4622","3350",
"39 s","Total","2019 ","6843","3970","2873",
"39 s","Sightseeing Pass","2000 ","244","156","88",
"39 s","Sightseeing Pass","2001 ","387","278","109",
"39 s","Sightseeing Pass","2002 ","439","322","117",
"39 s","Sightseeing Pass","2003 ","358","260","98",
"39 s","Sightseeing Pass","2004 ","354","219","135",
"39 s","Sightseeing Pass","2005 ","281","183","98",
"39 s","Sightseeing Pass","2006 ","226","134","92",
"39 s","Sightseeing Pass","2007 ","256","168","88",
"39 s","Sightseeing Pass","2008 ","342","235","107",
"39 s","Sightseeing Pass","2009 ","291","177","114",
"39 s","Sightseeing Pass","2010 ","477","300","177",
"39 s","Sightseeing Pass","2011 ","322","166","156",
"39 s","Sightseeing Pass","2012 ","320","164","156",
"39 s","Sightseeing Pass","2013 ","277","139","138",
"39 s","Sightseeing Pass","2014 ","359","180","179",
"39 s","Sightseeing Pass","2015 ","364","198","166",
"39 s","Sightseeing Pass","2016 ","384","219","165",
"39 s","Sightseeing Pass","2017 ","425","253","172",
"39 s","Sightseeing Pass","2018 ","763","468","295",
"39 s","Sightseeing Pass","2019 ","402","182","220",
"39 s","Short-term Business","2000 ","611","385","226",
"39 s","Short-term Business","2001 ","793","494","299",
"39 s","Short-term Business","2002 ","499","350","149",
"39 s","Short-term Business","2003 ","300","234","66",
"39 s","Short-term Business","2004 ","295","229","66",
"39 s","Short-term Business","2005 ","227","173","54",
"39 s","Short-term Business","2006 ","449","328","121",
"39 s","Short-term Business","2007 ","633","489","144",
"39 s","Short-term Business","2008 ","332","264","68",
"39 s","Short-term Business","2009 ","109","93","16",
"39 s","Short-term Business","2010 ","90","76","14",
"39 s","Short-term Business","2011 ","77","71","6",
"39 s","Short-term Visitors","2000 ","870","532","338",
"39 s","Short-term Visitors","2001 ","859","540","319",
"39 s","Short-term Visitors","2002 ","1235","801","434",
"39 s","Short-term Visitors","2003 ","655","401","254",
"39 s","Short-term Visitors","2004 ","569","380","189",
"39 s","Short-term Visitors","2005 ","545","339","206",
"39 s","Short-term Visitors","2006 ","540","343","197",
"39 s","Short-term Visitors","2007 ","479","288","191",
"39 s","Short-term Visitors","2008 ","372","200","172",
"39 s","Short-term Visitors","2009 ","234","106","128",
"39 s","Short-term Visitors","2010 ","917","530","387",
"39 s","Short-term Visitors","2011 ","1188","673","515",
"39 s","Short-term Visitors","2012 ","978","557","421",
"39 s","Short-term Visitors","2013 ","1147","657","490",
"39 s","Short-term Visitors","2014 ","730","435","295",
"39 s","Short-term Visitors","2015 ","906","535","371",
"39 s","Short-term Visitors","2016 ","953","593","360",
"39 s","Short-term Visitors","2017 ","1144","715","429",
"39 s","Short-term Visitors","2018 ","1244","762","482",
"39 s","Short-term Visitors","2019 ","1297","841","456",
"39 s","Short-term Employment","2000 ","7","4","3",
"39 s","Short-term Employment","2001 ","2","1","1",
"39 s","Short-term Employment","2002 ","2","2","0",
"39 s","Short-term Employment","2003 ","12","12","0",
"39 s","Short-term Employment","2004 ","2","1","1",
"39 s","Short-term Employment","2005 ","2","2","0",
"39 s","Short-term Employment","2006 ","4","4","0",
"39 s","Short-term Employment","2007 ","4","2","2",
"39 s","Short-term Employment","2008 ","3","3","0",
"39 s","Short-term Employment","2009 ","2","2","0",
"39 s","Short-term Employment","2010 ","3","3","0",
"39 s","Short-term Employment","2012 ","1","","1",
"39 s","Short-term Employment","2013 ","1","1","0",
"39 s","Short-term Employment","2014 ","2","1","1",
"39 s","Short-term Employment","2016 ","11","10","1",
"39 s","Short-term Employment","2017 ","2","2","0",
"39 s","Short-term Employment","2018 ","9","7","2",
"39 s","Short-term Employment","2019 ","2","2","0",
"39 s","Job Seeking","2000 ","0","0","0",
"39 s","Job Seeking","2001 ","0","0","0",
"39 s","Job Seeking","2002 ","0","0","0",
"39 s","Job Seeking","2003 ","0","0","0",
"39 s","Job Seeking","2004 ","0","0","0",
"39 s","Job Seeking","2005 ","0","0","0",
"39 s","Job Seeking","2006 ","0","0","0",
"39 s","Job Seeking","2007 ","0","0","0",
"39 s","Job Seeking","2008 ","0","0","0",
"39 s","Job Seeking","2009 ","0","0","0",
"39 s","Job Seeking","2010 ","0","0","0",
"39 s","Job Seeking","2012 ","1","1","",
"39 s","Job Seeking","2013 ","1","0","1",
"39 s","Job Seeking","2014 ","2","2","0",
"39 s","Job Seeking","2016 ","3","3","0",
"39 s","Job Seeking","2017 ","4","4","0",
"39 s","Job Seeking","2018 ","2","2","0",
"39 s","Job Seeking","2019 ","1","1","0",
"39 s","study","2000 ","10","9","1",
"39 s","study","2001 ","10","10","0",
"39 s","study","2002 ","15","11","4",
"39 s","study","2003 ","13","8","5",
"39 s","study","2004 ","23","16","7",
"39 s","study","2005 ","23","16","7",
"39 s","study","2006 ","15","9","6",
"39 s","study","2007 ","26","17","9",
"39 s","study","2008 ","22","10","12",
"39 s","study","2009 ","16","11","5",
"39 s","study","2010 ","22","17","5",
"39 s","study","2011 ","31","22","9",
"39 s","study","2012 ","20","11","9",
"39 s","study","2013 ","29","19","10",
"39 s","study","2014 ","29","22","7",
"39 s","study","2015 ","48","34","14",
"39 s","study","2016 ","46","29","17",
"39 s","study","2017 ","46","36","10",
"39 s","study","2018 ","76","43","33",
"39 s","study","2019 ","101","63","38",
"39 s","General Trainees","2000 ","7","6","1",
"39 s","General Trainees","2001 ","8","5","3",
"39 s","General Trainees","2002 ","8","6","2",
"39 s","General Trainees","2003 ","7","7","0",
"39 s","General Trainees","2004 ","11","8","3",
"39 s","General Trainees","2005 ","23","14","9",
"39 s","General Trainees","2006 ","11","6","5",
"39 s","General Trainees","2007 ","10","6","4",
"39 s","General Trainees","2008 ","13","11","2",
"39 s","General Trainees","2009 ","17","10","7",
"39 s","General Trainees","2010 ","16","6","10",
"39 s","General Trainees","2011 ","45","26","19",
"39 s","General Trainees","2012 ","31","15","16",
"39 s","General Trainees","2013 ","32","17","15",
"39 s","General Trainees","2014 ","30","13","17",
"39 s","General Trainees","2015 ","23","13","10",
"39 s","General Trainees","2016 ","41","33","8",
"39 s","General Trainees","2017 ","20","9","11",
"39 s","General Trainees","2018 ","23","18","5",
"39 s","General Trainees","2019 ","36","18","18",
"39 s","Religious Activities","2000 ","4","1","3",
"39 s","Religious Activities","2001 ","5","3","2",
"39 s","Religious Activities","2002 ","6","4","2",
"39 s","Religious Activities","2003 ","7","6","1",
"39 s","Religious Activities","2004 ","5","4","1",
"39 s","Religious Activities","2005 ","8","2","6",
"39 s","Religious Activities","2006 ","4","1","3",
"39 s","Religious Activities","2007 ","9","7","2",
"39 s","Religious Activities","2008 ","8","6","2",
"39 s","Religious Activities","2009 ","8","4","4",
"39 s","Religious Activities","2010 ","11","6","5",
"39 s","Religious Activities","2011 ","3","2","1",
"39 s","Religious Activities","2012 ","8","5","3",
"39 s","Religious Activities","2013 ","10","5","5",
"39 s","Religious Activities","2014 ","3","2","1",
"39 s","Religious Activities","2015 ","3","1","2",
"39 s","Religious Activities","2016 ","5","3","2",
"39 s","Religious Activities","2017 ","8","5","3",
"39 s","Religious Activities","2018 ","7","3","4",
"39 s","Religious Activities","2019 ","5","4","1",
"39 s","Investors","2000 ","77","47","30",
"39 s","Investors","2001 ","51","40","11",
"39 s","Investors","2002 ","41","39","2",
"39 s","Investors","2003 ","51","48","3",
"39 s","Investors","2004 ","53","46","7",
"39 s","Investors","2005 ","66","61","5",
"39 s","Investors","2006 ","43","39","4",
"39 s","Investors","2007 ","55","51","4",
"39 s","Investors","2008 ","50","44","6",
"39 s","Investors","2009 ","30","30","0",
"39 s","Investors","2010 ","30","28","2",
"39 s","Investors","2011 ","39","37","2",
"39 s","Investors","2012 ","33","32","1",
"39 s","Investors","2013 ","34","34","0",
"39 s","Investors","2014 ","21","19","2",
"39 s","Investors","2015 ","13","12","1",
"39 s","Investors","2016 ","37","34","3",
"39 s","Investors","2017 ","14","12","2",
"39 s","Investors","2018 ","13","13","0",
"39 s","Investors","2019 ","22","20","2",
"39 s","Trade and Business","2000 ","14","14","0",
"39 s","Trade and Business","2001 ","12","12","0",
"39 s","Trade and Business","2002 ","13","13","0",
"39 s","Trade and Business","2003 ","16","15","1",
"39 s","Trade and Business","2004 ","11","11","0",
"39 s","Trade and Business","2005 ","12","11","1",
"39 s","Trade and Business","2006 ","14","14","0",
"39 s","Trade and Business","2007 ","17","17","0",
"39 s","Trade and Business","2008 ","14","14","0",
"39 s","Trade and Business","2009 ","22","22","0",
"39 s","Trade and Business","2010 ","19","19","0",
"39 s","Trade and Business","2011 ","30","30","",
"39 s","Trade and Business","2012 ","32","32","",
"39 s","Trade and Business","2013 ","51","50","1",
"39 s","Trade and Business","2014 ","75","72","3",
"39 s","Trade and Business","2015 ","60","57","3",
"39 s","Trade and Business","2016 ","34","33","1",
"39 s","Trade and Business","2017 ","21","21","0",
"39 s","Trade and Business","2018 ","23","19","4",
"39 s","Trade and Business","2019 ","19","18","1",
"39 s","Research","2000 ","14","13","1",
"39 s","Research","2001 ","15","14","1",
"39 s","Research","2002 ","20","17","3",
"39 s","Research","2003 ","24","21","3",
"39 s","Research","2004 ","20","18","2",
"39 s","Research","2005 ","21","20","1",
"39 s","Research","2006 ","14","13","1",
"39 s","Research","2007 ","18","11","7",
"39 s","Research","2008 ","13","10","3",
"39 s","Research","2009 ","10","10","0",
"39 s","Research","2010 ","15","12","3",
"39 s","Research","2011 ","11","11","",
"39 s","Research","2012 ","13","13","",
"39 s","Research","2013 ","18","17","1",
"39 s","Research","2014 ","13","9","4",
"39 s","Research","2015 ","10","7","3",
"39 s","Research","2016 ","20","18","2",
"39 s","Research","2017 ","14","12","2",
"39 s","Research","2018 ","17","15","2",
"39 s","Research","2019 ","16","13","3",
"39 s","Art and Entertainment","2000 ","11","7","4",
"39 s","Art and Entertainment","2001 ","19","14","5",
"39 s","Art and Entertainment","2002 ","25","20","5",
"39 s","Art and Entertainment","2003 ","20","15","5",
"39 s","Art and Entertainment","2004 ","18","13","5",
"39 s","Art and Entertainment","2005 ","25","18","7",
"39 s","Art and Entertainment","2006 ","22","19","3",
"39 s","Art and Entertainment","2007 ","23","11","12",
"39 s","Art and Entertainment","2008 ","31","11","20",
"39 s","Art and Entertainment","2009 ","17","12","5",
"39 s","Art and Entertainment","2010 ","10","9","1",
"39 s","Art and Entertainment","2011 ","18","11","7",
"39 s","Art and Entertainment","2012 ","15","9","6",
"39 s","Art and Entertainment","2013 ","15","6","9",
"39 s","Art and Entertainment","2014 ","15","6","9",
"39 s","Art and Entertainment","2015 ","12","10","2",
"39 s","Art and Entertainment","2016 ","13","8","5",
"39 s","Art and Entertainment","2017 ","9","6","3",
"39 s","Art and Entertainment","2018 ","11","5","6",
"39 s","Art and Entertainment","2019 ","11","10","1",
"39 s","Unskilled Employment","2000 ","0","0","0",
"39 s","Unskilled Employment","2001 ","0","0","0",
"39 s","Unskilled Employment","2002 ","0","0","0",
"39 s","Unskilled Employment","2003 ","39","27","12",
"39 s","Unskilled Employment","2004 ","130","94","36",
"39 s","Unskilled Employment","2005 ","453","422","31",
"39 s","Unskilled Employment","2006 ","422","369","53",
"39 s","Unskilled Employment","2007 ","242","226","16",
"39 s","Unskilled Employment","2008 ","517","497","20",
"39 s","Unskilled Employment","2009 ","328","315","13",
"39 s","Unskilled Employment","2010 ","408","391","17",
"39 s","Unskilled Employment","2011 ","515","495","20",
"39 s","Unskilled Employment","2012 ","511","492","19",
"39 s","Unskilled Employment","2013 ","659","611","48",
"39 s","Unskilled Employment","2014 ","474","462","12",
"39 s","Unskilled Employment","2015 ","622","595","27",
"39 s","Unskilled Employment","2016 ","656","629","27",
"39 s","Unskilled Employment","2017 ","680","640","40",
"39 s","Unskilled Employment","2018 ","602","582","20",
"39 s","Unskilled Employment","2019 ","582","573","9",
"39 s","Visiting and Joining Family","2000 ","95","5","90",
"39 s","Visiting and Joining Family","2001 ","184","6","178",
"39 s","Visiting and Joining Family","2002 ","158","2","156",
"39 s","Visiting and Joining Family","2003 ","187","97","90",
"39 s","Visiting and Joining Family","2004 ","581","319","262",
"39 s","Visiting and Joining Family","2005 ","1765","936","829",
"39 s","Visiting and Joining Family","2006 ","2534","1393","1141",
"39 s","Visiting and Joining Family","2007 ","371","194","177",
"39 s","Visiting and Joining Family","2008 ","26","15","11",
"39 s","Visiting and Joining Family","2009 ","36","16","20",
"39 s","Visiting and Joining Family","2010 ","63","25","38",
"39 s","Visiting and Joining Family","2011 ","55","33","22",
"39 s","Visiting and Joining Family","2012 ","43","21","22",
"39 s","Visiting and Joining Family","2013 ","30","10","20",
"39 s","Visiting and Joining Family","2014 ","45","3","42",
"39 s","Visiting and Joining Family","2015 ","84","17","67",
"39 s","Visiting and Joining Family","2016 ","164","41","123",
"39 s","Visiting and Joining Family","2017 ","154","48","106",
"39 s","Visiting and Joining Family","2018 ","146","34","112",
"39 s","Visiting and Joining Family","2019 ","180","59","121",
"39 s","Overseas Koreans","2000 ","21","7","14",
"39 s","Overseas Koreans","2001 ","22","15","7",
"39 s","Overseas Koreans","2002 ","36","19","17",
"39 s","Overseas Koreans","2003 ","30","17","13",
"39 s","Overseas Koreans","2004 ","27","11","16",
"39 s","Overseas Koreans","2005 ","29","16","13",
"39 s","Overseas Koreans","2006 ","26","14","12",
"39 s","Overseas Koreans","2007 ","40","23","17",
"39 s","Overseas Koreans","2008 ","60","37","23",
"39 s","Overseas Koreans","2009 ","50","22","28",
"39 s","Overseas Koreans","2010 ","181","111","70",
"39 s","Overseas Koreans","2011 ","188","110","78",
"39 s","Overseas Koreans","2012 ","209","112","97",
"39 s","Overseas Koreans","2013 ","244","148","96",
"39 s","Overseas Koreans","2014 ","265","145","120",
"39 s","Overseas Koreans","2015 ","381","209","172",
"39 s","Overseas Koreans","2016 ","534","284","250",
"39 s","Overseas Koreans","2017 ","586","337","249",
"39 s","Overseas Koreans","2018 ","623","355","268",
"39 s","Overseas Koreans","2019 ","653","378","275",
"39 s","Permanent Residence","2000 ","0","0","0",
"39 s","Permanent Residence","2001 ","0","0","0",
"39 s","Permanent Residence","2002 ","0","0","0",
"39 s","Permanent Residence","2003 ","4","3","1",
"39 s","Permanent Residence","2004 ","2","1","1",
"39 s","Permanent Residence","2005 ","7","5","2",
"39 s","Permanent Residence","2006 ","5","3","2",
"39 s","Permanent Residence","2007 ","3","1","2",
"39 s","Permanent Residence","2008 ","10","5","5",
"39 s","Permanent Residence","2009 ","10","5","5",
"39 s","Permanent Residence","2010 ","24","9","15",
"39 s","Permanent Residence","2011 ","73","34","39",
"39 s","Permanent Residence","2012 ","96","54","42",
"39 s","Permanent Residence","2013 ","96","41","55",
"39 s","Permanent Residence","2014 ","113","57","56",
"39 s","Permanent Residence","2015 ","96","52","44",
"39 s","Permanent Residence","2016 ","115","55","60",
"39 s","Permanent Residence","2017 ","117","55","62",
"39 s","Permanent Residence","2018 ","140","60","80",
"39 s","Permanent Residence","2019 ","115","48","67",
"39 s","Marriage Immigration","2011 ","13","1","12",
"39 s","Marriage Immigration","2012 ","249","50","199",
"39 s","Marriage Immigration","2013 ","235","47","188",
"39 s","Marriage Immigration","2014 ","169","25","144",
"39 s","Marriage Immigration","2015 ","163","41","122",
"39 s","Marriage Immigration","2016 ","162","32","130",
"39 s","Marriage Immigration","2017 ","172","47","125",
"39 s","Marriage Immigration","2018 ","190","45","145",
"39 s","Marriage Immigration","2019 ","246","53","193",
"40 s","Total","2000 ","2932","1795","1137",
"40 s","Total","2001 ","2676","1664","1012",
"40 s","Total","2002 ","2694","1760","934",
"40 s","Total","2003 ","3260","2008","1252",
"40 s","Total","2004 ","3548","1991","1557",
"40 s","Total","2005 ","4868","2630","2238",
"40 s","Total","2006 ","5692","3340","2352",
"40 s","Total","2007 ","4778","2770","2008",
"40 s","Total","2008 ","4552","2562","1990",
"40 s","Total","2009 ","4126","2222","1904",
"40 s","Total","2010 ","5001","2817","2184",
"40 s","Total","2011 ","4591","2624","1967",
"40 s","Total","2012 ","4016","2330","1686",
"40 s","Total","2013 ","5239","3114","2125",
"40 s","Total","2014 ","5855","3499","2356",
"40 s","Total","2015 ","4625","2707","1918",
"40 s","Total","2016 ","5017","2899","2118",
"40 s","Total","2017 ","6775","4011","2764",
"40 s","Total","2018 ","7320","4153","3167",
"40 s","Total","2019 ","6288","3459","2829",
"40 s","Sightseeing Pass","2000 ","260","163","97",
"40 s","Sightseeing Pass","2001 ","390","260","130",
"40 s","Sightseeing Pass","2002 ","425","297","128",
"40 s","Sightseeing Pass","2003 ","328","230","98",
"40 s","Sightseeing Pass","2004 ","315","212","103",
"40 s","Sightseeing Pass","2005 ","299","205","94",
"40 s","Sightseeing Pass","2006 ","274","184","90",
"40 s","Sightseeing Pass","2007 ","223","139","84",
"40 s","Sightseeing Pass","2008 ","314","209","105",
"40 s","Sightseeing Pass","2009 ","316","197","119",
"40 s","Sightseeing Pass","2010 ","437","261","176",
"40 s","Sightseeing Pass","2011 ","311","179","132",
"40 s","Sightseeing Pass","2012 ","289","148","141",
"40 s","Sightseeing Pass","2013 ","272","143","129",
"40 s","Sightseeing Pass","2014 ","307","155","152",
"40 s","Sightseeing Pass","2015 ","368","201","167",
"40 s","Sightseeing Pass","2016 ","312","180","132",
"40 s","Sightseeing Pass","2017 ","405","258","147",
"40 s","Sightseeing Pass","2018 ","676","412","264",
"40 s","Sightseeing Pass","2019 ","468","209","259",
"40 s","Short-term Business","2000 ","742","422","320",
"40 s","Short-term Business","2001 ","648","417","231",
"40 s","Short-term Business","2002 ","368","272","96",
"40 s","Short-term Business","2003 ","362","267","95",
"40 s","Short-term Business","2004 ","303","233","70",
"40 s","Short-term Business","2005 ","246","189","57",
"40 s","Short-term Business","2006 ","460","352","108",
"40 s","Short-term Business","2007 ","513","401","112",
"40 s","Short-term Business","2008 ","268","223","45",
"40 s","Short-term Business","2009 ","95","81","14",
"40 s","Short-term Business","2010 ","92","79","13",
"40 s","Short-term Business","2011 ","59","53","6",
"40 s","Short-term Visitors","2000 ","933","568","365",
"40 s","Short-term Visitors","2001 ","759","459","300",
"40 s","Short-term Visitors","2002 ","875","573","302",
"40 s","Short-term Visitors","2003 ","665","411","254",
"40 s","Short-term Visitors","2004 ","597","403","194",
"40 s","Short-term Visitors","2005 ","535","305","230",
"40 s","Short-term Visitors","2006 ","621","399","222",
"40 s","Short-term Visitors","2007 ","417","235","182",
"40 s","Short-term Visitors","2008 ","365","194","171",
"40 s","Short-term Visitors","2009 ","255","95","160",
"40 s","Short-term Visitors","2010 ","968","518","450",
"40 s","Short-term Visitors","2011 ","1204","676","528",
"40 s","Short-term Visitors","2012 ","953","533","420",
"40 s","Short-term Visitors","2013 ","1252","697","555",
"40 s","Short-term Visitors","2014 ","885","520","365",
"40 s","Short-term Visitors","2015 ","985","554","431",
"40 s","Short-term Visitors","2016 ","1071","670","401",
"40 s","Short-term Visitors","2017 ","1156","720","436",
"40 s","Short-term Visitors","2018 ","1160","711","449",
"40 s","Short-term Visitors","2019 ","1262","783","479",
"40 s","Short-term Employment","2000 ","2","2","0",
"40 s","Short-term Employment","2001 ","3","3","0",
"40 s","Short-term Employment","2002 ","4","4","0",
"40 s","Short-term Employment","2003 ","7","6","1",
"40 s","Short-term Employment","2004 ","6","4","2",
"40 s","Short-term Employment","2005 ","8","7","1",
"40 s","Short-term Employment","2006 ","4","4","0",
"40 s","Short-term Employment","2007 ","5","4","1",
"40 s","Short-term Employment","2008 ","3","3","0",
"40 s","Short-term Employment","2009 ","1","1","0",
"40 s","Short-term Employment","2010 ","0","0","0",
"40 s","Short-term Employment","2011 ","2","2","",
"40 s","Short-term Employment","2012 ","5","4","1",
"40 s","Short-term Employment","2013 ","3","3","0",
"40 s","Short-term Employment","2014 ","1","1","0",
"40 s","Short-term Employment","2015 ","3","3","0",
"40 s","Short-term Employment","2016 ","10","9","1",
"40 s","Short-term Employment","2017 ","5","5","0",
"40 s","Short-term Employment","2018 ","6","4","2",
"40 s","Short-term Employment","2019 ","7","7","0",
"40 s","Job Seeking","2000 ","0","0","0",
"40 s","Job Seeking","2001 ","0","0","0",
"40 s","Job Seeking","2002 ","0","0","0",
"40 s","Job Seeking","2003 ","0","0","0",
"40 s","Job Seeking","2004 ","0","0","0",
"40 s","Job Seeking","2005 ","0","0","0",
"40 s","Job Seeking","2006 ","0","0","0",
"40 s","Job Seeking","2007 ","0","0","0",
"40 s","Job Seeking","2008 ","0","0","0",
"40 s","Job Seeking","2009 ","0","0","0",
"40 s","Job Seeking","2010 ","0","0","0",
"40 s","Job Seeking","2014 ","3","2","1",
"40 s","Job Seeking","2015 ","1","1","0",
"40 s","Job Seeking","2016 ","2","1","1",
"40 s","Job Seeking","2018 ","2","2","0",
"40 s","Job Seeking","2019 ","2","2","0",
"40 s","study","2000 ","10","9","1",
"40 s","study","2001 ","6","4","2",
"40 s","study","2002 ","11","9","2",
"40 s","study","2003 ","16","13","3",
"40 s","study","2004 ","15","11","4",
"40 s","study","2005 ","20","16","4",
"40 s","study","2006 ","16","12","4",
"40 s","study","2007 ","16","11","5",
"40 s","study","2008 ","17","13","4",
"40 s","study","2009 ","14","7","7",
"40 s","study","2010 ","13","10","3",
"40 s","study","2011 ","23","14","9",
"40 s","study","2012 ","34","23","11",
"40 s","study","2013 ","28","17","11",
"40 s","study","2014 ","20","16","4",
"40 s","study","2015 ","20","14","6",
"40 s","study","2016 ","41","30","11",
"40 s","study","2017 ","35","21","14",
"40 s","study","2018 ","47","29","18",
"40 s","study","2019 ","78","46","32",
"40 s","General Trainees","2000 ","6","4","2",
"40 s","General Trainees","2001 ","5","3","2",
"40 s","General Trainees","2002 ","2","0","2",
"40 s","General Trainees","2003 ","4","3","1",
"40 s","General Trainees","2004 ","8","7","1",
"40 s","General Trainees","2005 ","12","8","4",
"40 s","General Trainees","2006 ","12","7","5",
"40 s","General Trainees","2007 ","12","9","3",
"40 s","General Trainees","2008 ","13","5","8",
"40 s","General Trainees","2009 ","11","7","4",
"40 s","General Trainees","2010 ","28","12","16",
"40 s","General Trainees","2011 ","43","26","17",
"40 s","General Trainees","2012 ","17","13","4",
"40 s","General Trainees","2013 ","21","16","5",
"40 s","General Trainees","2014 ","16","10","6",
"40 s","General Trainees","2015 ","28","21","7",
"40 s","General Trainees","2016 ","23","16","7",
"40 s","General Trainees","2017 ","25","15","10",
"40 s","General Trainees","2018 ","17","7","10",
"40 s","General Trainees","2019 ","17","12","5",
"40 s","Religious Activities","2000 ","7","3","4",
"40 s","Religious Activities","2001 ","5","1","4",
"40 s","Religious Activities","2002 ","3","2","1",
"40 s","Religious Activities","2003 ","2","1","1",
"40 s","Religious Activities","2004 ","10","4","6",
"40 s","Religious Activities","2005 ","9","5","4",
"40 s","Religious Activities","2006 ","3","3","0",
"40 s","Religious Activities","2007 ","2","1","1",
"40 s","Religious Activities","2008 ","5","2","3",
"40 s","Religious Activities","2009 ","3","1","2",
"40 s","Religious Activities","2010 ","3","3","0",
"40 s","Religious Activities","2011 ","9","5","4",
"40 s","Religious Activities","2012 ","6","3","3",
"40 s","Religious Activities","2013 ","4","3","1",
"40 s","Religious Activities","2014 ","9","6","3",
"40 s","Religious Activities","2015 ","3","2","1",
"40 s","Religious Activities","2016 ","4","0","4",
"40 s","Religious Activities","2017 ","4","1","3",
"40 s","Religious Activities","2018 ","5","4","1",
"40 s","Religious Activities","2019 ","4","4","0",
"40 s","Investors","2000 ","93","48","45",
"40 s","Investors","2001 ","62","46","16",
"40 s","Investors","2002 ","47","39","8",
"40 s","Investors","2003 ","33","31","2",
"40 s","Investors","2004 ","46","39","7",
"40 s","Investors","2005 ","74","69","5",
"40 s","Investors","2006 ","43","40","3",
"40 s","Investors","2007 ","43","42","1",
"40 s","Investors","2008 ","48","42","6",
"40 s","Investors","2009 ","38","38","0",
"40 s","Investors","2010 ","43","42","1",
"40 s","Investors","2011 ","36","36","",
"40 s","Investors","2012 ","41","40","1",
"40 s","Investors","2013 ","39","38","1",
"40 s","Investors","2014 ","27","23","4",
"40 s","Investors","2015 ","19","17","2",
"40 s","Investors","2016 ","16","16","0",
"40 s","Investors","2017 ","22","21","1",
"40 s","Investors","2018 ","23","22","1",
"40 s","Investors","2019 ","22","21","1",
"40 s","Trade and Business","2000 ","14","14","0",
"40 s","Trade and Business","2001 ","10","10","0",
"40 s","Trade and Business","2002 ","12","11","1",
"40 s","Trade and Business","2003 ","20","19","1",
"40 s","Trade and Business","2004 ","14","14","0",
"40 s","Trade and Business","2005 ","24","24","0",
"40 s","Trade and Business","2006 ","22","21","1",
"40 s","Trade and Business","2007 ","23","23","0",
"40 s","Trade and Business","2008 ","11","11","0",
"40 s","Trade and Business","2009 ","16","16","0",
"40 s","Trade and Business","2010 ","20","19","1",
"40 s","Trade and Business","2011 ","26","25","1",
"40 s","Trade and Business","2012 ","41","40","1",
"40 s","Trade and Business","2013 ","54","53","1",
"40 s","Trade and Business","2014 ","57","50","7",
"40 s","Trade and Business","2015 ","49","47","2",
"40 s","Trade and Business","2016 ","30","29","1",
"40 s","Trade and Business","2017 ","22","22","0",
"40 s","Trade and Business","2018 ","21","21","0",
"40 s","Trade and Business","2019 ","22","21","1",
"40 s","Research","2000 ","14","14","0",
"40 s","Research","2001 ","10","7","3",
"40 s","Research","2002 ","11","10","1",
"40 s","Research","2003 ","31","31","0",
"40 s","Research","2004 ","17","13","4",
"40 s","Research","2005 ","15","13","2",
"40 s","Research","2006 ","14","12","2",
"40 s","Research","2007 ","5","5","0",
"40 s","Research","2008 ","6","4","2",
"40 s","Research","2009 ","9","6","3",
"40 s","Research","2010 ","7","6","1",
"40 s","Research","2011 ","11","8","3",
"40 s","Research","2012 ","10","9","1",
"40 s","Research","2013 ","21","19","2",
"40 s","Research","2014 ","14","13","1",
"40 s","Research","2015 ","10","9","1",
"40 s","Research","2016 ","11","10","1",
"40 s","Research","2017 ","15","15","0",
"40 s","Research","2018 ","16","14","2",
"40 s","Research","2019 ","11","10","1",
"40 s","Art and Entertainment","2000 ","15","14","1",
"40 s","Art and Entertainment","2001 ","10","9","1",
"40 s","Art and Entertainment","2002 ","26","17","9",
"40 s","Art and Entertainment","2003 ","30","24","6",
"40 s","Art and Entertainment","2004 ","23","16","7",
"40 s","Art and Entertainment","2005 ","31","26","5",
"40 s","Art and Entertainment","2006 ","16","12","4",
"40 s","Art and Entertainment","2007 ","20","16","4",
"40 s","Art and Entertainment","2008 ","19","15","4",
"40 s","Art and Entertainment","2009 ","12","8","4",
"40 s","Art and Entertainment","2010 ","19","12","7",
"40 s","Art and Entertainment","2011 ","19","15","4",
"40 s","Art and Entertainment","2012 ","25","15","10",
"40 s","Art and Entertainment","2013 ","9","4","5",
"40 s","Art and Entertainment","2014 ","6","3","3",
"40 s","Art and Entertainment","2015 ","9","6","3",
"40 s","Art and Entertainment","2016 ","11","5","6",
"40 s","Art and Entertainment","2017 ","13","8","5",
"40 s","Art and Entertainment","2018 ","9","7","2",
"40 s","Art and Entertainment","2019 ","11","6","5",
"40 s","Unskilled Employment","2000 ","0","0","0",
"40 s","Unskilled Employment","2001 ","0","0","0",
"40 s","Unskilled Employment","2002 ","0","0","0",
"40 s","Unskilled Employment","2003 ","31","20","11",
"40 s","Unskilled Employment","2004 ","93","63","30",
"40 s","Unskilled Employment","2005 ","282","257","25",
"40 s","Unskilled Employment","2006 ","205","165","40",
"40 s","Unskilled Employment","2007 ","75","67","8",
"40 s","Unskilled Employment","2008 ","142","131","11",
"40 s","Unskilled Employment","2009 ","171","155","16",
"40 s","Unskilled Employment","2010 ","189","181","8",
"40 s","Unskilled Employment","2011 ","179","169","10",
"40 s","Unskilled Employment","2012 ","266","252","14",
"40 s","Unskilled Employment","2013 ","383","366","17",
"40 s","Unskilled Employment","2014 ","298","293","5",
"40 s","Unskilled Employment","2015 ","340","332","8",
"40 s","Unskilled Employment","2016 ","380","367","13",
"40 s","Unskilled Employment","2017 ","544","519","25",
"40 s","Unskilled Employment","2018 ","413","400","13",
"40 s","Unskilled Employment","2019 ","365","358","7",
"40 s","Visiting and Joining Family","2000 ","105","9","96",
"40 s","Visiting and Joining Family","2001 ","144","9","135",
"40 s","Visiting and Joining Family","2002 ","107","8","99",
"40 s","Visiting and Joining Family","2003 ","388","206","182",
"40 s","Visiting and Joining Family","2004 ","684","369","315",
"40 s","Visiting and Joining Family","2005 ","1953","976","977",
"40 s","Visiting and Joining Family","2006 ","2999","1671","1328",
"40 s","Visiting and Joining Family","2007 ","402","217","185",
"40 s","Visiting and Joining Family","2008 ","24","10","14",
"40 s","Visiting and Joining Family","2009 ","39","17","22",
"40 s","Visiting and Joining Family","2010 ","57","29","28",
"40 s","Visiting and Joining Family","2011 ","60","27","33",
"40 s","Visiting and Joining Family","2012 ","39","18","21",
"40 s","Visiting and Joining Family","2013 ","43","12","31",
"40 s","Visiting and Joining Family","2014 ","50","13","37",
"40 s","Visiting and Joining Family","2015 ","96","18","78",
"40 s","Visiting and Joining Family","2016 ","182","43","139",
"40 s","Visiting and Joining Family","2017 ","138","43","95",
"40 s","Visiting and Joining Family","2018 ","187","53","134",
"40 s","Visiting and Joining Family","2019 ","201","46","155",
"40 s","Overseas Koreans","2000 ","12","4","8",
"40 s","Overseas Koreans","2001 ","20","8","12",
"40 s","Overseas Koreans","2002 ","22","11","11",
"40 s","Overseas Koreans","2003 ","30","20","10",
"40 s","Overseas Koreans","2004 ","47","27","20",
"40 s","Overseas Koreans","2005 ","42","20","22",
"40 s","Overseas Koreans","2006 ","37","23","14",
"40 s","Overseas Koreans","2007 ","37","20","17",
"40 s","Overseas Koreans","2008 ","49","29","20",
"40 s","Overseas Koreans","2009 ","63","40","23",
"40 s","Overseas Koreans","2010 ","153","80","73",
"40 s","Overseas Koreans","2011 ","195","106","89",
"40 s","Overseas Koreans","2012 ","208","132","76",
"40 s","Overseas Koreans","2013 ","281","156","125",
"40 s","Overseas Koreans","2014 ","314","186","128",
"40 s","Overseas Koreans","2015 ","339","197","142",
"40 s","Overseas Koreans","2016 ","485","284","201",
"40 s","Overseas Koreans","2017 ","471","265","206",
"40 s","Overseas Koreans","2018 ","623","346","277",
"40 s","Overseas Koreans","2019 ","597","358","239",
"40 s","Permanent Residence","2000 ","0","0","0",
"40 s","Permanent Residence","2001 ","0","0","0",
"40 s","Permanent Residence","2002 ","0","0","0",
"40 s","Permanent Residence","2003 ","2","2","0",
"40 s","Permanent Residence","2004 ","9","8","1",
"40 s","Permanent Residence","2005 ","4","2","2",
"40 s","Permanent Residence","2006 ","2","2","0",
"40 s","Permanent Residence","2007 ","9","5","4",
"40 s","Permanent Residence","2008 ","7","2","5",
"40 s","Permanent Residence","2009 ","11","4","7",
"40 s","Permanent Residence","2010 ","28","13","15",
"40 s","Permanent Residence","2011 ","65","33","32",
"40 s","Permanent Residence","2012 ","95","41","54",
"40 s","Permanent Residence","2013 ","118","64","54",
"40 s","Permanent Residence","2014 ","106","54","52",
"40 s","Permanent Residence","2015 ","129","60","69",
"40 s","Permanent Residence","2016 ","105","38","67",
"40 s","Permanent Residence","2017 ","119","45","74",
"40 s","Permanent Residence","2018 ","133","56","77",
"40 s","Permanent Residence","2019 ","127","54","73",
"40 s","Marriage Immigration","2011 ","5","","5",
"40 s","Marriage Immigration","2012 ","221","55","166",
"40 s","Marriage Immigration","2013 ","223","55","168",
"40 s","Marriage Immigration","2014 ","181","43","138",
"40 s","Marriage Immigration","2015 ","138","27","111",
"40 s","Marriage Immigration","2016 ","138","36","102",
"40 s","Marriage Immigration","2017 ","162","39","123",
"40 s","Marriage Immigration","2018 ","203","52","151",
"40 s","Marriage Immigration","2019 ","214","51","163",
"41 s","Total","2000 ","2582","1589","993",
"41 s","Total","2001 ","3061","1883","1178",
"41 s","Total","2002 ","2478","1555","923",
"41 s","Total","2003 ","2341","1440","901",
"41 s","Total","2004 ","3618","1870","1748",
"41 s","Total","2005 ","4734","2494","2240",
"41 s","Total","2006 ","5777","3269","2508",
"41 s","Total","2007 ","5236","2975","2261",
"41 s","Total","2008 ","4214","2290","1924",
"41 s","Total","2009 ","3680","1985","1695",
"41 s","Total","2010 ","4618","2470","2148",
"41 s","Total","2011 ","4285","2321","1964",
"41 s","Total","2012 ","3888","2106","1782",
"41 s","Total","2013 ","5358","3049","2309",
"41 s","Total","2014 ","6063","3600","2463",
"41 s","Total","2015 ","4580","2627","1953",
"41 s","Total","2016 ","4860","2691","2169",
"41 s","Total","2017 ","6105","3460","2645",
"41 s","Total","2018 ","6672","3761","2911",
"41 s","Total","2019 ","5809","3127","2682",
"41 s","Sightseeing Pass","2000 ","242","153","89",
"41 s","Sightseeing Pass","2001 ","375","261","114",
"41 s","Sightseeing Pass","2002 ","409","289","120",
"41 s","Sightseeing Pass","2003 ","344","243","101",
"41 s","Sightseeing Pass","2004 ","334","220","114",
"41 s","Sightseeing Pass","2005 ","289","202","87",
"41 s","Sightseeing Pass","2006 ","270","175","95",
"41 s","Sightseeing Pass","2007 ","236","157","79",
"41 s","Sightseeing Pass","2008 ","252","163","89",
"41 s","Sightseeing Pass","2009 ","279","166","113",
"41 s","Sightseeing Pass","2010 ","363","232","131",
"41 s","Sightseeing Pass","2011 ","291","170","121",
"41 s","Sightseeing Pass","2012 ","330","175","155",
"41 s","Sightseeing Pass","2013 ","262","145","117",
"41 s","Sightseeing Pass","2014 ","312","191","121",
"41 s","Sightseeing Pass","2015 ","377","198","179",
"41 s","Sightseeing Pass","2016 ","350","183","167",
"41 s","Sightseeing Pass","2017 ","416","247","169",
"41 s","Sightseeing Pass","2018 ","680","411","269",
"41 s","Sightseeing Pass","2019 ","397","177","220",
"41 s","Short-term Business","2000 ","649","364","285",
"41 s","Short-term Business","2001 ","824","518","306",
"41 s","Short-term Business","2002 ","302","200","102",
"41 s","Short-term Business","2003 ","186","140","46",
"41 s","Short-term Business","2004 ","313","236","77",
"41 s","Short-term Business","2005 ","271","212","59",
"41 s","Short-term Business","2006 ","429","320","109",
"41 s","Short-term Business","2007 ","502","383","119",
"41 s","Short-term Business","2008 ","254","213","41",
"41 s","Short-term Business","2009 ","100","79","21",
"41 s","Short-term Business","2010 ","67","57","10",
"41 s","Short-term Business","2011 ","84","76","8",
"41 s","Short-term Visitors","2000 ","873","545","328",
"41 s","Short-term Visitors","2001 ","908","571","337",
"41 s","Short-term Visitors","2002 ","797","498","299",
"41 s","Short-term Visitors","2003 ","584","360","224",
"41 s","Short-term Visitors","2004 ","586","364","222",
"41 s","Short-term Visitors","2005 ","536","303","233",
"41 s","Short-term Visitors","2006 ","594","377","217",
"41 s","Short-term Visitors","2007 ","435","239","196",
"41 s","Short-term Visitors","2008 ","349","156","193",
"41 s","Short-term Visitors","2009 ","249","96","153",
"41 s","Short-term Visitors","2010 ","991","505","486",
"41 s","Short-term Visitors","2011 ","1164","597","567",
"41 s","Short-term Visitors","2012 ","996","527","469",
"41 s","Short-term Visitors","2013 ","1459","850","609",
"41 s","Short-term Visitors","2014 ","963","535","428",
"41 s","Short-term Visitors","2015 ","1060","587","473",
"41 s","Short-term Visitors","2016 ","1089","629","460",
"41 s","Short-term Visitors","2017 ","1156","696","460",
"41 s","Short-term Visitors","2018 ","1115","656","459",
"41 s","Short-term Visitors","2019 ","1214","761","453",
"41 s","Short-term Employment","2000 ","6","3","3",
"41 s","Short-term Employment","2001 ","4","2","2",
"41 s","Short-term Employment","2002 ","3","2","1",
"41 s","Short-term Employment","2003 ","5","5","0",
"41 s","Short-term Employment","2004 ","4","4","0",
"41 s","Short-term Employment","2005 ","3","1","2",
"41 s","Short-term Employment","2006 ","9","7","2",
"41 s","Short-term Employment","2007 ","1","1","0",
"41 s","Short-term Employment","2008 ","3","3","0",
"41 s","Short-term Employment","2009 ","3","2","1",
"41 s","Short-term Employment","2010 ","0","0","0",
"41 s","Short-term Employment","2011 ","1","","1",
"41 s","Short-term Employment","2012 ","2","1","1",
"41 s","Short-term Employment","2013 ","1","1","0",
"41 s","Short-term Employment","2014 ","1","1","0",
"41 s","Short-term Employment","2015 ","4","4","0",
"41 s","Short-term Employment","2016 ","9","8","1",
"41 s","Short-term Employment","2018 ","9","9","0",
"41 s","Short-term Employment","2019 ","7","6","1",
"41 s","Job Seeking","2000 ","0","0","0",
"41 s","Job Seeking","2001 ","0","0","0",
"41 s","Job Seeking","2002 ","0","0","0",
"41 s","Job Seeking","2003 ","0","0","0",
"41 s","Job Seeking","2004 ","0","0","0",
"41 s","Job Seeking","2005 ","0","0","0",
"41 s","Job Seeking","2006 ","0","0","0",
"41 s","Job Seeking","2007 ","0","0","0",
"41 s","Job Seeking","2008 ","0","0","0",
"41 s","Job Seeking","2009 ","0","0","0",
"41 s","Job Seeking","2010 ","0","0","0",
"41 s","Job Seeking","2013 ","1","1","0",
"41 s","Job Seeking","2014 ","1","1","0",
"41 s","Job Seeking","2015 ","2","2","0",
"41 s","Job Seeking","2017 ","4","2","2",
"41 s","Job Seeking","2019 ","2","2","0",
"41 s","study","2000 ","8","5","3",
"41 s","study","2001 ","10","6","4",
"41 s","study","2002 ","13","11","2",
"41 s","study","2003 ","10","9","1",
"41 s","study","2004 ","16","12","4",
"41 s","study","2005 ","11","6","5",
"41 s","study","2006 ","14","9","5",
"41 s","study","2007 ","16","13","3",
"41 s","study","2008 ","6","4","2",
"41 s","study","2009 ","13","8","5",
"41 s","study","2010 ","18","13","5",
"41 s","study","2011 ","19","14","5",
"41 s","study","2012 ","18","13","5",
"41 s","study","2013 ","17","12","5",
"41 s","study","2014 ","26","17","9",
"41 s","study","2015 ","16","9","7",
"41 s","study","2016 ","21","16","5",
"41 s","study","2017 ","27","19","8",
"41 s","study","2018 ","39","24","15",
"41 s","study","2019 ","60","34","26",
"41 s","General Trainees","2000 ","1","0","1",
"41 s","General Trainees","2001 ","4","4","0",
"41 s","General Trainees","2002 ","10","9","1",
"41 s","General Trainees","2003 ","5","4","1",
"41 s","General Trainees","2004 ","10","3","7",
"41 s","General Trainees","2005 ","10","6","4",
"41 s","General Trainees","2006 ","5","4","1",
"41 s","General Trainees","2007 ","11","7","4",
"41 s","General Trainees","2008 ","9","2","7",
"41 s","General Trainees","2009 ","6","1","5",
"41 s","General Trainees","2010 ","17","7","10",
"41 s","General Trainees","2011 ","31","15","16",
"41 s","General Trainees","2012 ","15","8","7",
"41 s","General Trainees","2013 ","16","12","4",
"41 s","General Trainees","2014 ","16","9","7",
"41 s","General Trainees","2015 ","23","17","6",
"41 s","General Trainees","2016 ","31","20","11",
"41 s","General Trainees","2017 ","19","13","6",
"41 s","General Trainees","2018 ","19","16","3",
"41 s","General Trainees","2019 ","10","8","2",
"41 s","Religious Activities","2000 ","4","1","3",
"41 s","Religious Activities","2001 ","4","3","1",
"41 s","Religious Activities","2002 ","2","1","1",
"41 s","Religious Activities","2003 ","7","5","2",
"41 s","Religious Activities","2004 ","4","1","3",
"41 s","Religious Activities","2005 ","7","3","4",
"41 s","Religious Activities","2006 ","8","8","0",
"41 s","Religious Activities","2007 ","8","5","3",
"41 s","Religious Activities","2008 ","5","0","5",
"41 s","Religious Activities","2009 ","9","6","3",
"41 s","Religious Activities","2010 ","8","6","2",
"41 s","Religious Activities","2011 ","8","4","4",
"41 s","Religious Activities","2012 ","4","2","2",
"41 s","Religious Activities","2013 ","4","4","0",
"41 s","Religious Activities","2014 ","7","4","3",
"41 s","Religious Activities","2015 ","6","1","5",
"41 s","Religious Activities","2016 ","4","2","2",
"41 s","Religious Activities","2017 ","5","4","1",
"41 s","Religious Activities","2018 ","4","3","1",
"41 s","Religious Activities","2019 ","5","3","2",
"41 s","Investors","2000 ","89","55","34",
"41 s","Investors","2001 ","66","44","22",
"41 s","Investors","2002 ","54","46","8",
"41 s","Investors","2003 ","35","31","4",
"41 s","Investors","2004 ","41","32","9",
"41 s","Investors","2005 ","49","45","4",
"41 s","Investors","2006 ","37","31","6",
"41 s","Investors","2007 ","38","36","2",
"41 s","Investors","2008 ","41","38","3",
"41 s","Investors","2009 ","32","28","4",
"41 s","Investors","2010 ","36","31","5",
"41 s","Investors","2011 ","41","38","3",
"41 s","Investors","2012 ","34","33","1",
"41 s","Investors","2013 ","38","36","2",
"41 s","Investors","2014 ","24","20","4",
"41 s","Investors","2015 ","25","25","0",
"41 s","Investors","2016 ","20","20","0",
"41 s","Investors","2017 ","17","16","1",
"41 s","Investors","2018 ","20","17","3",
"41 s","Investors","2019 ","19","17","2",
"41 s","Trade and Business","2000 ","12","11","1",
"41 s","Trade and Business","2001 ","23","22","1",
"41 s","Trade and Business","2002 ","15","14","1",
"41 s","Trade and Business","2003 ","15","14","1",
"41 s","Trade and Business","2004 ","11","10","1",
"41 s","Trade and Business","2005 ","32","31","1",
"41 s","Trade and Business","2006 ","9","9","0",
"41 s","Trade and Business","2007 ","24","24","0",
"41 s","Trade and Business","2008 ","17","17","0",
"41 s","Trade and Business","2009 ","22","20","2",
"41 s","Trade and Business","2010 ","24","24","0",
"41 s","Trade and Business","2011 ","31","29","2",
"41 s","Trade and Business","2012 ","34","34","",
"41 s","Trade and Business","2013 ","46","46","0",
"41 s","Trade and Business","2014 ","55","55","0",
"41 s","Trade and Business","2015 ","40","40","0",
"41 s","Trade and Business","2016 ","30","29","1",
"41 s","Trade and Business","2017 ","21","21","0",
"41 s","Trade and Business","2018 ","13","13","0",
"41 s","Trade and Business","2019 ","18","16","2",
"41 s","Research","2000 ","13","12","1",
"41 s","Research","2001 ","14","13","1",
"41 s","Research","2002 ","22","18","4",
"41 s","Research","2003 ","16","13","3",
"41 s","Research","2004 ","16","14","2",
"41 s","Research","2005 ","21","20","1",
"41 s","Research","2006 ","15","13","2",
"41 s","Research","2007 ","16","11","5",
"41 s","Research","2008 ","4","3","1",
"41 s","Research","2009 ","11","10","1",
"41 s","Research","2010 ","6","5","1",
"41 s","Research","2011 ","3","3","",
"41 s","Research","2012 ","9","8","1",
"41 s","Research","2013 ","10","9","1",
"41 s","Research","2014 ","8","6","2",
"41 s","Research","2015 ","7","4","3",
"41 s","Research","2016 ","8","8","0",
"41 s","Research","2017 ","9","7","2",
"41 s","Research","2018 ","14","13","1",
"41 s","Research","2019 ","8","8","0",
"41 s","Art and Entertainment","2000 ","16","11","5",
"41 s","Art and Entertainment","2001 ","6","5","1",
"41 s","Art and Entertainment","2002 ","18","14","4",
"41 s","Art and Entertainment","2003 ","20","15","5",
"41 s","Art and Entertainment","2004 ","21","15","6",
"41 s","Art and Entertainment","2005 ","21","18","3",
"41 s","Art and Entertainment","2006 ","13","5","8",
"41 s","Art and Entertainment","2007 ","23","15","8",
"41 s","Art and Entertainment","2008 ","24","16","8",
"41 s","Art and Entertainment","2009 ","9","6","3",
"41 s","Art and Entertainment","2010 ","12","10","2",
"41 s","Art and Entertainment","2011 ","11","8","3",
"41 s","Art and Entertainment","2012 ","14","8","6",
"41 s","Art and Entertainment","2013 ","9","5","4",
"41 s","Art and Entertainment","2014 ","4","4","0",
"41 s","Art and Entertainment","2015 ","14","11","3",
"41 s","Art and Entertainment","2016 ","3","1","2",
"41 s","Art and Entertainment","2017 ","7","5","2",
"41 s","Art and Entertainment","2018 ","10","5","5",
"41 s","Art and Entertainment","2019 ","7","3","4",
"41 s","Unskilled Employment","2000 ","0","0","0",
"41 s","Unskilled Employment","2001 ","0","0","0",
"41 s","Unskilled Employment","2002 ","0","0","0",
"41 s","Unskilled Employment","2003 ","27","15","12",
"41 s","Unskilled Employment","2004 ","100","62","38",
"41 s","Unskilled Employment","2005 ","122","112","10",
"41 s","Unskilled Employment","2006 ","107","76","31",
"41 s","Unskilled Employment","2007 ","30","17","13",
"41 s","Unskilled Employment","2008 ","57","54","3",
"41 s","Unskilled Employment","2009 ","113","110","3",
"41 s","Unskilled Employment","2010 ","45","45","0",
"41 s","Unskilled Employment","2011 ","58","57","1",
"41 s","Unskilled Employment","2012 ","148","137","11",
"41 s","Unskilled Employment","2013 ","204","187","17",
"41 s","Unskilled Employment","2014 ","135","131","4",
"41 s","Unskilled Employment","2015 ","161","158","3",
"41 s","Unskilled Employment","2016 ","216","210","6",
"41 s","Unskilled Employment","2017 ","269","247","22",
"41 s","Unskilled Employment","2018 ","221","211","10",
"41 s","Unskilled Employment","2019 ","181","177","4",
"41 s","Visiting and Joining Family","2000 ","60","5","55",
"41 s","Visiting and Joining Family","2001 ","228","10","218",
"41 s","Visiting and Joining Family","2002 ","111","9","102",
"41 s","Visiting and Joining Family","2003 ","329","174","155",
"41 s","Visiting and Joining Family","2004 ","788","402","386",
"41 s","Visiting and Joining Family","2005 ","2114","1068","1046",
"41 s","Visiting and Joining Family","2006 ","3297","1843","1454",
"41 s","Visiting and Joining Family","2007 ","444","238","206",
"41 s","Visiting and Joining Family","2008 ","17","7","10",
"41 s","Visiting and Joining Family","2009 ","29","13","16",
"41 s","Visiting and Joining Family","2010 ","53","15","38",
"41 s","Visiting and Joining Family","2011 ","59","37","22",
"41 s","Visiting and Joining Family","2012 ","40","14","26",
"41 s","Visiting and Joining Family","2013 ","45","17","28",
"41 s","Visiting and Joining Family","2014 ","71","17","54",
"41 s","Visiting and Joining Family","2015 ","95","23","72",
"41 s","Visiting and Joining Family","2016 ","198","51","147",
"41 s","Visiting and Joining Family","2017 ","166","52","114",
"41 s","Visiting and Joining Family","2018 ","180","50","130",
"41 s","Visiting and Joining Family","2019 ","239","49","190",
"41 s","Overseas Koreans","2000 ","16","6","10",
"41 s","Overseas Koreans","2001 ","22","11","11",
"41 s","Overseas Koreans","2002 ","36","20","16",
"41 s","Overseas Koreans","2003 ","25","18","7",
"41 s","Overseas Koreans","2004 ","36","20","16",
"41 s","Overseas Koreans","2005 ","44","19","25",
"41 s","Overseas Koreans","2006 ","32","21","11",
"41 s","Overseas Koreans","2007 ","37","20","17",
"41 s","Overseas Koreans","2008 ","54","33","21",
"41 s","Overseas Koreans","2009 ","50","29","21",
"41 s","Overseas Koreans","2010 ","156","92","64",
"41 s","Overseas Koreans","2011 ","201","105","96",
"41 s","Overseas Koreans","2012 ","214","134","80",
"41 s","Overseas Koreans","2013 ","288","161","127",
"41 s","Overseas Koreans","2014 ","336","190","146",
"41 s","Overseas Koreans","2015 ","369","224","145",
"41 s","Overseas Koreans","2016 ","518","284","234",
"41 s","Overseas Koreans","2017 ","497","288","209",
"41 s","Overseas Koreans","2018 ","515","280","235",
"41 s","Overseas Koreans","2019 ","548","285","263",
"41 s","Permanent Residence","2000 ","0","0","0",
"41 s","Permanent Residence","2001 ","0","0","0",
"41 s","Permanent Residence","2002 ","0","0","0",
"41 s","Permanent Residence","2003 ","5","3","2",
"41 s","Permanent Residence","2004 ","4","3","1",
"41 s","Permanent Residence","2005 ","3","3","0",
"41 s","Permanent Residence","2006 ","5","5","0",
"41 s","Permanent Residence","2007 ","5","2","3",
"41 s","Permanent Residence","2008 ","9","4","5",
"41 s","Permanent Residence","2009 ","11","2","9",
"41 s","Permanent Residence","2010 ","24","9","15",
"41 s","Permanent Residence","2011 ","70","17","53",
"41 s","Permanent Residence","2012 ","112","52","60",
"41 s","Permanent Residence","2013 ","116","41","75",
"41 s","Permanent Residence","2014 ","133","54","79",
"41 s","Permanent Residence","2015 ","125","55","70",
"41 s","Permanent Residence","2016 ","107","42","65",
"41 s","Permanent Residence","2017 ","106","42","64",
"41 s","Permanent Residence","2018 ","113","53","60",
"41 s","Permanent Residence","2019 ","131","56","75",
"41 s","Marriage Immigration","2011 ","10","3","7",
"41 s","Marriage Immigration","2012 ","221","51","170",
"41 s","Marriage Immigration","2013 ","254","49","205",
"41 s","Marriage Immigration","2014 ","150","35","115",
"41 s","Marriage Immigration","2015 ","133","33","100",
"41 s","Marriage Immigration","2016 ","143","43","100",
"41 s","Marriage Immigration","2017 ","128","30","98",
"41 s","Marriage Immigration","2018 ","152","38","114",
"41 s","Marriage Immigration","2019 ","148","42","106",
"42 s","Total","2000 ","2522","1549","973",
"42 s","Total","2001 ","2675","1630","1045",
"42 s","Total","2002 ","2647","1636","1011",
"42 s","Total","2003 ","2133","1259","874",
"42 s","Total","2004 ","2677","1437","1240",
"42 s","Total","2005 ","5068","2568","2500",
"42 s","Total","2006 ","6039","3345","2694",
"42 s","Total","2007 ","5651","3160","2491",
"42 s","Total","2008 ","4792","2601","2191",
"42 s","Total","2009 ","3296","1691","1605",
"42 s","Total","2010 ","4485","2364","2121",
"42 s","Total","2011 ","4353","2306","2047",
"42 s","Total","2012 ","3750","1939","1811",
"42 s","Total","2013 ","5629","3086","2543",
"42 s","Total","2014 ","6455","3709","2746",
"42 s","Total","2015 ","4813","2651","2162",
"42 s","Total","2016 ","4979","2793","2186",
"42 s","Total","2017 ","6015","3403","2612",
"42 s","Total","2018 ","6446","3594","2852",
"42 s","Total","2019 ","5498","2911","2587",
"42 s","Sightseeing Pass","2000 ","223","141","82",
"42 s","Sightseeing Pass","2001 ","333","242","91",
"42 s","Sightseeing Pass","2002 ","437","306","131",
"42 s","Sightseeing Pass","2003 ","319","214","105",
"42 s","Sightseeing Pass","2004 ","315","225","90",
"42 s","Sightseeing Pass","2005 ","282","176","106",
"42 s","Sightseeing Pass","2006 ","234","153","81",
"42 s","Sightseeing Pass","2007 ","242","135","107",
"42 s","Sightseeing Pass","2008 ","287","193","94",
"42 s","Sightseeing Pass","2009 ","269","166","103",
"42 s","Sightseeing Pass","2010 ","344","211","133",
"42 s","Sightseeing Pass","2011 ","264","146","118",
"42 s","Sightseeing Pass","2012 ","276","155","121",
"42 s","Sightseeing Pass","2013 ","269","144","125",
"42 s","Sightseeing Pass","2014 ","287","174","113",
"42 s","Sightseeing Pass","2015 ","391","201","190",
"42 s","Sightseeing Pass","2016 ","347","197","150",
"42 s","Sightseeing Pass","2017 ","410","234","176",
"42 s","Sightseeing Pass","2018 ","624","400","224",
"42 s","Sightseeing Pass","2019 ","371","169","202",
"42 s","Short-term Business","2000 ","645","396","249",
"42 s","Short-term Business","2001 ","659","426","233",
"42 s","Short-term Business","2002 ","370","254","116",
"42 s","Short-term Business","2003 ","206","154","52",
"42 s","Short-term Business","2004 ","191","162","29",
"42 s","Short-term Business","2005 ","242","185","57",
"42 s","Short-term Business","2006 ","409","308","101",
"42 s","Short-term Business","2007 ","491","390","101",
"42 s","Short-term Business","2008 ","242","198","44",
"42 s","Short-term Business","2009 ","78","65","13",
"42 s","Short-term Business","2010 ","77","59","18",
"42 s","Short-term Business","2011 ","80","65","15",
"42 s","Short-term Visitors","2000 ","894","542","352",
"42 s","Short-term Visitors","2001 ","833","483","350",
"42 s","Short-term Visitors","2002 ","937","595","342",
"42 s","Short-term Visitors","2003 ","547","325","222",
"42 s","Short-term Visitors","2004 ","480","288","192",
"42 s","Short-term Visitors","2005 ","583","351","232",
"42 s","Short-term Visitors","2006 ","621","379","242",
"42 s","Short-term Visitors","2007 ","433","250","183",
"42 s","Short-term Visitors","2008 ","365","170","195",
"42 s","Short-term Visitors","2009 ","246","100","146",
"42 s","Short-term Visitors","2010 ","1054","496","558",
"42 s","Short-term Visitors","2011 ","1359","695","664",
"42 s","Short-term Visitors","2012 ","1041","496","545",
"42 s","Short-term Visitors","2013 ","1611","868","743",
"42 s","Short-term Visitors","2014 ","1130","620","510",
"42 s","Short-term Visitors","2015 ","1217","671","546",
"42 s","Short-term Visitors","2016 ","1138","665","473",
"42 s","Short-term Visitors","2017 ","1214","750","464",
"42 s","Short-term Visitors","2018 ","1185","682","503",
"42 s","Short-term Visitors","2019 ","1167","711","456",
"42 s","Short-term Employment","2000 ","4","4","0",
"42 s","Short-term Employment","2001 ","3","3","0",
"42 s","Short-term Employment","2002 ","2","1","1",
"42 s","Short-term Employment","2003 ","2","1","1",
"42 s","Short-term Employment","2004 ","3","2","1",
"42 s","Short-term Employment","2005 ","4","2","2",
"42 s","Short-term Employment","2006 ","8","6","2",
"42 s","Short-term Employment","2007 ","4","2","2",
"42 s","Short-term Employment","2008 ","2","1","1",
"42 s","Short-term Employment","2009 ","1","1","0",
"42 s","Short-term Employment","2010 ","2","2","0",
"42 s","Short-term Employment","2013 ","1","1","0",
"42 s","Short-term Employment","2014 ","2","2","0",
"42 s","Short-term Employment","2016 ","11","10","1",
"42 s","Short-term Employment","2017 ","3","2","1",
"42 s","Short-term Employment","2018 ","5","3","2",
"42 s","Short-term Employment","2019 ","5","5","0",
"42 s","Job Seeking","2000 ","0","0","0",
"42 s","Job Seeking","2001 ","0","0","0",
"42 s","Job Seeking","2002 ","0","0","0",
"42 s","Job Seeking","2003 ","0","0","0",
"42 s","Job Seeking","2004 ","0","0","0",
"42 s","Job Seeking","2005 ","0","0","0",
"42 s","Job Seeking","2006 ","0","0","0",
"42 s","Job Seeking","2007 ","0","0","0",
"42 s","Job Seeking","2008 ","0","0","0",
"42 s","Job Seeking","2009 ","0","0","0",
"42 s","Job Seeking","2010 ","1","0","1",
"42 s","Job Seeking","2013 ","2","2","0",
"42 s","Job Seeking","2015 ","1","1","0",
"42 s","Job Seeking","2016 ","2","1","1",
"42 s","Job Seeking","2017 ","1","1","0",
"42 s","Job Seeking","2018 ","2","1","1",
"42 s","study","2000 ","9","7","2",
"42 s","study","2001 ","6","5","1",
"42 s","study","2002 ","8","6","2",
"42 s","study","2003 ","5","3","2",
"42 s","study","2004 ","11","7","4",
"42 s","study","2005 ","11","9","2",
"42 s","study","2006 ","11","11","0",
"42 s","study","2007 ","10","7","3",
"42 s","study","2008 ","15","13","2",
"42 s","study","2009 ","6","3","3",
"42 s","study","2010 ","13","9","4",
"42 s","study","2011 ","14","8","6",
"42 s","study","2012 ","12","10","2",
"42 s","study","2013 ","13","9","4",
"42 s","study","2014 ","13","12","1",
"42 s","study","2015 ","20","14","6",
"42 s","study","2016 ","13","9","4",
"42 s","study","2017 ","25","17","8",
"42 s","study","2018 ","28","17","11",
"42 s","study","2019 ","54","27","27",
"42 s","General Trainees","2000 ","6","6","0",
"42 s","General Trainees","2001 ","6","3","3",
"42 s","General Trainees","2002 ","5","3","2",
"42 s","General Trainees","2003 ","6","5","1",
"42 s","General Trainees","2004 ","5","4","1",
"42 s","General Trainees","2005 ","7","4","3",
"42 s","General Trainees","2006 ","12","10","2",
"42 s","General Trainees","2007 ","10","6","4",
"42 s","General Trainees","2008 ","10","6","4",
"42 s","General Trainees","2009 ","8","7","1",
"42 s","General Trainees","2010 ","15","9","6",
"42 s","General Trainees","2011 ","51","29","22",
"42 s","General Trainees","2012 ","14","10","4",
"42 s","General Trainees","2013 ","13","11","2",
"42 s","General Trainees","2014 ","13","7","6",
"42 s","General Trainees","2015 ","17","11","6",
"42 s","General Trainees","2016 ","26","22","4",
"42 s","General Trainees","2017 ","22","12","10",
"42 s","General Trainees","2018 ","12","9","3",
"42 s","General Trainees","2019 ","20","10","10",
"42 s","Religious Activities","2000 ","5","4","1",
"42 s","Religious Activities","2001 ","5","3","2",
"42 s","Religious Activities","2002 ","5","2","3",
"42 s","Religious Activities","2003 ","2","1","1",
"42 s","Religious Activities","2004 ","5","2","3",
"42 s","Religious Activities","2005 ","4","0","4",
"42 s","Religious Activities","2006 ","10","8","2",
"42 s","Religious Activities","2007 ","5","2","3",
"42 s","Religious Activities","2008 ","4","3","1",
"42 s","Religious Activities","2009 ","9","1","8",
"42 s","Religious Activities","2010 ","7","5","2",
"42 s","Religious Activities","2011 ","6","4","2",
"42 s","Religious Activities","2012 ","4","2","2",
"42 s","Religious Activities","2013 ","7","5","2",
"42 s","Religious Activities","2014 ","5","5","0",
"42 s","Religious Activities","2015 ","4","2","2",
"42 s","Religious Activities","2016 ","3","2","1",
"42 s","Religious Activities","2017 ","5","2","3",
"42 s","Religious Activities","2018 ","5","3","2",
"42 s","Religious Activities","2019 ","6","4","2",
"42 s","Investors","2000 ","67","37","30",
"42 s","Investors","2001 ","80","60","20",
"42 s","Investors","2002 ","26","23","3",
"42 s","Investors","2003 ","30","24","6",
"42 s","Investors","2004 ","36","31","5",
"42 s","Investors","2005 ","39","28","11",
"42 s","Investors","2006 ","33","29","4",
"42 s","Investors","2007 ","37","34","3",
"42 s","Investors","2008 ","35","30","5",
"42 s","Investors","2009 ","25","22","3",
"42 s","Investors","2010 ","35","33","2",
"42 s","Investors","2011 ","41","34","7",
"42 s","Investors","2012 ","31","31","",
"42 s","Investors","2013 ","37","37","0",
"42 s","Investors","2014 ","14","14","0",
"42 s","Investors","2015 ","23","21","2",
"42 s","Investors","2016 ","29","28","1",
"42 s","Investors","2017 ","11","11","0",
"42 s","Investors","2018 ","21","20","1",
"42 s","Investors","2019 ","13","12","1",
"42 s","Trade and Business","2000 ","10","10","0",
"42 s","Trade and Business","2001 ","20","19","1",
"42 s","Trade and Business","2002 ","13","13","0",
"42 s","Trade and Business","2003 ","11","11","0",
"42 s","Trade and Business","2004 ","15","14","1",
"42 s","Trade and Business","2005 ","26","26","0",
"42 s","Trade and Business","2006 ","16","16","0",
"42 s","Trade and Business","2007 ","21","21","0",
"42 s","Trade and Business","2008 ","19","18","1",
"42 s","Trade and Business","2009 ","23","22","1",
"42 s","Trade and Business","2010 ","25","25","0",
"42 s","Trade and Business","2011 ","22","22","",
"42 s","Trade and Business","2012 ","26","26","",
"42 s","Trade and Business","2013 ","44","43","1",
"42 s","Trade and Business","2014 ","57","55","2",
"42 s","Trade and Business","2015 ","38","38","0",
"42 s","Trade and Business","2016 ","32","30","2",
"42 s","Trade and Business","2017 ","19","18","1",
"42 s","Trade and Business","2018 ","15","15","0",
"42 s","Trade and Business","2019 ","18","18","0",
"42 s","Research","2000 ","10","7","3",
"42 s","Research","2001 ","10","7","3",
"42 s","Research","2002 ","17","12","5",
"42 s","Research","2003 ","11","8","3",
"42 s","Research","2004 ","9","6","3",
"42 s","Research","2005 ","14","13","1",
"42 s","Research","2006 ","16","11","5",
"42 s","Research","2007 ","14","11","3",
"42 s","Research","2008 ","12","11","1",
"42 s","Research","2009 ","4","4","0",
"42 s","Research","2010 ","8","7","1",
"42 s","Research","2011 ","10","8","2",
"42 s","Research","2012 ","9","8","1",
"42 s","Research","2013 ","12","10","2",
"42 s","Research","2014 ","9","8","1",
"42 s","Research","2015 ","6","5","1",
"42 s","Research","2016 ","8","6","2",
"42 s","Research","2017 ","3","2","1",
"42 s","Research","2018 ","5","5","0",
"42 s","Research","2019 ","14","13","1",
"42 s","Art and Entertainment","2000 ","16","16","0",
"42 s","Art and Entertainment","2001 ","12","7","5",
"42 s","Art and Entertainment","2002 ","9","7","2",
"42 s","Art and Entertainment","2003 ","13","10","3",
"42 s","Art and Entertainment","2004 ","17","14","3",
"42 s","Art and Entertainment","2005 ","12","9","3",
"42 s","Art and Entertainment","2006 ","14","12","2",
"42 s","Art and Entertainment","2007 ","15","12","3",
"42 s","Art and Entertainment","2008 ","12","10","2",
"42 s","Art and Entertainment","2009 ","11","9","2",
"42 s","Art and Entertainment","2010 ","12","8","4",
"42 s","Art and Entertainment","2011 ","11","7","4",
"42 s","Art and Entertainment","2012 ","13","10","3",
"42 s","Art and Entertainment","2013 ","10","6","4",
"42 s","Art and Entertainment","2014 ","9","6","3",
"42 s","Art and Entertainment","2015 ","5","5","0",
"42 s","Art and Entertainment","2016 ","11","8","3",
"42 s","Art and Entertainment","2017 ","5","3","2",
"42 s","Art and Entertainment","2018 ","9","7","2",
"42 s","Art and Entertainment","2019 ","13","8","5",
"42 s","Unskilled Employment","2000 ","0","0","0",
"42 s","Unskilled Employment","2001 ","0","0","0",
"42 s","Unskilled Employment","2002 ","0","0","0",
"42 s","Unskilled Employment","2003 ","28","13","15",
"42 s","Unskilled Employment","2004 ","66","40","26",
"42 s","Unskilled Employment","2005 ","33","25","8",
"42 s","Unskilled Employment","2006 ","90","47","43",
"42 s","Unskilled Employment","2007 ","21","10","11",
"42 s","Unskilled Employment","2008 ","22","22","0",
"42 s","Unskilled Employment","2009 ","38","36","2",
"42 s","Unskilled Employment","2010 ","25","24","1",
"42 s","Unskilled Employment","2011 ","18","18","",
"42 s","Unskilled Employment","2012 ","89","84","5",
"42 s","Unskilled Employment","2013 ","156","149","7",
"42 s","Unskilled Employment","2014 ","71","68","3",
"42 s","Unskilled Employment","2015 ","79","76","3",
"42 s","Unskilled Employment","2016 ","179","170","9",
"42 s","Unskilled Employment","2017 ","165","158","7",
"42 s","Unskilled Employment","2018 ","172","167","5",
"42 s","Unskilled Employment","2019 ","110","107","3",
"42 s","Visiting and Joining Family","2000 ","88","4","84",
"42 s","Visiting and Joining Family","2001 ","160","3","157",
"42 s","Visiting and Joining Family","2002 ","108","6","102",
"42 s","Visiting and Joining Family","2003 ","257","138","119",
"42 s","Visiting and Joining Family","2004 ","551","268","283",
"42 s","Visiting and Joining Family","2005 ","2540","1292","1248",
"42 s","Visiting and Joining Family","2006 ","3587","1976","1611",
"42 s","Visiting and Joining Family","2007 ","448","230","218",
"42 s","Visiting and Joining Family","2008 ","20","9","11",
"42 s","Visiting and Joining Family","2009 ","28","9","19",
"42 s","Visiting and Joining Family","2010 ","74","37","37",
"42 s","Visiting and Joining Family","2011 ","59","25","34",
"42 s","Visiting and Joining Family","2012 ","35","9","26",
"42 s","Visiting and Joining Family","2013 ","62","14","48",
"42 s","Visiting and Joining Family","2014 ","65","12","53",
"42 s","Visiting and Joining Family","2015 ","119","30","89",
"42 s","Visiting and Joining Family","2016 ","186","64","122",
"42 s","Visiting and Joining Family","2017 ","190","56","134",
"42 s","Visiting and Joining Family","2018 ","238","68","170",
"42 s","Visiting and Joining Family","2019 ","286","64","222",
"42 s","Overseas Koreans","2000 ","17","11","6",
"42 s","Overseas Koreans","2001 ","17","6","11",
"42 s","Overseas Koreans","2002 ","29","15","14",
"42 s","Overseas Koreans","2003 ","36","22","14",
"42 s","Overseas Koreans","2004 ","25","12","13",
"42 s","Overseas Koreans","2005 ","32","13","19",
"42 s","Overseas Koreans","2006 ","26","14","12",
"42 s","Overseas Koreans","2007 ","46","26","20",
"42 s","Overseas Koreans","2008 ","42","26","16",
"42 s","Overseas Koreans","2009 ","36","25","11",
"42 s","Overseas Koreans","2010 ","151","73","78",
"42 s","Overseas Koreans","2011 ","187","99","88",
"42 s","Overseas Koreans","2012 ","220","126","94",
"42 s","Overseas Koreans","2013 ","350","191","159",
"42 s","Overseas Koreans","2014 ","323","189","134",
"42 s","Overseas Koreans","2015 ","390","232","158",
"42 s","Overseas Koreans","2016 ","534","288","246",
"42 s","Overseas Koreans","2017 ","502","278","224",
"42 s","Overseas Koreans","2018 ","518","281","237",
"42 s","Overseas Koreans","2019 ","508","278","230",
"42 s","Permanent Residence","2000 ","0","0","0",
"42 s","Permanent Residence","2001 ","0","0","0",
"42 s","Permanent Residence","2002 ","0","0","0",
"42 s","Permanent Residence","2003 ","3","2","1",
"42 s","Permanent Residence","2004 ","6","3","3",
"42 s","Permanent Residence","2005 ","5","2","3",
"42 s","Permanent Residence","2006 ","2","1","1",
"42 s","Permanent Residence","2007 ","7","1","6",
"42 s","Permanent Residence","2008 ","7","3","4",
"42 s","Permanent Residence","2009 ","14","3","11",
"42 s","Permanent Residence","2010 ","32","15","17",
"42 s","Permanent Residence","2011 ","83","37","46",
"42 s","Permanent Residence","2012 ","113","52","61",
"42 s","Permanent Residence","2013 ","136","47","89",
"42 s","Permanent Residence","2014 ","151","71","80",
"42 s","Permanent Residence","2015 ","126","60","66",
"42 s","Permanent Residence","2016 ","129","58","71",
"42 s","Permanent Residence","2017 ","112","47","65",
"42 s","Permanent Residence","2018 ","107","42","65",
"42 s","Permanent Residence","2019 ","118","39","79",
"42 s","Marriage Immigration","2011 ","2","","2",
"42 s","Marriage Immigration","2012 ","222","49","173",
"42 s","Marriage Immigration","2013 ","218","54","164",
"42 s","Marriage Immigration","2014 ","165","39","126",
"42 s","Marriage Immigration","2015 ","138","29","109",
"42 s","Marriage Immigration","2016 ","136","40","96",
"42 s","Marriage Immigration","2017 ","138","44","94",
"42 s","Marriage Immigration","2018 ","140","38","102",
"42 s","Marriage Immigration","2019 ","159","41","118",
"43 s","Total","2000 ","2266","1391","875",
"43 s","Total","2001 ","2627","1653","974",
"43 s","Total","2002 ","2310","1418","892",
"43 s","Total","2003 ","2493","1463","1030",
"43 s","Total","2004 ","2464","1340","1124",
"43 s","Total","2005 ","3744","1940","1804",
"43 s","Total","2006 ","6327","3488","2839",
"43 s","Total","2007 ","5702","3043","2659",
"43 s","Total","2008 ","4971","2581","2390",
"43 s","Total","2009 ","3800","1956","1844",
"43 s","Total","2010 ","4015","2107","1908",
"43 s","Total","2011 ","3819","1933","1886",
"43 s","Total","2012 ","3630","1878","1752",
"43 s","Total","2013 ","5480","2919","2561",
"43 s","Total","2014 ","6766","3845","2921",
"43 s","Total","2015 ","5075","2770","2305",
"43 s","Total","2016 ","5170","2866","2304",
"43 s","Total","2017 ","6083","3321","2762",
"43 s","Total","2018 ","6144","3428","2716",
"43 s","Total","2019 ","5212","2703","2509",
"43 s","Sightseeing Pass","2000 ","212","142","70",
"43 s","Sightseeing Pass","2001 ","393","271","122",
"43 s","Sightseeing Pass","2002 ","381","266","115",
"43 s","Sightseeing Pass","2003 ","332","234","98",
"43 s","Sightseeing Pass","2004 ","330","213","117",
"43 s","Sightseeing Pass","2005 ","271","172","99",
"43 s","Sightseeing Pass","2006 ","229","156","73",
"43 s","Sightseeing Pass","2007 ","226","147","79",
"43 s","Sightseeing Pass","2008 ","253","171","82",
"43 s","Sightseeing Pass","2009 ","225","131","94",
"43 s","Sightseeing Pass","2010 ","306","195","111",
"43 s","Sightseeing Pass","2011 ","285","148","137",
"43 s","Sightseeing Pass","2012 ","264","165","99",
"43 s","Sightseeing Pass","2013 ","239","134","105",
"43 s","Sightseeing Pass","2014 ","306","183","123",
"43 s","Sightseeing Pass","2015 ","401","218","183",
"43 s","Sightseeing Pass","2016 ","378","213","165",
"43 s","Sightseeing Pass","2017 ","359","210","149",
"43 s","Sightseeing Pass","2018 ","663","421","242",
"43 s","Sightseeing Pass","2019 ","352","151","201",
"43 s","Short-term Business","2000 ","577","363","214",
"43 s","Short-term Business","2001 ","662","449","213",
"43 s","Short-term Business","2002 ","296","209","87",
"43 s","Short-term Business","2003 ","210","173","37",
"43 s","Short-term Business","2004 ","147","119","28",
"43 s","Short-term Business","2005 ","164","131","33",
"43 s","Short-term Business","2006 ","395","302","93",
"43 s","Short-term Business","2007 ","420","334","86",
"43 s","Short-term Business","2008 ","218","180","38",
"43 s","Short-term Business","2009 ","57","47","10",
"43 s","Short-term Business","2010 ","74","62","12",
"43 s","Short-term Business","2011 ","47","37","10",
"43 s","Short-term Visitors","2000 ","780","455","325",
"43 s","Short-term Visitors","2001 ","793","475","318",
"43 s","Short-term Visitors","2002 ","852","522","330",
"43 s","Short-term Visitors","2003 ","640","370","270",
"43 s","Short-term Visitors","2004 ","474","279","195",
"43 s","Short-term Visitors","2005 ","475","272","203",
"43 s","Short-term Visitors","2006 ","687","402","285",
"43 s","Short-term Visitors","2007 ","439","235","204",
"43 s","Short-term Visitors","2008 ","382","165","217",
"43 s","Short-term Visitors","2009 ","255","110","145",
"43 s","Short-term Visitors","2010 ","945","429","516",
"43 s","Short-term Visitors","2011 ","1230","579","651",
"43 s","Short-term Visitors","2012 ","1120","526","594",
"43 s","Short-term Visitors","2013 ","1677","843","834",
"43 s","Short-term Visitors","2014 ","1187","660","527",
"43 s","Short-term Visitors","2015 ","1331","737","594",
"43 s","Short-term Visitors","2016 ","1300","766","534",
"43 s","Short-term Visitors","2017 ","1199","721","478",
"43 s","Short-term Visitors","2018 ","1173","661","512",
"43 s","Short-term Visitors","2019 ","1159","669","490",
"43 s","Short-term Employment","2000 ","3","3","0",
"43 s","Short-term Employment","2001 ","3","2","1",
"43 s","Short-term Employment","2002 ","2","2","0",
"43 s","Short-term Employment","2003 ","8","6","2",
"43 s","Short-term Employment","2004 ","3","2","1",
"43 s","Short-term Employment","2005 ","7","5","2",
"43 s","Short-term Employment","2006 ","1","1","0",
"43 s","Short-term Employment","2007 ","6","6","0",
"43 s","Short-term Employment","2008 ","2","2","0",
"43 s","Short-term Employment","2009 ","2","1","1",
"43 s","Short-term Employment","2010 ","0","0","0",
"43 s","Short-term Employment","2011 ","2","1","1",
"43 s","Short-term Employment","2012 ","1","1","",
"43 s","Short-term Employment","2014 ","1","1","0",
"43 s","Short-term Employment","2015 ","2","2","0",
"43 s","Short-term Employment","2016 ","8","8","0",
"43 s","Short-term Employment","2017 ","2","2","0",
"43 s","Short-term Employment","2019 ","5","3","2",
"43 s","Job Seeking","2000 ","0","0","0",
"43 s","Job Seeking","2001 ","0","0","0",
"43 s","Job Seeking","2002 ","0","0","0",
"43 s","Job Seeking","2003 ","0","0","0",
"43 s","Job Seeking","2004 ","0","0","0",
"43 s","Job Seeking","2005 ","0","0","0",
"43 s","Job Seeking","2006 ","0","0","0",
"43 s","Job Seeking","2007 ","0","0","0",
"43 s","Job Seeking","2008 ","0","0","0",
"43 s","Job Seeking","2009 ","0","0","0",
"43 s","Job Seeking","2010 ","0","0","0",
"43 s","Job Seeking","2013 ","2","2","0",
"43 s","Job Seeking","2014 ","2","1","1",
"43 s","Job Seeking","2016 ","1","0","1",
"43 s","Job Seeking","2018 ","1","1","0",
"43 s","Job Seeking","2019 ","1","1","0",
"43 s","study","2000 ","8","6","2",
"43 s","study","2001 ","9","6","3",
"43 s","study","2002 ","3","2","1",
"43 s","study","2003 ","10","8","2",
"43 s","study","2004 ","6","3","3",
"43 s","study","2005 ","2","1","1",
"43 s","study","2006 ","9","7","2",
"43 s","study","2007 ","14","11","3",
"43 s","study","2008 ","10","7","3",
"43 s","study","2009 ","8","4","4",
"43 s","study","2010 ","10","7","3",
"43 s","study","2011 ","14","12","2",
"43 s","study","2012 ","13","10","3",
"43 s","study","2013 ","19","13","6",
"43 s","study","2014 ","10","5","5",
"43 s","study","2015 ","16","11","5",
"43 s","study","2016 ","15","12","3",
"43 s","study","2017 ","24","15","9",
"43 s","study","2018 ","29","23","6",
"43 s","study","2019 ","26","16","10",
"43 s","General Trainees","2000 ","5","5","0",
"43 s","General Trainees","2001 ","6","5","1",
"43 s","General Trainees","2002 ","3","3","0",
"43 s","General Trainees","2003 ","3","2","1",
"43 s","General Trainees","2004 ","4","1","3",
"43 s","General Trainees","2005 ","9","6","3",
"43 s","General Trainees","2006 ","8","5","3",
"43 s","General Trainees","2007 ","7","7","0",
"43 s","General Trainees","2008 ","9","5","4",
"43 s","General Trainees","2009 ","5","3","2",
"43 s","General Trainees","2010 ","9","5","4",
"43 s","General Trainees","2011 ","23","15","8",
"43 s","General Trainees","2012 ","16","11","5",
"43 s","General Trainees","2013 ","13","8","5",
"43 s","General Trainees","2014 ","12","9","3",
"43 s","General Trainees","2015 ","9","4","5",
"43 s","General Trainees","2016 ","19","15","4",
"43 s","General Trainees","2017 ","11","5","6",
"43 s","General Trainees","2018 ","14","10","4",
"43 s","General Trainees","2019 ","9","3","6",
"43 s","Religious Activities","2000 ","5","4","1",
"43 s","Religious Activities","2001 ","6","3","3",
"43 s","Religious Activities","2002 ","4","3","1",
"43 s","Religious Activities","2003 ","9","5","4",
"43 s","Religious Activities","2004 ","4","3","1",
"43 s","Religious Activities","2005 ","1","0","1",
"43 s","Religious Activities","2006 ","6","5","1",
"43 s","Religious Activities","2007 ","10","7","3",
"43 s","Religious Activities","2008 ","10","7","3",
"43 s","Religious Activities","2009 ","5","2","3",
"43 s","Religious Activities","2010 ","4","2","2",
"43 s","Religious Activities","2011 ","5","5","",
"43 s","Religious Activities","2012 ","5","5","",
"43 s","Religious Activities","2013 ","4","3","1",
"43 s","Religious Activities","2014 ","4","1","3",
"43 s","Religious Activities","2015 ","4","2","2",
"43 s","Religious Activities","2016 ","2","0","2",
"43 s","Religious Activities","2017 ","2","0","2",
"43 s","Religious Activities","2018 ","1","0","1",
"43 s","Religious Activities","2019 ","2","1","1",
"43 s","Investors","2000 ","78","51","27",
"43 s","Investors","2001 ","58","45","13",
"43 s","Investors","2002 ","32","30","2",
"43 s","Investors","2003 ","30","28","2",
"43 s","Investors","2004 ","34","28","6",
"43 s","Investors","2005 ","37","32","5",
"43 s","Investors","2006 ","26","25","1",
"43 s","Investors","2007 ","27","25","2",
"43 s","Investors","2008 ","29","26","3",
"43 s","Investors","2009 ","24","20","4",
"43 s","Investors","2010 ","31","29","2",
"43 s","Investors","2011 ","30","29","1",
"43 s","Investors","2012 ","27","27","",
"43 s","Investors","2013 ","31","31","0",
"43 s","Investors","2014 ","13","13","0",
"43 s","Investors","2015 ","11","10","1",
"43 s","Investors","2016 ","27","26","1",
"43 s","Investors","2017 ","16","15","1",
"43 s","Investors","2018 ","18","16","2",
"43 s","Investors","2019 ","19","18","1",
"43 s","Trade and Business","2000 ","6","6","0",
"43 s","Trade and Business","2001 ","13","13","0",
"43 s","Trade and Business","2002 ","16","15","1",
"43 s","Trade and Business","2003 ","17","17","0",
"43 s","Trade and Business","2004 ","12","11","1",
"43 s","Trade and Business","2005 ","18","17","1",
"43 s","Trade and Business","2006 ","19","19","0",
"43 s","Trade and Business","2007 ","19","19","0",
"43 s","Trade and Business","2008 ","12","12","0",
"43 s","Trade and Business","2009 ","17","17","0",
"43 s","Trade and Business","2010 ","19","19","0",
"43 s","Trade and Business","2011 ","27","27","",
"43 s","Trade and Business","2012 ","26","25","1",
"43 s","Trade and Business","2013 ","32","30","2",
"43 s","Trade and Business","2014 ","63","62","1",
"43 s","Trade and Business","2015 ","42","41","1",
"43 s","Trade and Business","2016 ","28","28","0",
"43 s","Trade and Business","2017 ","22","21","1",
"43 s","Trade and Business","2018 ","26","26","0",
"43 s","Trade and Business","2019 ","16","15","1",
"43 s","Research","2000 ","11","10","1",
"43 s","Research","2001 ","12","8","4",
"43 s","Research","2002 ","13","12","1",
"43 s","Research","2003 ","18","16","2",
"43 s","Research","2004 ","9","8","1",
"43 s","Research","2005 ","13","11","2",
"43 s","Research","2006 ","10","10","0",
"43 s","Research","2007 ","15","14","1",
"43 s","Research","2008 ","9","8","1",
"43 s","Research","2009 ","1","1","0",
"43 s","Research","2010 ","13","12","1",
"43 s","Research","2011 ","5","5","",
"43 s","Research","2012 ","8","8","",
"43 s","Research","2013 ","5","5","0",
"43 s","Research","2014 ","5","4","1",
"43 s","Research","2015 ","5","5","0",
"43 s","Research","2016 ","9","8","1",
"43 s","Research","2017 ","3","3","0",
"43 s","Research","2018 ","6","6","0",
"43 s","Research","2019 ","12","11","1",
"43 s","Art and Entertainment","2000 ","7","6","1",
"43 s","Art and Entertainment","2001 ","12","11","1",
"43 s","Art and Entertainment","2002 ","6","5","1",
"43 s","Art and Entertainment","2003 ","18","18","0",
"43 s","Art and Entertainment","2004 ","14","9","5",
"43 s","Art and Entertainment","2005 ","21","14","7",
"43 s","Art and Entertainment","2006 ","15","11","4",
"43 s","Art and Entertainment","2007 ","16","13","3",
"43 s","Art and Entertainment","2008 ","19","12","7",
"43 s","Art and Entertainment","2009 ","12","9","3",
"43 s","Art and Entertainment","2010 ","12","7","5",
"43 s","Art and Entertainment","2011 ","11","8","3",
"43 s","Art and Entertainment","2012 ","12","8","4",
"43 s","Art and Entertainment","2013 ","12","9","3",
"43 s","Art and Entertainment","2014 ","8","7","1",
"43 s","Art and Entertainment","2015 ","6","4","2",
"43 s","Art and Entertainment","2016 ","5","4","1",
"43 s","Art and Entertainment","2017 ","4","3","1",
"43 s","Art and Entertainment","2018 ","2","1","1",
"43 s","Art and Entertainment","2019 ","6","3","3",
"43 s","Unskilled Employment","2000 ","0","0","0",
"43 s","Unskilled Employment","2001 ","0","0","0",
"43 s","Unskilled Employment","2002 ","0","0","0",
"43 s","Unskilled Employment","2003 ","27","16","11",
"43 s","Unskilled Employment","2004 ","71","44","27",
"43 s","Unskilled Employment","2005 ","29","20","9",
"43 s","Unskilled Employment","2006 ","63","39","24",
"43 s","Unskilled Employment","2007 ","13","6","7",
"43 s","Unskilled Employment","2008 ","14","11","3",
"43 s","Unskilled Employment","2009 ","13","12","1",
"43 s","Unskilled Employment","2010 ","6","6","0",
"43 s","Unskilled Employment","2011 ","9","8","1",
"43 s","Unskilled Employment","2012 ","58","53","5",
"43 s","Unskilled Employment","2013 ","131","129","2",
"43 s","Unskilled Employment","2014 ","58","55","3",
"43 s","Unskilled Employment","2015 ","58","54","4",
"43 s","Unskilled Employment","2016 ","136","130","6",
"43 s","Unskilled Employment","2017 ","130","123","7",
"43 s","Unskilled Employment","2018 ","96","92","4",
"43 s","Unskilled Employment","2019 ","74","73","1",
"43 s","Visiting and Joining Family","2000 ","77","3","74",
"43 s","Visiting and Joining Family","2001 ","146","8","138",
"43 s","Visiting and Joining Family","2002 ","113","9","104",
"43 s","Visiting and Joining Family","2003 ","452","230","222",
"43 s","Visiting and Joining Family","2004 ","469","255","214",
"43 s","Visiting and Joining Family","2005 ","1722","878","844",
"43 s","Visiting and Joining Family","2006 ","3888","2136","1752",
"43 s","Visiting and Joining Family","2007 ","576","256","320",
"43 s","Visiting and Joining Family","2008 ","39","19","20",
"43 s","Visiting and Joining Family","2009 ","29","11","18",
"43 s","Visiting and Joining Family","2010 ","54","21","33",
"43 s","Visiting and Joining Family","2011 ","74","34","40",
"43 s","Visiting and Joining Family","2012 ","42","18","24",
"43 s","Visiting and Joining Family","2013 ","52","14","38",
"43 s","Visiting and Joining Family","2014 ","112","18","94",
"43 s","Visiting and Joining Family","2015 ","141","33","108",
"43 s","Visiting and Joining Family","2016 ","267","91","176",
"43 s","Visiting and Joining Family","2017 ","232","62","170",
"43 s","Visiting and Joining Family","2018 ","244","79","165",
"43 s","Visiting and Joining Family","2019 ","306","103","203",
"43 s","Overseas Koreans","2000 ","21","11","10",
"43 s","Overseas Koreans","2001 ","22","12","10",
"43 s","Overseas Koreans","2002 ","32","14","18",
"43 s","Overseas Koreans","2003 ","35","19","16",
"43 s","Overseas Koreans","2004 ","31","14","17",
"43 s","Overseas Koreans","2005 ","45","20","25",
"43 s","Overseas Koreans","2006 ","37","18","19",
"43 s","Overseas Koreans","2007 ","38","21","17",
"43 s","Overseas Koreans","2008 ","42","16","26",
"43 s","Overseas Koreans","2009 ","68","22","46",
"43 s","Overseas Koreans","2010 ","120","57","63",
"43 s","Overseas Koreans","2011 ","221","105","116",
"43 s","Overseas Koreans","2012 ","191","103","88",
"43 s","Overseas Koreans","2013 ","302","169","133",
"43 s","Overseas Koreans","2014 ","345","187","158",
"43 s","Overseas Koreans","2015 ","434","242","192",
"43 s","Overseas Koreans","2016 ","489","286","203",
"43 s","Overseas Koreans","2017 ","542","299","243",
"43 s","Overseas Koreans","2018 ","480","256","224",
"43 s","Overseas Koreans","2019 ","543","293","250",
"43 s","Permanent Residence","2000 ","0","0","0",
"43 s","Permanent Residence","2001 ","0","0","0",
"43 s","Permanent Residence","2002 ","0","0","0",
"43 s","Permanent Residence","2003 ","9","5","4",
"43 s","Permanent Residence","2004 ","9","7","2",
"43 s","Permanent Residence","2005 ","3","2","1",
"43 s","Permanent Residence","2006 ","4","3","1",
"43 s","Permanent Residence","2007 ","12","4","8",
"43 s","Permanent Residence","2008 ","6","4","2",
"43 s","Permanent Residence","2009 ","3","0","3",
"43 s","Permanent Residence","2010 ","22","12","10",
"43 s","Permanent Residence","2011 ","55","24","31",
"43 s","Permanent Residence","2012 ","96","39","57",
"43 s","Permanent Residence","2013 ","133","60","73",
"43 s","Permanent Residence","2014 ","125","45","80",
"43 s","Permanent Residence","2015 ","137","64","73",
"43 s","Permanent Residence","2016 ","116","51","65",
"43 s","Permanent Residence","2017 ","114","46","68",
"43 s","Permanent Residence","2018 ","127","56","71",
"43 s","Permanent Residence","2019 ","111","48","63",
"43 s","Marriage Immigration","2011 ","9","1","8",
"43 s","Marriage Immigration","2012 ","218","53","165",
"43 s","Marriage Immigration","2013 ","213","49","164",
"43 s","Marriage Immigration","2014 ","177","46","131",
"43 s","Marriage Immigration","2015 ","118","24","94",
"43 s","Marriage Immigration","2016 ","125","30","95",
"43 s","Marriage Immigration","2017 ","136","33","103",
"43 s","Marriage Immigration","2018 ","121","35","86",
"43 s","Marriage Immigration","2019 ","152","48","104",
"44 s","Total","2000 ","2056","1262","794",
"44 s","Total","2001 ","2446","1484","962",
"44 s","Total","2002 ","2201","1325","876",
"44 s","Total","2003 ","2139","1221","918",
"44 s","Total","2004 ","2873","1507","1366",
"44 s","Total","2005 ","3214","1655","1559",
"44 s","Total","2006 ","4000","2237","1763",
"44 s","Total","2007 ","6507","3535","2972",
"44 s","Total","2008 ","5293","2732","2561",
"44 s","Total","2009 ","3924","1995","1929",
"44 s","Total","2010 ","4587","2379","2208",
"44 s","Total","2011 ","3596","1849","1747",
"44 s","Total","2012 ","3304","1658","1646",
"44 s","Total","2013 ","5472","2810","2662",
"44 s","Total","2014 ","6319","3525","2794",
"44 s","Total","2015 ","5496","2887","2609",
"44 s","Total","2016 ","5164","2741","2423",
"44 s","Total","2017 ","5961","3265","2696",
"44 s","Total","2018 ","6292","3444","2848",
"44 s","Total","2019 ","4869","2466","2403",
"44 s","Sightseeing Pass","2000 ","263","169","94",
"44 s","Sightseeing Pass","2001 ","322","224","98",
"44 s","Sightseeing Pass","2002 ","355","224","131",
"44 s","Sightseeing Pass","2003 ","309","228","81",
"44 s","Sightseeing Pass","2004 ","317","214","103",
"44 s","Sightseeing Pass","2005 ","302","204","98",
"44 s","Sightseeing Pass","2006 ","210","130","80",
"44 s","Sightseeing Pass","2007 ","225","157","68",
"44 s","Sightseeing Pass","2008 ","228","162","66",
"44 s","Sightseeing Pass","2009 ","231","121","110",
"44 s","Sightseeing Pass","2010 ","303","188","115",
"44 s","Sightseeing Pass","2011 ","253","126","127",
"44 s","Sightseeing Pass","2012 ","265","150","115",
"44 s","Sightseeing Pass","2013 ","237","127","110",
"44 s","Sightseeing Pass","2014 ","295","163","132",
"44 s","Sightseeing Pass","2015 ","369","218","151",
"44 s","Sightseeing Pass","2016 ","352","196","156",
"44 s","Sightseeing Pass","2017 ","379","238","141",
"44 s","Sightseeing Pass","2018 ","676","420","256",
"44 s","Sightseeing Pass","2019 ","349","160","189",
"44 s","Short-term Business","2000 ","452","290","162",
"44 s","Short-term Business","2001 ","575","379","196",
"44 s","Short-term Business","2002 ","276","198","78",
"44 s","Short-term Business","2003 ","175","135","40",
"44 s","Short-term Business","2004 ","211","165","46",
"44 s","Short-term Business","2005 ","145","106","39",
"44 s","Short-term Business","2006 ","237","192","45",
"44 s","Short-term Business","2007 ","421","328","93",
"44 s","Short-term Business","2008 ","198","151","47",
"44 s","Short-term Business","2009 ","55","49","6",
"44 s","Short-term Business","2010 ","68","61","7",
"44 s","Short-term Business","2011 ","66","63","3",
"44 s","Short-term Visitors","2000 ","708","408","300",
"44 s","Short-term Visitors","2001 ","831","467","364",
"44 s","Short-term Visitors","2002 ","813","498","315",
"44 s","Short-term Visitors","2003 ","597","320","277",
"44 s","Short-term Visitors","2004 ","507","287","220",
"44 s","Short-term Visitors","2005 ","451","234","217",
"44 s","Short-term Visitors","2006 ","446","261","185",
"44 s","Short-term Visitors","2007 ","493","255","238",
"44 s","Short-term Visitors","2008 ","398","181","217",
"44 s","Short-term Visitors","2009 ","276","113","163",
"44 s","Short-term Visitors","2010 ","1199","556","643",
"44 s","Short-term Visitors","2011 ","1217","592","625",
"44 s","Short-term Visitors","2012 ","1067","504","563",
"44 s","Short-term Visitors","2013 ","1770","864","906",
"44 s","Short-term Visitors","2014 ","1289","675","614",
"44 s","Short-term Visitors","2015 ","1475","777","698",
"44 s","Short-term Visitors","2016 ","1383","767","616",
"44 s","Short-term Visitors","2017 ","1362","775","587",
"44 s","Short-term Visitors","2018 ","1243","694","549",
"44 s","Short-term Visitors","2019 ","1198","687","511",
"44 s","Short-term Employment","2000 ","4","4","0",
"44 s","Short-term Employment","2001 ","4","4","0",
"44 s","Short-term Employment","2002 ","1","1","0",
"44 s","Short-term Employment","2003 ","1","1","0",
"44 s","Short-term Employment","2004 ","3","2","1",
"44 s","Short-term Employment","2005 ","8","5","3",
"44 s","Short-term Employment","2006 ","3","2","1",
"44 s","Short-term Employment","2007 ","4","3","1",
"44 s","Short-term Employment","2008 ","1","1","0",
"44 s","Short-term Employment","2009 ","0","0","0",
"44 s","Short-term Employment","2010 ","2","2","0",
"44 s","Short-term Employment","2011 ","1","","1",
"44 s","Short-term Employment","2012 ","2","2","",
"44 s","Short-term Employment","2015 ","2","2","0",
"44 s","Short-term Employment","2016 ","14","14","0",
"44 s","Short-term Employment","2017 ","2","2","0",
"44 s","Short-term Employment","2018 ","4","3","1",
"44 s","Short-term Employment","2019 ","6","5","1",
"44 s","Job Seeking","2000 ","0","0","0",
"44 s","Job Seeking","2001 ","0","0","0",
"44 s","Job Seeking","2002 ","0","0","0",
"44 s","Job Seeking","2003 ","0","0","0",
"44 s","Job Seeking","2004 ","0","0","0",
"44 s","Job Seeking","2005 ","0","0","0",
"44 s","Job Seeking","2006 ","0","0","0",
"44 s","Job Seeking","2007 ","0","0","0",
"44 s","Job Seeking","2008 ","0","0","0",
"44 s","Job Seeking","2009 ","0","0","0",
"44 s","Job Seeking","2010 ","0","0","0",
"44 s","Job Seeking","2013 ","1","1","0",
"44 s","Job Seeking","2014 ","1","0","1",
"44 s","study","2000 ","2","2","0",
"44 s","study","2001 ","3","1","2",
"44 s","study","2002 ","3","2","1",
"44 s","study","2003 ","9","5","4",
"44 s","study","2004 ","5","3","2",
"44 s","study","2005 ","8","6","2",
"44 s","study","2006 ","6","4","2",
"44 s","study","2007 ","8","7","1",
"44 s","study","2008 ","12","9","3",
"44 s","study","2009 ","8","6","2",
"44 s","study","2010 ","9","8","1",
"44 s","study","2011 ","9","7","2",
"44 s","study","2012 ","5","4","1",
"44 s","study","2013 ","15","10","5",
"44 s","study","2014 ","7","5","2",
"44 s","study","2015 ","13","7","6",
"44 s","study","2016 ","11","7","4",
"44 s","study","2017 ","15","10","5",
"44 s","study","2018 ","19","12","7",
"44 s","study","2019 ","16","8","8",
"44 s","General Trainees","2000 ","6","6","0",
"44 s","General Trainees","2001 ","7","4","3",
"44 s","General Trainees","2002 ","7","5","2",
"44 s","General Trainees","2003 ","5","3","2",
"44 s","General Trainees","2004 ","9","7","2",
"44 s","General Trainees","2005 ","4","2","2",
"44 s","General Trainees","2006 ","4","0","4",
"44 s","General Trainees","2007 ","13","8","5",
"44 s","General Trainees","2008 ","7","4","3",
"44 s","General Trainees","2009 ","6","2","4",
"44 s","General Trainees","2010 ","12","9","3",
"44 s","General Trainees","2011 ","22","11","11",
"44 s","General Trainees","2013 ","12","9","3",
"44 s","General Trainees","2014 ","17","13","4",
"44 s","General Trainees","2015 ","10","5","5",
"44 s","General Trainees","2016 ","24","14","10",
"44 s","General Trainees","2017 ","12","6","6",
"44 s","General Trainees","2018 ","11","5","6",
"44 s","General Trainees","2019 ","9","5","4",
"44 s","Religious Activities","2000 ","4","3","1",
"44 s","Religious Activities","2001 ","3","0","3",
"44 s","Religious Activities","2002 ","2","2","0",
"44 s","Religious Activities","2003 ","4","4","0",
"44 s","Religious Activities","2004 ","4","3","1",
"44 s","Religious Activities","2005 ","4","3","1",
"44 s","Religious Activities","2006 ","9","6","3",
"44 s","Religious Activities","2007 ","4","2","2",
"44 s","Religious Activities","2008 ","8","4","4",
"44 s","Religious Activities","2009 ","5","3","2",
"44 s","Religious Activities","2010 ","9","5","4",
"44 s","Religious Activities","2011 ","7","5","2",
"44 s","Religious Activities","2012 ","4","3","1",
"44 s","Religious Activities","2013 ","6","4","2",
"44 s","Religious Activities","2014 ","4","2","2",
"44 s","Religious Activities","2015 ","4","1","3",
"44 s","Religious Activities","2016 ","4","2","2",
"44 s","Religious Activities","2017 ","4","3","1",
"44 s","Religious Activities","2018 ","1","0","1",
"44 s","Religious Activities","2019 ","4","2","2",
"44 s","Investors","2000 ","60","39","21",
"44 s","Investors","2001 ","52","31","21",
"44 s","Investors","2002 ","29","25","4",
"44 s","Investors","2003 ","27","23","4",
"44 s","Investors","2004 ","29","24","5",
"44 s","Investors","2005 ","50","42","8",
"44 s","Investors","2006 ","18","17","1",
"44 s","Investors","2007 ","33","29","4",
"44 s","Investors","2008 ","40","38","2",
"44 s","Investors","2009 ","28","27","1",
"44 s","Investors","2010 ","25","23","2",
"44 s","Investors","2011 ","28","26","2",
"44 s","Investors","2012 ","26","25","1",
"44 s","Investors","2013 ","36","36","0",
"44 s","Investors","2014 ","21","17","4",
"44 s","Investors","2015 ","16","16","0",
"44 s","Investors","2016 ","24","24","0",
"44 s","Investors","2017 ","15","14","1",
"44 s","Investors","2018 ","21","21","0",
"44 s","Investors","2019 ","18","16","2",
"44 s","Trade and Business","2000 ","8","8","0",
"44 s","Trade and Business","2001 ","11","11","0",
"44 s","Trade and Business","2002 ","25","23","2",
"44 s","Trade and Business","2003 ","21","20","1",
"44 s","Trade and Business","2004 ","11","11","0",
"44 s","Trade and Business","2005 ","18","18","0",
"44 s","Trade and Business","2006 ","11","11","0",
"44 s","Trade and Business","2007 ","8","8","0",
"44 s","Trade and Business","2008 ","12","12","0",
"44 s","Trade and Business","2009 ","18","18","0",
"44 s","Trade and Business","2010 ","28","28","0",
"44 s","Trade and Business","2011 ","26","26","",
"44 s","Trade and Business","2012 ","25","24","1",
"44 s","Trade and Business","2013 ","33","33","0",
"44 s","Trade and Business","2014 ","47","44","3",
"44 s","Trade and Business","2015 ","34","34","0",
"44 s","Trade and Business","2016 ","35","34","1",
"44 s","Trade and Business","2017 ","20","18","2",
"44 s","Trade and Business","2018 ","17","16","1",
"44 s","Trade and Business","2019 ","17","17","0",
"44 s","Research","2000 ","14","10","4",
"44 s","Research","2001 ","11","8","3",
"44 s","Research","2002 ","12","11","1",
"44 s","Research","2003 ","12","11","1",
"44 s","Research","2004 ","12","9","3",
"44 s","Research","2005 ","6","5","1",
"44 s","Research","2006 ","7","6","1",
"44 s","Research","2007 ","16","16","0",
"44 s","Research","2008 ","6","6","0",
"44 s","Research","2009 ","6","6","0",
"44 s","Research","2010 ","6","6","0",
"44 s","Research","2011 ","4","4","",
"44 s","Research","2012 ","5","5","",
"44 s","Research","2013 ","9","8","1",
"44 s","Research","2014 ","4","4","0",
"44 s","Research","2015 ","6","5","1",
"44 s","Research","2016 ","7","7","0",
"44 s","Research","2017 ","2","1","1",
"44 s","Research","2018 ","5","5","0",
"44 s","Research","2019 ","7","6","1",
"44 s","Art and Entertainment","2000 ","10","10","0",
"44 s","Art and Entertainment","2001 ","9","9","0",
"44 s","Art and Entertainment","2002 ","9","8","1",
"44 s","Art and Entertainment","2003 ","11","9","2",
"44 s","Art and Entertainment","2004 ","11","10","1",
"44 s","Art and Entertainment","2005 ","11","9","2",
"44 s","Art and Entertainment","2006 ","12","9","3",
"44 s","Art and Entertainment","2007 ","9","6","3",
"44 s","Art and Entertainment","2008 ","19","17","2",
"44 s","Art and Entertainment","2009 ","10","7","3",
"44 s","Art and Entertainment","2010 ","8","6","2",
"44 s","Art and Entertainment","2011 ","10","7","3",
"44 s","Art and Entertainment","2012 ","15","14","1",
"44 s","Art and Entertainment","2013 ","7","5","2",
"44 s","Art and Entertainment","2014 ","7","6","1",
"44 s","Art and Entertainment","2015 ","5","4","1",
"44 s","Art and Entertainment","2016 ","7","5","2",
"44 s","Art and Entertainment","2017 ","2","1","1",
"44 s","Art and Entertainment","2018 ","8","5","3",
"44 s","Art and Entertainment","2019 ","9","5","4",
"44 s","Unskilled Employment","2000 ","0","0","0",
"44 s","Unskilled Employment","2001 ","0","0","0",
"44 s","Unskilled Employment","2002 ","0","0","0",
"44 s","Unskilled Employment","2003 ","19","12","7",
"44 s","Unskilled Employment","2004 ","70","41","29",
"44 s","Unskilled Employment","2005 ","13","9","4",
"44 s","Unskilled Employment","2006 ","42","27","15",
"44 s","Unskilled Employment","2007 ","19","11","8",
"44 s","Unskilled Employment","2008 ","16","10","6",
"44 s","Unskilled Employment","2009 ","7","7","0",
"44 s","Unskilled Employment","2010 ","1","1","0",
"44 s","Unskilled Employment","2011 ","4","4","",
"44 s","Unskilled Employment","2012 ","40","39","1",
"44 s","Unskilled Employment","2013 ","93","92","1",
"44 s","Unskilled Employment","2014 ","31","30","1",
"44 s","Unskilled Employment","2015 ","43","40","3",
"44 s","Unskilled Employment","2016 ","67","64","3",
"44 s","Unskilled Employment","2017 ","67","61","6",
"44 s","Unskilled Employment","2018 ","43","39","4",
"44 s","Unskilled Employment","2019 ","39","38","1",
"44 s","Visiting and Joining Family","2000 ","72","4","68",
"44 s","Visiting and Joining Family","2001 ","151","7","144",
"44 s","Visiting and Joining Family","2002 ","106","11","95",
"44 s","Visiting and Joining Family","2003 ","324","164","160",
"44 s","Visiting and Joining Family","2004 ","682","346","336",
"44 s","Visiting and Joining Family","2005 ","1304","660","644",
"44 s","Visiting and Joining Family","2006 ","2308","1253","1055",
"44 s","Visiting and Joining Family","2007 ","541","270","271",
"44 s","Visiting and Joining Family","2008 ","34","12","22",
"44 s","Visiting and Joining Family","2009 ","37","10","27",
"44 s","Visiting and Joining Family","2010 ","62","28","34",
"44 s","Visiting and Joining Family","2011 ","60","29","31",
"44 s","Visiting and Joining Family","2012 ","55","15","40",
"44 s","Visiting and Joining Family","2013 ","84","18","66",
"44 s","Visiting and Joining Family","2014 ","116","25","91",
"44 s","Visiting and Joining Family","2015 ","187","35","152",
"44 s","Visiting and Joining Family","2016 ","261","94","167",
"44 s","Visiting and Joining Family","2017 ","259","97","162",
"44 s","Visiting and Joining Family","2018 ","290","95","195",
"44 s","Visiting and Joining Family","2019 ","311","109","202",
"44 s","Overseas Koreans","2000 ","17","3","14",
"44 s","Overseas Koreans","2001 ","28","13","15",
"44 s","Overseas Koreans","2002 ","36","15","21",
"44 s","Overseas Koreans","2003 ","37","19","18",
"44 s","Overseas Koreans","2004 ","36","15","21",
"44 s","Overseas Koreans","2005 ","38","16","22",
"44 s","Overseas Koreans","2006 ","36","20","16",
"44 s","Overseas Koreans","2007 ","41","18","23",
"44 s","Overseas Koreans","2008 ","43","24","19",
"44 s","Overseas Koreans","2009 ","60","30","30",
"44 s","Overseas Koreans","2010 ","169","79","90",
"44 s","Overseas Koreans","2011 ","204","98","106",
"44 s","Overseas Koreans","2012 ","193","104","89",
"44 s","Overseas Koreans","2013 ","271","146","125",
"44 s","Overseas Koreans","2014 ","323","170","153",
"44 s","Overseas Koreans","2015 ","421","235","186",
"44 s","Overseas Koreans","2016 ","513","292","221",
"44 s","Overseas Koreans","2017 ","504","277","227",
"44 s","Overseas Koreans","2018 ","517","278","239",
"44 s","Overseas Koreans","2019 ","455","226","229",
"44 s","Permanent Residence","2000 ","0","0","0",
"44 s","Permanent Residence","2001 ","0","0","0",
"44 s","Permanent Residence","2002 ","0","0","0",
"44 s","Permanent Residence","2003 ","1","1","0",
"44 s","Permanent Residence","2004 ","6","3","3",
"44 s","Permanent Residence","2005 ","6","3","3",
"44 s","Permanent Residence","2006 ","4","2","2",
"44 s","Permanent Residence","2007 ","5","3","2",
"44 s","Permanent Residence","2008 ","12","6","6",
"44 s","Permanent Residence","2009 ","9","6","3",
"44 s","Permanent Residence","2010 ","18","7","11",
"44 s","Permanent Residence","2011 ","58","25","33",
"44 s","Permanent Residence","2012 ","92","36","56",
"44 s","Permanent Residence","2013 ","125","43","82",
"44 s","Permanent Residence","2014 ","118","49","69",
"44 s","Permanent Residence","2015 ","155","67","88",
"44 s","Permanent Residence","2016 ","130","57","73",
"44 s","Permanent Residence","2017 ","135","59","76",
"44 s","Permanent Residence","2018 ","108","51","57",
"44 s","Permanent Residence","2019 ","102","39","63",
"44 s","Marriage Immigration","2011 ","3","1","2",
"44 s","Marriage Immigration","2012 ","193","43","150",
"44 s","Marriage Immigration","2013 ","206","38","168",
"44 s","Marriage Immigration","2014 ","171","52","119",
"44 s","Marriage Immigration","2015 ","146","36","110",
"44 s","Marriage Immigration","2016 ","162","39","123",
"44 s","Marriage Immigration","2017 ","118","32","86",
"44 s","Marriage Immigration","2018 ","144","33","111",
"44 s","Marriage Immigration","2019 ","146","52","94",
"45 s","Total","2000 ","1970","1166","804",
"45 s","Total","2001 ","2143","1307","836",
"45 s","Total","2002 ","2200","1288","912",
"45 s","Total","2003 ","2318","1284","1034",
"45 s","Total","2004 ","2676","1404","1272",
"45 s","Total","2005 ","4076","2044","2032",
"45 s","Total","2006 ","4007","2178","1829",
"45 s","Total","2007 ","4507","2422","2085",
"45 s","Total","2008 ","5687","2908","2779",
"45 s","Total","2009 ","3845","1943","1902",
"45 s","Total","2010 ","4930","2567","2363",
"45 s","Total","2011 ","3996","1955","2041",
"45 s","Total","2012 ","3049","1459","1590",
"45 s","Total","2013 ","5115","2620","2495",
"45 s","Total","2014 ","6338","3490","2848",
"45 s","Total","2015 ","5139","2709","2430",
"45 s","Total","2016 ","5278","2760","2518",
"45 s","Total","2017 ","6235","3542","2693",
"45 s","Total","2018 ","6293","3499","2794",
"45 s","Total","2019 ","4937","2532","2405",
"45 s","Sightseeing Pass","2000 ","212","136","76",
"45 s","Sightseeing Pass","2001 ","343","249","94",
"45 s","Sightseeing Pass","2002 ","358","242","116",
"45 s","Sightseeing Pass","2003 ","291","197","94",
"45 s","Sightseeing Pass","2004 ","299","197","102",
"45 s","Sightseeing Pass","2005 ","296","188","108",
"45 s","Sightseeing Pass","2006 ","221","145","76",
"45 s","Sightseeing Pass","2007 ","183","112","71",
"45 s","Sightseeing Pass","2008 ","233","158","75",
"45 s","Sightseeing Pass","2009 ","237","139","98",
"45 s","Sightseeing Pass","2010 ","316","199","117",
"45 s","Sightseeing Pass","2011 ","250","149","101",
"45 s","Sightseeing Pass","2012 ","226","132","94",
"45 s","Sightseeing Pass","2013 ","220","121","99",
"45 s","Sightseeing Pass","2014 ","279","160","119",
"45 s","Sightseeing Pass","2015 ","379","226","153",
"45 s","Sightseeing Pass","2016 ","341","186","155",
"45 s","Sightseeing Pass","2017 ","388","234","154",
"45 s","Sightseeing Pass","2018 ","715","449","266",
"45 s","Sightseeing Pass","2019 ","330","158","172",
"45 s","Short-term Business","2000 ","408","247","161",
"45 s","Short-term Business","2001 ","417","285","132",
"45 s","Short-term Business","2002 ","246","180","66",
"45 s","Short-term Business","2003 ","208","160","48",
"45 s","Short-term Business","2004 ","149","122","27",
"45 s","Short-term Business","2005 ","162","120","42",
"45 s","Short-term Business","2006 ","188","149","39",
"45 s","Short-term Business","2007 ","225","173","52",
"45 s","Short-term Business","2008 ","199","154","45",
"45 s","Short-term Business","2009 ","74","64","10",
"45 s","Short-term Business","2010 ","45","41","4",
"45 s","Short-term Business","2011 ","51","45","6",
"45 s","Short-term Visitors","2000 ","760","406","354",
"45 s","Short-term Visitors","2001 ","705","381","324",
"45 s","Short-term Visitors","2002 ","839","458","381",
"45 s","Short-term Visitors","2003 ","602","316","286",
"45 s","Short-term Visitors","2004 ","483","275","208",
"45 s","Short-term Visitors","2005 ","538","280","258",
"45 s","Short-term Visitors","2006 ","427","212","215",
"45 s","Short-term Visitors","2007 ","351","181","170",
"45 s","Short-term Visitors","2008 ","410","186","224",
"45 s","Short-term Visitors","2009 ","308","120","188",
"45 s","Short-term Visitors","2010 ","1442","679","763",
"45 s","Short-term Visitors","2011 ","1424","640","784",
"45 s","Short-term Visitors","2012 ","1085","456","629",
"45 s","Short-term Visitors","2013 ","1759","863","896",
"45 s","Short-term Visitors","2014 ","1357","715","642",
"45 s","Short-term Visitors","2015 ","1490","821","669",
"45 s","Short-term Visitors","2016 ","1496","823","673",
"45 s","Short-term Visitors","2017 ","1502","884","618",
"45 s","Short-term Visitors","2018 ","1353","748","605",
"45 s","Short-term Visitors","2019 ","1101","604","497",
"45 s","Short-term Employment","2000 ","1","1","0",
"45 s","Short-term Employment","2001 ","1","1","0",
"45 s","Short-term Employment","2002 ","0","0","0",
"45 s","Short-term Employment","2003 ","4","2","2",
"45 s","Short-term Employment","2004 ","3","3","0",
"45 s","Short-term Employment","2005 ","4","4","0",
"45 s","Short-term Employment","2006 ","4","1","3",
"45 s","Short-term Employment","2007 ","2","2","0",
"45 s","Short-term Employment","2008 ","1","1","0",
"45 s","Short-term Employment","2009 ","3","2","1",
"45 s","Short-term Employment","2010 ","0","0","0",
"45 s","Short-term Employment","2011 ","1","1","",
"45 s","Short-term Employment","2012 ","2","1","1",
"45 s","Short-term Employment","2014 ","2","2","0",
"45 s","Short-term Employment","2016 ","8","8","0",
"45 s","Short-term Employment","2017 ","1","1","0",
"45 s","Short-term Employment","2018 ","1","0","1",
"45 s","Short-term Employment","2019 ","1","1","0",
"45 s","Job Seeking","2000 ","0","0","0",
"45 s","Job Seeking","2001 ","0","0","0",
"45 s","Job Seeking","2002 ","0","0","0",
"45 s","Job Seeking","2003 ","0","0","0",
"45 s","Job Seeking","2004 ","0","0","0",
"45 s","Job Seeking","2005 ","0","0","0",
"45 s","Job Seeking","2006 ","0","0","0",
"45 s","Job Seeking","2007 ","0","0","0",
"45 s","Job Seeking","2008 ","0","0","0",
"45 s","Job Seeking","2009 ","0","0","0",
"45 s","Job Seeking","2010 ","0","0","0",
"45 s","Job Seeking","2014 ","1","1","0",
"45 s","Job Seeking","2015 ","2","2","0",
"45 s","Job Seeking","2017 ","1","1","0",
"45 s","Job Seeking","2018 ","2","2","0",
"45 s","Job Seeking","2019 ","1","1","0",
"45 s","study","2000 ","8","3","5",
"45 s","study","2001 ","9","6","3",
"45 s","study","2002 ","7","6","1",
"45 s","study","2003 ","10","8","2",
"45 s","study","2004 ","6","5","1",
"45 s","study","2005 ","2","2","0",
"45 s","study","2006 ","3","2","1",
"45 s","study","2007 ","8","5","3",
"45 s","study","2008 ","4","2","2",
"45 s","study","2009 ","6","6","0",
"45 s","study","2010 ","8","8","0",
"45 s","study","2011 ","3","1","2",
"45 s","study","2012 ","5","2","3",
"45 s","study","2013 ","5","4","1",
"45 s","study","2014 ","7","3","4",
"45 s","study","2015 ","15","6","9",
"45 s","study","2016 ","10","9","1",
"45 s","study","2017 ","9","7","2",
"45 s","study","2018 ","18","7","11",
"45 s","study","2019 ","21","13","8",
"45 s","General Trainees","2000 ","5","3","2",
"45 s","General Trainees","2001 ","4","2","2",
"45 s","General Trainees","2002 ","2","2","0",
"45 s","General Trainees","2003 ","6","4","2",
"45 s","General Trainees","2004 ","3","2","1",
"45 s","General Trainees","2005 ","4","3","1",
"45 s","General Trainees","2006 ","3","3","0",
"45 s","General Trainees","2007 ","4","2","2",
"45 s","General Trainees","2008 ","5","3","2",
"45 s","General Trainees","2009 ","5","3","2",
"45 s","General Trainees","2010 ","2","1","1",
"45 s","General Trainees","2011 ","29","15","14",
"45 s","General Trainees","2013 ","10","8","2",
"45 s","General Trainees","2014 ","7","5","2",
"45 s","General Trainees","2015 ","4","3","1",
"45 s","General Trainees","2016 ","7","6","1",
"45 s","General Trainees","2017 ","12","6","6",
"45 s","General Trainees","2018 ","8","5","3",
"45 s","General Trainees","2019 ","5","2","3",
"45 s","Religious Activities","2000 ","5","2","3",
"45 s","Religious Activities","2001 ","9","2","7",
"45 s","Religious Activities","2002 ","1","1","0",
"45 s","Religious Activities","2003 ","4","0","4",
"45 s","Religious Activities","2004 ","4","2","2",
"45 s","Religious Activities","2005 ","4","3","1",
"45 s","Religious Activities","2006 ","0","0","0",
"45 s","Religious Activities","2007 ","8","4","4",
"45 s","Religious Activities","2008 ","7","6","1",
"45 s","Religious Activities","2009 ","6","3","3",
"45 s","Religious Activities","2010 ","7","5","2",
"45 s","Religious Activities","2011 ","4","3","1",
"45 s","Religious Activities","2012 ","7","7","",
"45 s","Religious Activities","2013 ","4","2","2",
"45 s","Religious Activities","2014 ","8","7","1",
"45 s","Religious Activities","2015 ","5","1","4",
"45 s","Religious Activities","2016 ","2","2","0",
"45 s","Religious Activities","2017 ","3","2","1",
"45 s","Religious Activities","2018 ","1","0","1",
"45 s","Religious Activities","2019 ","5","3","2",
"45 s","Investors","2000 ","76","47","29",
"45 s","Investors","2001 ","58","39","19",
"45 s","Investors","2002 ","32","28","4",
"45 s","Investors","2003 ","26","25","1",
"45 s","Investors","2004 ","34","27","7",
"45 s","Investors","2005 ","47","39","8",
"45 s","Investors","2006 ","27","25","2",
"45 s","Investors","2007 ","22","22","0",
"45 s","Investors","2008 ","30","28","2",
"45 s","Investors","2009 ","23","21","2",
"45 s","Investors","2010 ","26","26","0",
"45 s","Investors","2011 ","21","18","3",
"45 s","Investors","2012 ","24","22","2",
"45 s","Investors","2013 ","35","34","1",
"45 s","Investors","2014 ","13","13","0",
"45 s","Investors","2015 ","15","15","0",
"45 s","Investors","2016 ","12","11","1",
"45 s","Investors","2017 ","18","17","1",
"45 s","Investors","2018 ","17","17","0",
"45 s","Investors","2019 ","15","14","1",
"45 s","Trade and Business","2000 ","10","10","0",
"45 s","Trade and Business","2001 ","10","10","0",
"45 s","Trade and Business","2002 ","24","23","1",
"45 s","Trade and Business","2003 ","12","12","0",
"45 s","Trade and Business","2004 ","23","22","1",
"45 s","Trade and Business","2005 ","19","19","0",
"45 s","Trade and Business","2006 ","18","18","0",
"45 s","Trade and Business","2007 ","10","9","1",
"45 s","Trade and Business","2008 ","12","12","0",
"45 s","Trade and Business","2009 ","17","17","0",
"45 s","Trade and Business","2010 ","17","17","0",
"45 s","Trade and Business","2011 ","28","28","",
"45 s","Trade and Business","2012 ","22","22","",
"45 s","Trade and Business","2013 ","41","38","3",
"45 s","Trade and Business","2014 ","48","47","1",
"45 s","Trade and Business","2015 ","41","40","1",
"45 s","Trade and Business","2016 ","30","29","1",
"45 s","Trade and Business","2017 ","21","21","0",
"45 s","Trade and Business","2018 ","16","15","1",
"45 s","Trade and Business","2019 ","14","14","0",
"45 s","Research","2000 ","12","12","0",
"45 s","Research","2001 ","11","10","1",
"45 s","Research","2002 ","7","5","2",
"45 s","Research","2003 ","16","15","1",
"45 s","Research","2004 ","6","4","2",
"45 s","Research","2005 ","11","9","2",
"45 s","Research","2006 ","6","5","1",
"45 s","Research","2007 ","9","9","0",
"45 s","Research","2008 ","15","13","2",
"45 s","Research","2009 ","3","2","1",
"45 s","Research","2010 ","9","7","2",
"45 s","Research","2011 ","2","2","",
"45 s","Research","2012 ","1","1","",
"45 s","Research","2013 ","9","9","0",
"45 s","Research","2014 ","10","10","0",
"45 s","Research","2015 ","3","3","0",
"45 s","Research","2016 ","6","3","3",
"45 s","Research","2017 ","5","5","0",
"45 s","Research","2018 ","7","6","1",
"45 s","Research","2019 ","5","3","2",
"45 s","Art and Entertainment","2000 ","15","15","0",
"45 s","Art and Entertainment","2001 ","7","5","2",
"45 s","Art and Entertainment","2002 ","10","8","2",
"45 s","Art and Entertainment","2003 ","10","9","1",
"45 s","Art and Entertainment","2004 ","6","3","3",
"45 s","Art and Entertainment","2005 ","12","8","4",
"45 s","Art and Entertainment","2006 ","7","4","3",
"45 s","Art and Entertainment","2007 ","15","10","5",
"45 s","Art and Entertainment","2008 ","15","12","3",
"45 s","Art and Entertainment","2009 ","8","8","0",
"45 s","Art and Entertainment","2010 ","6","3","3",
"45 s","Art and Entertainment","2011 ","7","7","",
"45 s","Art and Entertainment","2012 ","9","8","1",
"45 s","Art and Entertainment","2013 ","7","6","1",
"45 s","Art and Entertainment","2014 ","8","8","0",
"45 s","Art and Entertainment","2015 ","4","1","3",
"45 s","Art and Entertainment","2016 ","4","2","2",
"45 s","Art and Entertainment","2017 ","6","3","3",
"45 s","Art and Entertainment","2018 ","4","3","1",
"45 s","Art and Entertainment","2019 ","4","1","3",
"45 s","Unskilled Employment","2000 ","0","0","0",
"45 s","Unskilled Employment","2001 ","0","0","0",
"45 s","Unskilled Employment","2002 ","0","0","0",
"45 s","Unskilled Employment","2003 ","15","11","4",
"45 s","Unskilled Employment","2004 ","60","40","20",
"45 s","Unskilled Employment","2005 ","21","16","5",
"45 s","Unskilled Employment","2006 ","46","33","13",
"45 s","Unskilled Employment","2007 ","11","4","7",
"45 s","Unskilled Employment","2008 ","4","2","2",
"45 s","Unskilled Employment","2009 ","6","5","1",
"45 s","Unskilled Employment","2010 ","1","1","0",
"45 s","Unskilled Employment","2011 ","2","2","",
"45 s","Unskilled Employment","2012 ","18","18","",
"45 s","Unskilled Employment","2013 ","36","36","0",
"45 s","Unskilled Employment","2014 ","11","11","0",
"45 s","Unskilled Employment","2015 ","20","20","0",
"45 s","Unskilled Employment","2016 ","21","21","0",
"45 s","Unskilled Employment","2017 ","40","40","0",
"45 s","Unskilled Employment","2018 ","25","23","2",
"45 s","Unskilled Employment","2019 ","32","32","0",
"45 s","Visiting and Joining Family","2000 ","56","4","52",
"45 s","Visiting and Joining Family","2001 ","121","2","119",
"45 s","Visiting and Joining Family","2002 ","119","19","100",
"45 s","Visiting and Joining Family","2003 ","473","244","229",
"45 s","Visiting and Joining Family","2004 ","678","351","327",
"45 s","Visiting and Joining Family","2005 ","1936","976","960",
"45 s","Visiting and Joining Family","2006 ","2422","1283","1139",
"45 s","Visiting and Joining Family","2007 ","254","115","139",
"45 s","Visiting and Joining Family","2008 ","27","14","13",
"45 s","Visiting and Joining Family","2009 ","34","15","19",
"45 s","Visiting and Joining Family","2010 ","66","31","35",
"45 s","Visiting and Joining Family","2011 ","58","17","41",
"45 s","Visiting and Joining Family","2012 ","63","17","46",
"45 s","Visiting and Joining Family","2013 ","92","21","71",
"45 s","Visiting and Joining Family","2014 ","111","28","83",
"45 s","Visiting and Joining Family","2015 ","203","47","156",
"45 s","Visiting and Joining Family","2016 ","343","106","237",
"45 s","Visiting and Joining Family","2017 ","296","112","184",
"45 s","Visiting and Joining Family","2018 ","288","106","182",
"45 s","Visiting and Joining Family","2019 ","376","130","246",
"45 s","Overseas Koreans","2000 ","17","6","11",
"45 s","Overseas Koreans","2001 ","23","13","10",
"45 s","Overseas Koreans","2002 ","31","15","16",
"45 s","Overseas Koreans","2003 ","36","20","16",
"45 s","Overseas Koreans","2004 ","47","20","27",
"45 s","Overseas Koreans","2005 ","41","17","24",
"45 s","Overseas Koreans","2006 ","33","13","20",
"45 s","Overseas Koreans","2007 ","50","20","30",
"45 s","Overseas Koreans","2008 ","57","28","29",
"45 s","Overseas Koreans","2009 ","48","22","26",
"45 s","Overseas Koreans","2010 ","231","94","137",
"45 s","Overseas Koreans","2011 ","227","95","132",
"45 s","Overseas Koreans","2012 ","180","84","96",
"45 s","Overseas Koreans","2013 ","274","155","119",
"45 s","Overseas Koreans","2014 ","297","161","136",
"45 s","Overseas Koreans","2015 ","386","206","180",
"45 s","Overseas Koreans","2016 ","550","283","267",
"45 s","Overseas Koreans","2017 ","563","311","252",
"45 s","Overseas Koreans","2018 ","556","327","229",
"45 s","Overseas Koreans","2019 ","562","294","268",
"45 s","Permanent Residence","2000 ","0","0","0",
"45 s","Permanent Residence","2001 ","0","0","0",
"45 s","Permanent Residence","2002 ","0","0","0",
"45 s","Permanent Residence","2003 ","6","6","0",
"45 s","Permanent Residence","2004 ","9","6","3",
"45 s","Permanent Residence","2005 ","6","5","1",
"45 s","Permanent Residence","2006 ","5","4","1",
"45 s","Permanent Residence","2007 ","7","4","3",
"45 s","Permanent Residence","2008 ","10","2","8",
"45 s","Permanent Residence","2009 ","11","3","8",
"45 s","Permanent Residence","2010 ","21","8","13",
"45 s","Permanent Residence","2011 ","54","19","35",
"45 s","Permanent Residence","2012 ","77","30","47",
"45 s","Permanent Residence","2013 ","111","41","70",
"45 s","Permanent Residence","2014 ","110","47","63",
"45 s","Permanent Residence","2015 ","123","61","62",
"45 s","Permanent Residence","2016 ","135","64","71",
"45 s","Permanent Residence","2017 ","132","49","83",
"45 s","Permanent Residence","2018 ","141","62","79",
"45 s","Permanent Residence","2019 ","118","52","66",
"45 s","Marriage Immigration","2011 ","3","2","1",
"45 s","Marriage Immigration","2012 ","149","42","107",
"45 s","Marriage Immigration","2013 ","146","40","106",
"45 s","Marriage Immigration","2014 ","142","38","104",
"45 s","Marriage Immigration","2015 ","136","44","92",
"45 s","Marriage Immigration","2016 ","139","43","96",
"45 s","Marriage Immigration","2017 ","116","32","84",
"45 s","Marriage Immigration","2018 ","141","32","109",
"45 s","Marriage Immigration","2019 ","126","35","91",
"46 s","Total","2000 ","1778","1026","752",
"46 s","Total","2001 ","2125","1266","859",
"46 s","Total","2002 ","1996","1173","823",
"46 s","Total","2003 ","2269","1259","1010",
"46 s","Total","2004 ","2837","1459","1378",
"46 s","Total","2005 ","3593","1889","1704",
"46 s","Total","2006 ","4855","2634","2221",
"46 s","Total","2007 ","3853","2000","1853",
"46 s","Total","2008 ","3671","1826","1845",
"46 s","Total","2009 ","4042","1995","2047",
"46 s","Total","2010 ","5187","2683","2504",
"46 s","Total","2011 ","4207","2078","2129",
"46 s","Total","2012 ","3397","1633","1764",
"46 s","Total","2013 ","4660","2320","2340",
"46 s","Total","2014 ","5736","3085","2651",
"46 s","Total","2015 ","4919","2533","2386",
"46 s","Total","2016 ","5151","2680","2471",
"46 s","Total","2017 ","6314","3509","2805",
"46 s","Total","2018 ","6761","3784","2977",
"46 s","Total","2019 ","5097","2562","2535",
"46 s","Sightseeing Pass","2000 ","232","134","98",
"46 s","Sightseeing Pass","2001 ","356","240","116",
"46 s","Sightseeing Pass","2002 ","402","262","140",
"46 s","Sightseeing Pass","2003 ","327","210","117",
"46 s","Sightseeing Pass","2004 ","349","209","140",
"46 s","Sightseeing Pass","2005 ","295","182","113",
"46 s","Sightseeing Pass","2006 ","216","139","77",
"46 s","Sightseeing Pass","2007 ","175","102","73",
"46 s","Sightseeing Pass","2008 ","212","132","80",
"46 s","Sightseeing Pass","2009 ","209","125","84",
"46 s","Sightseeing Pass","2010 ","266","152","114",
"46 s","Sightseeing Pass","2011 ","233","108","125",
"46 s","Sightseeing Pass","2012 ","238","134","104",
"46 s","Sightseeing Pass","2013 ","210","105","105",
"46 s","Sightseeing Pass","2014 ","263","151","112",
"46 s","Sightseeing Pass","2015 ","318","180","138",
"46 s","Sightseeing Pass","2016 ","332","179","153",
"46 s","Sightseeing Pass","2017 ","404","254","150",
"46 s","Sightseeing Pass","2018 ","689","446","243",
"46 s","Sightseeing Pass","2019 ","340","151","189",
"46 s","Short-term Business","2000 ","329","204","125",
"46 s","Short-term Business","2001 ","401","263","138",
"46 s","Short-term Business","2002 ","195","137","58",
"46 s","Short-term Business","2003 ","161","127","34",
"46 s","Short-term Business","2004 ","169","133","36",
"46 s","Short-term Business","2005 ","109","90","19",
"46 s","Short-term Business","2006 ","240","183","57",
"46 s","Short-term Business","2007 ","215","167","48",
"46 s","Short-term Business","2008 ","119","93","26",
"46 s","Short-term Business","2009 ","53","47","6",
"46 s","Short-term Business","2010 ","59","50","9",
"46 s","Short-term Business","2011 ","37","34","3",
"46 s","Short-term Visitors","2000 ","690","367","323",
"46 s","Short-term Visitors","2001 ","767","392","375",
"46 s","Short-term Visitors","2002 ","713","399","314",
"46 s","Short-term Visitors","2003 ","621","307","314",
"46 s","Short-term Visitors","2004 ","566","299","267",
"46 s","Short-term Visitors","2005 ","564","284","280",
"46 s","Short-term Visitors","2006 ","509","245","264",
"46 s","Short-term Visitors","2007 ","362","164","198",
"46 s","Short-term Visitors","2008 ","334","143","191",
"46 s","Short-term Visitors","2009 ","381","144","237",
"46 s","Short-term Visitors","2010 ","1602","778","824",
"46 s","Short-term Visitors","2011 ","1658","766","892",
"46 s","Short-term Visitors","2012 ","1205","532","673",
"46 s","Short-term Visitors","2013 ","1625","748","877",
"46 s","Short-term Visitors","2014 ","1285","650","635",
"46 s","Short-term Visitors","2015 ","1452","763","689",
"46 s","Short-term Visitors","2016 ","1582","861","721",
"46 s","Short-term Visitors","2017 ","1540","897","643",
"46 s","Short-term Visitors","2018 ","1535","847","688",
"46 s","Short-term Visitors","2019 ","1213","664","549",
"46 s","Short-term Employment","2000 ","3","1","2",
"46 s","Short-term Employment","2001 ","3","2","1",
"46 s","Short-term Employment","2002 ","4","3","1",
"46 s","Short-term Employment","2003 ","4","4","0",
"46 s","Short-term Employment","2004 ","3","2","1",
"46 s","Short-term Employment","2005 ","5","5","0",
"46 s","Short-term Employment","2006 ","6","4","2",
"46 s","Short-term Employment","2007 ","3","3","0",
"46 s","Short-term Employment","2008 ","1","1","0",
"46 s","Short-term Employment","2009 ","0","0","0",
"46 s","Short-term Employment","2010 ","0","0","0",
"46 s","Short-term Employment","2012 ","2","1","1",
"46 s","Short-term Employment","2013 ","1","1","0",
"46 s","Short-term Employment","2015 ","2","1","1",
"46 s","Short-term Employment","2016 ","8","8","0",
"46 s","Short-term Employment","2017 ","3","3","0",
"46 s","Short-term Employment","2018 ","1","1","0",
"46 s","Short-term Employment","2019 ","2","1","1",
"46 s","Job Seeking","2000 ","0","0","0",
"46 s","Job Seeking","2001 ","0","0","0",
"46 s","Job Seeking","2002 ","0","0","0",
"46 s","Job Seeking","2003 ","0","0","0",
"46 s","Job Seeking","2004 ","0","0","0",
"46 s","Job Seeking","2005 ","0","0","0",
"46 s","Job Seeking","2006 ","0","0","0",
"46 s","Job Seeking","2007 ","0","0","0",
"46 s","Job Seeking","2008 ","0","0","0",
"46 s","Job Seeking","2009 ","0","0","0",
"46 s","Job Seeking","2010 ","0","0","0",
"46 s","Job Seeking","2014 ","1","1","0",
"46 s","Job Seeking","2016 ","1","1","0",
"46 s","study","2000 ","2","1","1",
"46 s","study","2001 ","5","3","2",
"46 s","study","2002 ","7","5","2",
"46 s","study","2003 ","3","1","2",
"46 s","study","2004 ","8","4","4",
"46 s","study","2005 ","5","4","1",
"46 s","study","2006 ","5","4","1",
"46 s","study","2007 ","3","2","1",
"46 s","study","2008 ","3","2","1",
"46 s","study","2009 ","2","1","1",
"46 s","study","2010 ","5","4","1",
"46 s","study","2011 ","10","8","2",
"46 s","study","2012 ","5","5","",
"46 s","study","2013 ","5","4","1",
"46 s","study","2014 ","7","6","1",
"46 s","study","2015 ","2","1","1",
"46 s","study","2016 ","6","1","5",
"46 s","study","2017 ","12","10","2",
"46 s","study","2018 ","13","7","6",
"46 s","study","2019 ","14","7","7",
"46 s","General Trainees","2000 ","6","3","3",
"46 s","General Trainees","2001 ","1","1","0",
"46 s","General Trainees","2002 ","2","1","1",
"46 s","General Trainees","2003 ","5","5","0",
"46 s","General Trainees","2004 ","3","3","0",
"46 s","General Trainees","2005 ","4","3","1",
"46 s","General Trainees","2006 ","4","2","2",
"46 s","General Trainees","2007 ","7","1","6",
"46 s","General Trainees","2008 ","2","1","1",
"46 s","General Trainees","2009 ","7","5","2",
"46 s","General Trainees","2010 ","12","9","3",
"46 s","General Trainees","2011 ","43","26","17",
"46 s","General Trainees","2013 ","5","2","3",
"46 s","General Trainees","2014 ","6","2","4",
"46 s","General Trainees","2015 ","3","3","0",
"46 s","General Trainees","2016 ","19","15","4",
"46 s","General Trainees","2017 ","7","2","5",
"46 s","General Trainees","2018 ","2","1","1",
"46 s","General Trainees","2019 ","6","6","0",
"46 s","Religious Activities","2000 ","3","3","0",
"46 s","Religious Activities","2001 ","6","3","3",
"46 s","Religious Activities","2002 ","3","0","3",
"46 s","Religious Activities","2003 ","3","2","1",
"46 s","Religious Activities","2004 ","3","2","1",
"46 s","Religious Activities","2005 ","6","5","1",
"46 s","Religious Activities","2006 ","2","1","1",
"46 s","Religious Activities","2007 ","5","2","3",
"46 s","Religious Activities","2008 ","2","1","1",
"46 s","Religious Activities","2009 ","8","2","6",
"46 s","Religious Activities","2010 ","5","3","2",
"46 s","Religious Activities","2011 ","5","1","4",
"46 s","Religious Activities","2012 ","3","3","",
"46 s","Religious Activities","2013 ","3","2","1",
"46 s","Religious Activities","2014 ","4","4","0",
"46 s","Religious Activities","2015 ","8","6","2",
"46 s","Religious Activities","2016 ","6","3","3",
"46 s","Religious Activities","2017 ","3","0","3",
"46 s","Religious Activities","2018 ","2","2","0",
"46 s","Religious Activities","2019 ","4","2","2",
"46 s","Investors","2000 ","47","33","14",
"46 s","Investors","2001 ","45","32","13",
"46 s","Investors","2002 ","23","20","3",
"46 s","Investors","2003 ","34","29","5",
"46 s","Investors","2004 ","26","19","7",
"46 s","Investors","2005 ","37","30","7",
"46 s","Investors","2006 ","26","21","5",
"46 s","Investors","2007 ","25","23","2",
"46 s","Investors","2008 ","29","27","2",
"46 s","Investors","2009 ","24","21","3",
"46 s","Investors","2010 ","21","21","0",
"46 s","Investors","2011 ","30","26","4",
"46 s","Investors","2012 ","24","24","",
"46 s","Investors","2013 ","28","28","0",
"46 s","Investors","2014 ","19","18","1",
"46 s","Investors","2015 ","22","21","1",
"46 s","Investors","2016 ","22","21","1",
"46 s","Investors","2017 ","19","16","3",
"46 s","Investors","2018 ","20","19","1",
"46 s","Investors","2019 ","20","17","3",
"46 s","Trade and Business","2000 ","15","14","1",
"46 s","Trade and Business","2001 ","22","22","0",
"46 s","Trade and Business","2002 ","13","13","0",
"46 s","Trade and Business","2003 ","21","20","1",
"46 s","Trade and Business","2004 ","13","13","0",
"46 s","Trade and Business","2005 ","27","27","0",
"46 s","Trade and Business","2006 ","21","21","0",
"46 s","Trade and Business","2007 ","20","20","0",
"46 s","Trade and Business","2008 ","11","10","1",
"46 s","Trade and Business","2009 ","16","16","0",
"46 s","Trade and Business","2010 ","16","16","0",
"46 s","Trade and Business","2011 ","36","35","1",
"46 s","Trade and Business","2012 ","36","33","3",
"46 s","Trade and Business","2013 ","28","28","0",
"46 s","Trade and Business","2014 ","40","40","0",
"46 s","Trade and Business","2015 ","30","29","1",
"46 s","Trade and Business","2016 ","34","33","1",
"46 s","Trade and Business","2017 ","19","19","0",
"46 s","Trade and Business","2018 ","20","19","1",
"46 s","Trade and Business","2019 ","17","16","1",
"46 s","Research","2000 ","9","7","2",
"46 s","Research","2001 ","6","6","0",
"46 s","Research","2002 ","9","8","1",
"46 s","Research","2003 ","19","17","2",
"46 s","Research","2004 ","16","10","6",
"46 s","Research","2005 ","10","10","0",
"46 s","Research","2006 ","11","9","2",
"46 s","Research","2007 ","5","5","0",
"46 s","Research","2008 ","4","3","1",
"46 s","Research","2009 ","4","3","1",
"46 s","Research","2010 ","12","11","1",
"46 s","Research","2011 ","8","8","",
"46 s","Research","2012 ","5","4","1",
"46 s","Research","2013 ","7","7","0",
"46 s","Research","2014 ","5","4","1",
"46 s","Research","2015 ","3","3","0",
"46 s","Research","2016 ","11","10","1",
"46 s","Research","2017 ","3","3","0",
"46 s","Research","2018 ","6","5","1",
"46 s","Research","2019 ","4","3","1",
"46 s","Art and Entertainment","2000 ","8","7","1",
"46 s","Art and Entertainment","2001 ","15","15","0",
"46 s","Art and Entertainment","2002 ","14","11","3",
"46 s","Art and Entertainment","2003 ","15","13","2",
"46 s","Art and Entertainment","2004 ","6","5","1",
"46 s","Art and Entertainment","2005 ","11","9","2",
"46 s","Art and Entertainment","2006 ","15","12","3",
"46 s","Art and Entertainment","2007 ","14","12","2",
"46 s","Art and Entertainment","2008 ","13","11","2",
"46 s","Art and Entertainment","2009 ","7","7","0",
"46 s","Art and Entertainment","2010 ","13","12","1",
"46 s","Art and Entertainment","2011 ","8","8","",
"46 s","Art and Entertainment","2012 ","11","8","3",
"46 s","Art and Entertainment","2013 ","10","9","1",
"46 s","Art and Entertainment","2014 ","6","5","1",
"46 s","Art and Entertainment","2015 ","5","3","2",
"46 s","Art and Entertainment","2016 ","7","6","1",
"46 s","Art and Entertainment","2017 ","4","3","1",
"46 s","Art and Entertainment","2018 ","5","4","1",
"46 s","Art and Entertainment","2019 ","3","1","2",
"46 s","Unskilled Employment","2000 ","0","0","0",
"46 s","Unskilled Employment","2001 ","0","0","0",
"46 s","Unskilled Employment","2002 ","0","0","0",
"46 s","Unskilled Employment","2003 ","11","8","3",
"46 s","Unskilled Employment","2004 ","51","37","14",
"46 s","Unskilled Employment","2005 ","12","8","4",
"46 s","Unskilled Employment","2006 ","41","29","12",
"46 s","Unskilled Employment","2007 ","12","5","7",
"46 s","Unskilled Employment","2008 ","0","0","0",
"46 s","Unskilled Employment","2009 ","5","2","3",
"46 s","Unskilled Employment","2010 ","1","1","0",
"46 s","Unskilled Employment","2011 ","2","2","",
"46 s","Unskilled Employment","2012 ","4","3","1",
"46 s","Unskilled Employment","2013 ","10","10","0",
"46 s","Unskilled Employment","2015 ","5","5","0",
"46 s","Unskilled Employment","2016 ","6","6","0",
"46 s","Unskilled Employment","2017 ","5","5","0",
"46 s","Unskilled Employment","2018 ","7","7","0",
"46 s","Unskilled Employment","2019 ","9","9","0",
"46 s","Visiting and Joining Family","2000 ","56","5","51",
"46 s","Visiting and Joining Family","2001 ","92","6","86",
"46 s","Visiting and Joining Family","2002 ","109","27","82",
"46 s","Visiting and Joining Family","2003 ","480","266","214",
"46 s","Visiting and Joining Family","2004 ","711","371","340",
"46 s","Visiting and Joining Family","2005 ","1607","843","764",
"46 s","Visiting and Joining Family","2006 ","3056","1658","1398",
"46 s","Visiting and Joining Family","2007 ","447","237","210",
"46 s","Visiting and Joining Family","2008 ","17","7","10",
"46 s","Visiting and Joining Family","2009 ","35","17","18",
"46 s","Visiting and Joining Family","2010 ","59","29","30",
"46 s","Visiting and Joining Family","2011 ","51","23","28",
"46 s","Visiting and Joining Family","2012 ","62","15","47",
"46 s","Visiting and Joining Family","2013 ","81","17","64",
"46 s","Visiting and Joining Family","2014 ","164","32","132",
"46 s","Visiting and Joining Family","2015 ","223","59","164",
"46 s","Visiting and Joining Family","2016 ","392","143","249",
"46 s","Visiting and Joining Family","2017 ","348","119","229",
"46 s","Visiting and Joining Family","2018 ","404","151","253",
"46 s","Visiting and Joining Family","2019 ","428","149","279",
"46 s","Overseas Koreans","2000 ","16","8","8",
"46 s","Overseas Koreans","2001 ","35","13","22",
"46 s","Overseas Koreans","2002 ","44","22","22",
"46 s","Overseas Koreans","2003 ","38","18","20",
"46 s","Overseas Koreans","2004 ","43","20","23",
"46 s","Overseas Koreans","2005 ","46","17","29",
"46 s","Overseas Koreans","2006 ","50","22","28",
"46 s","Overseas Koreans","2007 ","47","18","29",
"46 s","Overseas Koreans","2008 ","49","20","29",
"46 s","Overseas Koreans","2009 ","57","18","39",
"46 s","Overseas Koreans","2010 ","275","113","162",
"46 s","Overseas Koreans","2011 ","293","135","158",
"46 s","Overseas Koreans","2012 ","220","108","112",
"46 s","Overseas Koreans","2013 ","234","115","119",
"46 s","Overseas Koreans","2014 ","276","119","157",
"46 s","Overseas Koreans","2015 ","356","199","157",
"46 s","Overseas Koreans","2016 ","484","249","235",
"46 s","Overseas Koreans","2017 ","579","304","275",
"46 s","Overseas Koreans","2018 ","605","336","269",
"46 s","Overseas Koreans","2019 ","577","301","276",
"46 s","Permanent Residence","2000 ","0","0","0",
"46 s","Permanent Residence","2001 ","0","0","0",
"46 s","Permanent Residence","2002 ","0","0","0",
"46 s","Permanent Residence","2003 ","5","3","2",
"46 s","Permanent Residence","2004 ","9","5","4",
"46 s","Permanent Residence","2005 ","10","5","5",
"46 s","Permanent Residence","2006 ","6","5","1",
"46 s","Permanent Residence","2007 ","7","4","3",
"46 s","Permanent Residence","2008 ","6","4","2",
"46 s","Permanent Residence","2009 ","11","4","7",
"46 s","Permanent Residence","2010 ","20","10","10",
"46 s","Permanent Residence","2011 ","68","26","42",
"46 s","Permanent Residence","2012 ","86","34","52",
"46 s","Permanent Residence","2013 ","93","36","57",
"46 s","Permanent Residence","2014 ","92","41","51",
"46 s","Permanent Residence","2015 ","133","55","78",
"46 s","Permanent Residence","2016 ","141","58","83",
"46 s","Permanent Residence","2017 ","144","66","78",
"46 s","Permanent Residence","2018 ","134","57","77",
"46 s","Permanent Residence","2019 ","146","56","90",
"46 s","Marriage Immigration","2011 ","7","2","5",
"46 s","Marriage Immigration","2012 ","161","44","117",
"46 s","Marriage Immigration","2013 ","126","33","93",
"46 s","Marriage Immigration","2014 ","142","34","108",
"46 s","Marriage Immigration","2015 ","102","26","76",
"46 s","Marriage Immigration","2016 ","114","33","81",
"46 s","Marriage Immigration","2017 ","102","32","70",
"46 s","Marriage Immigration","2018 ","133","39","94",
"46 s","Marriage Immigration","2019 ","127","35","92",
"47 s","Total","2000 ","1607","926","681",
"47 s","Total","2001 ","1863","1090","773",
"47 s","Total","2002 ","1911","1135","776",
"47 s","Total","2003 ","2127","1158","969",
"47 s","Total","2004 ","2614","1336","1278",
"47 s","Total","2005 ","3780","1842","1938",
"47 s","Total","2006 ","4077","2194","1883",
"47 s","Total","2007 ","5118","2621","2497",
"47 s","Total","2008 ","3852","1975","1877",
"47 s","Total","2009 ","2717","1351","1366",
"47 s","Total","2010 ","6163","3044","3119",
"47 s","Total","2011 ","4615","2233","2382",
"47 s","Total","2012 ","3481","1631","1850",
"47 s","Total","2013 ","5306","2624","2682",
"47 s","Total","2014 ","5605","2991","2614",
"47 s","Total","2015 ","4817","2424","2393",
"47 s","Total","2016 ","5232","2681","2551",
"47 s","Total","2017 ","5885","3192","2693",
"47 s","Total","2018 ","6373","3493","2880",
"47 s","Total","2019 ","5177","2645","2532",
"47 s","Sightseeing Pass","2000 ","212","120","92",
"47 s","Sightseeing Pass","2001 ","307","205","102",
"47 s","Sightseeing Pass","2002 ","364","225","139",
"47 s","Sightseeing Pass","2003 ","308","193","115",
"47 s","Sightseeing Pass","2004 ","321","201","120",
"47 s","Sightseeing Pass","2005 ","286","189","97",
"47 s","Sightseeing Pass","2006 ","217","139","78",
"47 s","Sightseeing Pass","2007 ","169","93","76",
"47 s","Sightseeing Pass","2008 ","210","133","77",
"47 s","Sightseeing Pass","2009 ","229","128","101",
"47 s","Sightseeing Pass","2010 ","303","172","131",
"47 s","Sightseeing Pass","2011 ","220","117","103",
"47 s","Sightseeing Pass","2012 ","233","119","114",
"47 s","Sightseeing Pass","2013 ","166","92","74",
"47 s","Sightseeing Pass","2014 ","223","124","99",
"47 s","Sightseeing Pass","2015 ","309","169","140",
"47 s","Sightseeing Pass","2016 ","305","147","158",
"47 s","Sightseeing Pass","2017 ","414","246","168",
"47 s","Sightseeing Pass","2018 ","684","453","231",
"47 s","Sightseeing Pass","2019 ","359","167","192",
"47 s","Short-term Business","2000 ","251","173","78",
"47 s","Short-term Business","2001 ","274","199","75",
"47 s","Short-term Business","2002 ","174","135","39",
"47 s","Short-term Business","2003 ","145","107","38",
"47 s","Short-term Business","2004 ","122","99","23",
"47 s","Short-term Business","2005 ","125","85","40",
"47 s","Short-term Business","2006 ","151","118","33",
"47 s","Short-term Business","2007 ","208","164","44",
"47 s","Short-term Business","2008 ","103","85","18",
"47 s","Short-term Business","2009 ","45","36","9",
"47 s","Short-term Business","2010 ","45","39","6",
"47 s","Short-term Business","2011 ","49","40","9",
"47 s","Short-term Visitors","2000 ","677","335","342",
"47 s","Short-term Visitors","2001 ","754","367","387",
"47 s","Short-term Visitors","2002 ","721","387","334",
"47 s","Short-term Visitors","2003 ","592","299","293",
"47 s","Short-term Visitors","2004 ","525","281","244",
"47 s","Short-term Visitors","2005 ","595","263","332",
"47 s","Short-term Visitors","2006 ","491","247","244",
"47 s","Short-term Visitors","2007 ","437","204","233",
"47 s","Short-term Visitors","2008 ","330","141","189",
"47 s","Short-term Visitors","2009 ","296","115","181",
"47 s","Short-term Visitors","2010 ","2084","966","1118",
"47 s","Short-term Visitors","2011 ","1868","866","1002",
"47 s","Short-term Visitors","2012 ","1315","555","760",
"47 s","Short-term Visitors","2013 ","1906","886","1020",
"47 s","Short-term Visitors","2014 ","1308","691","617",
"47 s","Short-term Visitors","2015 ","1410","729","681",
"47 s","Short-term Visitors","2016 ","1560","869","691",
"47 s","Short-term Visitors","2017 ","1486","877","609",
"47 s","Short-term Visitors","2018 ","1429","764","665",
"47 s","Short-term Visitors","2019 ","1260","680","580",
"47 s","Short-term Employment","2000 ","2","2","0",
"47 s","Short-term Employment","2001 ","4","2","2",
"47 s","Short-term Employment","2002 ","2","2","0",
"47 s","Short-term Employment","2003 ","1","1","0",
"47 s","Short-term Employment","2004 ","1","1","0",
"47 s","Short-term Employment","2005 ","2","1","1",
"47 s","Short-term Employment","2006 ","2","2","0",
"47 s","Short-term Employment","2007 ","3","2","1",
"47 s","Short-term Employment","2008 ","1","1","0",
"47 s","Short-term Employment","2009 ","1","1","0",
"47 s","Short-term Employment","2010 ","0","0","0",
"47 s","Short-term Employment","2011 ","1","1","",
"47 s","Short-term Employment","2012 ","2","1","1",
"47 s","Short-term Employment","2013 ","1","1","0",
"47 s","Short-term Employment","2014 ","1","1","0",
"47 s","Short-term Employment","2015 ","1","1","0",
"47 s","Short-term Employment","2016 ","6","6","0",
"47 s","Short-term Employment","2017 ","1","1","0",
"47 s","Short-term Employment","2018 ","3","3","0",
"47 s","Short-term Employment","2019 ","4","3","1",
"47 s","Job Seeking","2000 ","0","0","0",
"47 s","Job Seeking","2001 ","0","0","0",
"47 s","Job Seeking","2002 ","0","0","0",
"47 s","Job Seeking","2003 ","0","0","0",
"47 s","Job Seeking","2004 ","0","0","0",
"47 s","Job Seeking","2005 ","0","0","0",
"47 s","Job Seeking","2006 ","0","0","0",
"47 s","Job Seeking","2007 ","0","0","0",
"47 s","Job Seeking","2008 ","0","0","0",
"47 s","Job Seeking","2009 ","0","0","0",
"47 s","Job Seeking","2010 ","0","0","0",
"47 s","Job Seeking","2015 ","1","1","0",
"47 s","Job Seeking","2016 ","1","0","1",
"47 s","Job Seeking","2017 ","1","1","0",
"47 s","study","2000 ","2","1","1",
"47 s","study","2001 ","4","2","2",
"47 s","study","2002 ","2","2","0",
"47 s","study","2003 ","5","4","1",
"47 s","study","2004 ","6","4","2",
"47 s","study","2005 ","7","7","0",
"47 s","study","2006 ","6","4","2",
"47 s","study","2007 ","4","4","0",
"47 s","study","2008 ","2","1","1",
"47 s","study","2009 ","5","2","3",
"47 s","study","2010 ","7","7","0",
"47 s","study","2011 ","8","7","1",
"47 s","study","2012 ","6","5","1",
"47 s","study","2013 ","5","3","2",
"47 s","study","2014 ","3","2","1",
"47 s","study","2015 ","6","5","1",
"47 s","study","2016 ","7","3","4",
"47 s","study","2017 ","8","6","2",
"47 s","study","2018 ","6","4","2",
"47 s","study","2019 ","8","5","3",
"47 s","General Trainees","2000 ","3","2","1",
"47 s","General Trainees","2001 ","2","2","0",
"47 s","General Trainees","2002 ","3","2","1",
"47 s","General Trainees","2003 ","2","0","2",
"47 s","General Trainees","2004 ","1","1","0",
"47 s","General Trainees","2005 ","3","2","1",
"47 s","General Trainees","2006 ","1","1","0",
"47 s","General Trainees","2007 ","7","5","2",
"47 s","General Trainees","2008 ","9","7","2",
"47 s","General Trainees","2009 ","0","0","0",
"47 s","General Trainees","2010 ","7","3","4",
"47 s","General Trainees","2011 ","36","17","19",
"47 s","General Trainees","2013 ","6","3","3",
"47 s","General Trainees","2014 ","7","5","2",
"47 s","General Trainees","2015 ","5","2","3",
"47 s","General Trainees","2016 ","7","5","2",
"47 s","General Trainees","2017 ","6","3","3",
"47 s","General Trainees","2018 ","10","6","4",
"47 s","General Trainees","2019 ","5","3","2",
"47 s","Religious Activities","2000 ","1","0","1",
"47 s","Religious Activities","2001 ","6","4","2",
"47 s","Religious Activities","2002 ","1","0","1",
"47 s","Religious Activities","2003 ","4","4","0",
"47 s","Religious Activities","2004 ","2","2","0",
"47 s","Religious Activities","2005 ","2","1","1",
"47 s","Religious Activities","2006 ","5","5","0",
"47 s","Religious Activities","2007 ","2","1","1",
"47 s","Religious Activities","2008 ","6","4","2",
"47 s","Religious Activities","2009 ","6","3","3",
"47 s","Religious Activities","2010 ","5","3","2",
"47 s","Religious Activities","2011 ","6","5","1",
"47 s","Religious Activities","2012 ","2","1","1",
"47 s","Religious Activities","2013 ","2","2","0",
"47 s","Religious Activities","2014 ","3","1","2",
"47 s","Religious Activities","2015 ","5","3","2",
"47 s","Religious Activities","2016 ","5","5","0",
"47 s","Religious Activities","2017 ","2","2","0",
"47 s","Religious Activities","2018 ","1","1","0",
"47 s","Religious Activities","2019 ","1","1","0",
"47 s","Investors","2000 ","39","26","13",
"47 s","Investors","2001 ","38","29","9",
"47 s","Investors","2002 ","28","25","3",
"47 s","Investors","2003 ","34","33","1",
"47 s","Investors","2004 ","31","23","8",
"47 s","Investors","2005 ","37","32","5",
"47 s","Investors","2006 ","15","13","2",
"47 s","Investors","2007 ","19","19","0",
"47 s","Investors","2008 ","22","20","2",
"47 s","Investors","2009 ","20","19","1",
"47 s","Investors","2010 ","17","17","0",
"47 s","Investors","2011 ","21","19","2",
"47 s","Investors","2012 ","14","14","",
"47 s","Investors","2013 ","21","20","1",
"47 s","Investors","2014 ","20","19","1",
"47 s","Investors","2015 ","14","14","0",
"47 s","Investors","2016 ","36","34","2",
"47 s","Investors","2017 ","15","15","0",
"47 s","Investors","2018 ","14","11","3",
"47 s","Investors","2019 ","13","12","1",
"47 s","Trade and Business","2000 ","6","6","0",
"47 s","Trade and Business","2001 ","13","13","0",
"47 s","Trade and Business","2002 ","19","18","1",
"47 s","Trade and Business","2003 ","19","19","0",
"47 s","Trade and Business","2004 ","11","11","0",
"47 s","Trade and Business","2005 ","26","25","1",
"47 s","Trade and Business","2006 ","16","16","0",
"47 s","Trade and Business","2007 ","12","12","0",
"47 s","Trade and Business","2008 ","21","21","0",
"47 s","Trade and Business","2009 ","21","21","0",
"47 s","Trade and Business","2010 ","17","17","0",
"47 s","Trade and Business","2011 ","24","23","1",
"47 s","Trade and Business","2012 ","27","27","",
"47 s","Trade and Business","2013 ","42","41","1",
"47 s","Trade and Business","2014 ","45","41","4",
"47 s","Trade and Business","2015 ","31","30","1",
"47 s","Trade and Business","2016 ","29","29","0",
"47 s","Trade and Business","2017 ","14","14","0",
"47 s","Trade and Business","2018 ","20","19","1",
"47 s","Trade and Business","2019 ","21","21","0",
"47 s","Research","2000 ","7","7","0",
"47 s","Research","2001 ","9","8","1",
"47 s","Research","2002 ","11","11","0",
"47 s","Research","2003 ","17","13","4",
"47 s","Research","2004 ","14","10","4",
"47 s","Research","2005 ","3","2","1",
"47 s","Research","2006 ","5","5","0",
"47 s","Research","2007 ","3","3","0",
"47 s","Research","2008 ","6","6","0",
"47 s","Research","2009 ","3","3","0",
"47 s","Research","2010 ","4","4","0",
"47 s","Research","2011 ","3","2","1",
"47 s","Research","2012 ","7","6","1",
"47 s","Research","2013 ","10","9","1",
"47 s","Research","2014 ","1","1","0",
"47 s","Research","2015 ","4","3","1",
"47 s","Research","2016 ","6","6","0",
"47 s","Research","2017 ","5","4","1",
"47 s","Research","2018 ","3","3","0",
"47 s","Research","2019 ","1","1","0",
"47 s","Art and Entertainment","2000 ","5","4","1",
"47 s","Art and Entertainment","2001 ","6","6","0",
"47 s","Art and Entertainment","2002 ","15","15","0",
"47 s","Art and Entertainment","2003 ","14","10","4",
"47 s","Art and Entertainment","2004 ","3","2","1",
"47 s","Art and Entertainment","2005 ","10","10","0",
"47 s","Art and Entertainment","2006 ","4","2","2",
"47 s","Art and Entertainment","2007 ","5","4","1",
"47 s","Art and Entertainment","2008 ","6","5","1",
"47 s","Art and Entertainment","2009 ","7","6","1",
"47 s","Art and Entertainment","2010 ","5","4","1",
"47 s","Art and Entertainment","2011 ","5","5","",
"47 s","Art and Entertainment","2012 ","7","6","1",
"47 s","Art and Entertainment","2013 ","10","8","2",
"47 s","Art and Entertainment","2014 ","7","6","1",
"47 s","Art and Entertainment","2015 ","3","3","0",
"47 s","Art and Entertainment","2016 ","6","5","1",
"47 s","Art and Entertainment","2017 ","2","2","0",
"47 s","Art and Entertainment","2018 ","9","9","0",
"47 s","Art and Entertainment","2019 ","3","1","2",
"47 s","Unskilled Employment","2000 ","0","0","0",
"47 s","Unskilled Employment","2001 ","0","0","0",
"47 s","Unskilled Employment","2002 ","0","0","0",
"47 s","Unskilled Employment","2003 ","10","7","3",
"47 s","Unskilled Employment","2004 ","50","32","18",
"47 s","Unskilled Employment","2005 ","4","4","0",
"47 s","Unskilled Employment","2006 ","39","17","22",
"47 s","Unskilled Employment","2007 ","12","4","8",
"47 s","Unskilled Employment","2008 ","4","2","2",
"47 s","Unskilled Employment","2009 ","0","0","0",
"47 s","Unskilled Employment","2010 ","0","0","0",
"47 s","Unskilled Employment","2011 ","1","1","",
"47 s","Unskilled Employment","2012 ","3","3","",
"47 s","Unskilled Employment","2013 ","1","1","0",
"47 s","Unskilled Employment","2014 ","1","1","0",
"47 s","Unskilled Employment","2016 ","1","1","0",
"47 s","Unskilled Employment","2017 ","1","1","0",
"47 s","Unskilled Employment","2018 ","1","1","0",
"47 s","Unskilled Employment","2019 ","9","8","1",
"47 s","Visiting and Joining Family","2000 ","41","6","35",
"47 s","Visiting and Joining Family","2001 ","86","5","81",
"47 s","Visiting and Joining Family","2002 ","112","26","86",
"47 s","Visiting and Joining Family","2003 ","442","234","208",
"47 s","Visiting and Joining Family","2004 ","735","367","368",
"47 s","Visiting and Joining Family","2005 ","1790","886","904",
"47 s","Visiting and Joining Family","2006 ","2495","1348","1147",
"47 s","Visiting and Joining Family","2007 ","407","207","200",
"47 s","Visiting and Joining Family","2008 ","18","7","11",
"47 s","Visiting and Joining Family","2009 ","23","9","14",
"47 s","Visiting and Joining Family","2010 ","73","39","34",
"47 s","Visiting and Joining Family","2011 ","62","23","39",
"47 s","Visiting and Joining Family","2012 ","59","14","45",
"47 s","Visiting and Joining Family","2013 ","91","21","70",
"47 s","Visiting and Joining Family","2014 ","179","44","135",
"47 s","Visiting and Joining Family","2015 ","253","73","180",
"47 s","Visiting and Joining Family","2016 ","431","146","285",
"47 s","Visiting and Joining Family","2017 ","429","163","266",
"47 s","Visiting and Joining Family","2018 ","387","146","241",
"47 s","Visiting and Joining Family","2019 ","455","171","284",
"47 s","Overseas Koreans","2000 ","13","1","12",
"47 s","Overseas Koreans","2001 ","20","8","12",
"47 s","Overseas Koreans","2002 ","29","15","14",
"47 s","Overseas Koreans","2003 ","43","12","31",
"47 s","Overseas Koreans","2004 ","52","21","31",
"47 s","Overseas Koreans","2005 ","45","16","29",
"47 s","Overseas Koreans","2006 ","37","15","22",
"47 s","Overseas Koreans","2007 ","64","23","41",
"47 s","Overseas Koreans","2008 ","59","16","43",
"47 s","Overseas Koreans","2009 ","75","29","46",
"47 s","Overseas Koreans","2010 ","404","164","240",
"47 s","Overseas Koreans","2011 ","399","170","229",
"47 s","Overseas Koreans","2012 ","234","114","120",
"47 s","Overseas Koreans","2013 ","293","156","137",
"47 s","Overseas Koreans","2014 ","273","133","140",
"47 s","Overseas Koreans","2015 ","381","197","184",
"47 s","Overseas Koreans","2016 ","517","285","232",
"47 s","Overseas Koreans","2017 ","506","255","251",
"47 s","Overseas Koreans","2018 ","607","321","286",
"47 s","Overseas Koreans","2019 ","579","313","266",
"47 s","Permanent Residence","2000 ","0","0","0",
"47 s","Permanent Residence","2001 ","0","0","0",
"47 s","Permanent Residence","2002 ","0","0","0",
"47 s","Permanent Residence","2003 ","11","7","4",
"47 s","Permanent Residence","2004 ","10","5","5",
"47 s","Permanent Residence","2005 ","17","11","6",
"47 s","Permanent Residence","2006 ","5","4","1",
"47 s","Permanent Residence","2007 ","5","4","1",
"47 s","Permanent Residence","2008 ","6","3","3",
"47 s","Permanent Residence","2009 ","7","3","4",
"47 s","Permanent Residence","2010 ","23","7","16",
"47 s","Permanent Residence","2011 ","69","28","41",
"47 s","Permanent Residence","2012 ","85","33","52",
"47 s","Permanent Residence","2013 ","93","38","55",
"47 s","Permanent Residence","2014 ","81","36","45",
"47 s","Permanent Residence","2015 ","110","44","66",
"47 s","Permanent Residence","2016 ","116","54","62",
"47 s","Permanent Residence","2017 ","112","45","67",
"47 s","Permanent Residence","2018 ","124","63","61",
"47 s","Permanent Residence","2019 ","112","47","65",
"47 s","Marriage Immigration","2011 ","3","1","2",
"47 s","Marriage Immigration","2012 ","141","40","101",
"47 s","Marriage Immigration","2013 ","148","34","114",
"47 s","Marriage Immigration","2014 ","104","28","76",
"47 s","Marriage Immigration","2015 ","109","39","70",
"47 s","Marriage Immigration","2016 ","120","36","84",
"47 s","Marriage Immigration","2017 ","114","33","81",
"47 s","Marriage Immigration","2018 ","109","34","75",
"47 s","Marriage Immigration","2019 ","110","24","86",
"48 s","Total","2000 ","1481","805","676",
"48 s","Total","2001 ","1698","1023","675",
"48 s","Total","2002 ","1771","1043","728",
"48 s","Total","2003 ","2033","1100","933",
"48 s","Total","2004 ","2477","1233","1244",
"48 s","Total","2005 ","3664","1792","1872",
"48 s","Total","2006 ","4288","2231","2057",
"48 s","Total","2007 ","4299","2244","2055",
"48 s","Total","2008 ","4519","2239","2280",
"48 s","Total","2009 ","2673","1278","1395",
"48 s","Total","2010 ","4179","2074","2105",
"48 s","Total","2011 ","5100","2443","2657",
"48 s","Total","2012 ","3503","1624","1879",
"48 s","Total","2013 ","5774","2898","2876",
"48 s","Total","2014 ","6150","3229","2921",
"48 s","Total","2015 ","4286","2143","2143",
"48 s","Total","2016 ","4571","2262","2309",
"48 s","Total","2017 ","5736","3004","2732",
"48 s","Total","2018 ","6365","3505","2860",
"48 s","Total","2019 ","5233","2660","2573",
"48 s","Sightseeing Pass","2000 ","206","119","87",
"48 s","Sightseeing Pass","2001 ","311","208","103",
"48 s","Sightseeing Pass","2002 ","352","229","123",
"48 s","Sightseeing Pass","2003 ","285","177","108",
"48 s","Sightseeing Pass","2004 ","317","187","130",
"48 s","Sightseeing Pass","2005 ","261","149","112",
"48 s","Sightseeing Pass","2006 ","223","135","88",
"48 s","Sightseeing Pass","2007 ","177","110","67",
"48 s","Sightseeing Pass","2008 ","194","105","89",
"48 s","Sightseeing Pass","2009 ","210","110","100",
"48 s","Sightseeing Pass","2010 ","234","138","96",
"48 s","Sightseeing Pass","2011 ","225","123","102",
"48 s","Sightseeing Pass","2012 ","233","117","116",
"48 s","Sightseeing Pass","2013 ","201","106","95",
"48 s","Sightseeing Pass","2014 ","226","128","98",
"48 s","Sightseeing Pass","2015 ","260","145","115",
"48 s","Sightseeing Pass","2016 ","301","151","150",
"48 s","Sightseeing Pass","2017 ","352","216","136",
"48 s","Sightseeing Pass","2018 ","599","375","224",
"48 s","Sightseeing Pass","2019 ","335","162","173",
"48 s","Short-term Business","2000 ","155","103","52",
"48 s","Short-term Business","2001 ","212","158","54",
"48 s","Short-term Business","2002 ","129","100","29",
"48 s","Short-term Business","2003 ","117","85","32",
"48 s","Short-term Business","2004 ","114","89","25",
"48 s","Short-term Business","2005 ","111","84","27",
"48 s","Short-term Business","2006 ","135","95","40",
"48 s","Short-term Business","2007 ","149","122","27",
"48 s","Short-term Business","2008 ","85","68","17",
"48 s","Short-term Business","2009 ","39","26","13",
"48 s","Short-term Business","2010 ","39","34","5",
"48 s","Short-term Business","2011 ","35","30","5",
"48 s","Short-term Visitors","2000 ","682","297","385",
"48 s","Short-term Visitors","2001 ","701","384","317",
"48 s","Short-term Visitors","2002 ","692","359","333",
"48 s","Short-term Visitors","2003 ","656","333","323",
"48 s","Short-term Visitors","2004 ","568","263","305",
"48 s","Short-term Visitors","2005 ","688","317","371",
"48 s","Short-term Visitors","2006 ","503","247","256",
"48 s","Short-term Visitors","2007 ","388","181","207",
"48 s","Short-term Visitors","2008 ","380","143","237",
"48 s","Short-term Visitors","2009 ","267","87","180",
"48 s","Short-term Visitors","2010 ","1429","681","748",
"48 s","Short-term Visitors","2011 ","2044","983","1061",
"48 s","Short-term Visitors","2012 ","1135","473","662",
"48 s","Short-term Visitors","2013 ","1998","952","1046",
"48 s","Short-term Visitors","2014 ","1430","714","716",
"48 s","Short-term Visitors","2015 ","1293","674","619",
"48 s","Short-term Visitors","2016 ","1348","709","639",
"48 s","Short-term Visitors","2017 ","1443","750","693",
"48 s","Short-term Visitors","2018 ","1487","824","663",
"48 s","Short-term Visitors","2019 ","1216","674","542",
"48 s","Short-term Employment","2000 ","2","0","2",
"48 s","Short-term Employment","2001 ","3","3","0",
"48 s","Short-term Employment","2002 ","5","4","1",
"48 s","Short-term Employment","2003 ","3","2","1",
"48 s","Short-term Employment","2004 ","4","4","0",
"48 s","Short-term Employment","2005 ","5","3","2",
"48 s","Short-term Employment","2006 ","5","5","0",
"48 s","Short-term Employment","2007 ","1","1","0",
"48 s","Short-term Employment","2008 ","1","0","1",
"48 s","Short-term Employment","2009 ","1","1","0",
"48 s","Short-term Employment","2010 ","0","0","0",
"48 s","Short-term Employment","2015 ","1","1","0",
"48 s","Short-term Employment","2016 ","4","4","0",
"48 s","Short-term Employment","2017 ","4","4","0",
"48 s","Short-term Employment","2018 ","4","3","1",
"48 s","Short-term Employment","2019 ","1","1","0",
"48 s","Job Seeking","2000 ","0","0","0",
"48 s","Job Seeking","2001 ","0","0","0",
"48 s","Job Seeking","2002 ","0","0","0",
"48 s","Job Seeking","2003 ","0","0","0",
"48 s","Job Seeking","2004 ","0","0","0",
"48 s","Job Seeking","2005 ","0","0","0",
"48 s","Job Seeking","2006 ","0","0","0",
"48 s","Job Seeking","2007 ","0","0","0",
"48 s","Job Seeking","2008 ","0","0","0",
"48 s","Job Seeking","2009 ","0","0","0",
"48 s","Job Seeking","2010 ","0","0","0",
"48 s","Job Seeking","2013 ","1","1","0",
"48 s","Job Seeking","2018 ","1","1","0",
"48 s","study","2000 ","2","2","0",
"48 s","study","2001 ","2","2","0",
"48 s","study","2002 ","5","2","3",
"48 s","study","2003 ","7","5","2",
"48 s","study","2004 ","3","2","1",
"48 s","study","2005 ","2","1","1",
"48 s","study","2006 ","4","3","1",
"48 s","study","2007 ","3","2","1",
"48 s","study","2008 ","5","4","1",
"48 s","study","2009 ","5","5","0",
"48 s","study","2010 ","6","2","4",
"48 s","study","2011 ","3","2","1",
"48 s","study","2012 ","6","4","2",
"48 s","study","2013 ","3","2","1",
"48 s","study","2014 ","3","2","1",
"48 s","study","2015 ","5","3","2",
"48 s","study","2016 ","6","5","1",
"48 s","study","2017 ","4","2","2",
"48 s","study","2018 ","11","9","2",
"48 s","study","2019 ","12","7","5",
"48 s","General Trainees","2000 ","3","2","1",
"48 s","General Trainees","2001 ","1","1","0",
"48 s","General Trainees","2002 ","2","1","1",
"48 s","General Trainees","2003 ","3","3","0",
"48 s","General Trainees","2004 ","5","5","0",
"48 s","General Trainees","2005 ","3","3","0",
"48 s","General Trainees","2006 ","3","1","2",
"48 s","General Trainees","2007 ","4","2","2",
"48 s","General Trainees","2008 ","5","4","1",
"48 s","General Trainees","2009 ","5","2","3",
"48 s","General Trainees","2010 ","6","5","1",
"48 s","General Trainees","2011 ","40","18","22",
"48 s","General Trainees","2013 ","4","2","2",
"48 s","General Trainees","2014 ","2","1","1",
"48 s","General Trainees","2015 ","3","3","0",
"48 s","General Trainees","2016 ","7","5","2",
"48 s","General Trainees","2017 ","2","1","1",
"48 s","General Trainees","2018 ","5","4","1",
"48 s","General Trainees","2019 ","6","4","2",
"48 s","Religious Activities","2000 ","3","1","2",
"48 s","Religious Activities","2001 ","3","1","2",
"48 s","Religious Activities","2002 ","6","3","3",
"48 s","Religious Activities","2003 ","4","3","1",
"48 s","Religious Activities","2004 ","3","2","1",
"48 s","Religious Activities","2005 ","3","2","1",
"48 s","Religious Activities","2006 ","4","3","1",
"48 s","Religious Activities","2007 ","4","3","1",
"48 s","Religious Activities","2008 ","1","1","0",
"48 s","Religious Activities","2009 ","4","3","1",
"48 s","Religious Activities","2010 ","4","2","2",
"48 s","Religious Activities","2011 ","8","6","2",
"48 s","Religious Activities","2012 ","2","2","",
"48 s","Religious Activities","2013 ","6","4","2",
"48 s","Religious Activities","2014 ","6","5","1",
"48 s","Religious Activities","2015 ","4","2","2",
"48 s","Religious Activities","2016 ","7","5","2",
"48 s","Religious Activities","2017 ","2","1","1",
"48 s","Religious Activities","2018 ","7","3","4",
"48 s","Religious Activities","2019 ","1","1","0",
"48 s","Investors","2000 ","25","16","9",
"48 s","Investors","2001 ","25","20","5",
"48 s","Investors","2002 ","36","30","6",
"48 s","Investors","2003 ","25","18","7",
"48 s","Investors","2004 ","28","24","4",
"48 s","Investors","2005 ","36","27","9",
"48 s","Investors","2006 ","19","18","1",
"48 s","Investors","2007 ","13","12","1",
"48 s","Investors","2008 ","20","17","3",
"48 s","Investors","2009 ","19","16","3",
"48 s","Investors","2010 ","22","20","2",
"48 s","Investors","2011 ","19","18","1",
"48 s","Investors","2012 ","16","16","",
"48 s","Investors","2013 ","21","20","1",
"48 s","Investors","2014 ","15","15","0",
"48 s","Investors","2015 ","16","16","0",
"48 s","Investors","2016 ","10","10","0",
"48 s","Investors","2017 ","4","4","0",
"48 s","Investors","2018 ","15","15","0",
"48 s","Investors","2019 ","19","17","2",
"48 s","Trade and Business","2000 ","6","6","0",
"48 s","Trade and Business","2001 ","17","15","2",
"48 s","Trade and Business","2002 ","21","21","0",
"48 s","Trade and Business","2003 ","12","12","0",
"48 s","Trade and Business","2004 ","18","18","0",
"48 s","Trade and Business","2005 ","18","18","0",
"48 s","Trade and Business","2006 ","9","9","0",
"48 s","Trade and Business","2007 ","16","16","0",
"48 s","Trade and Business","2008 ","22","19","3",
"48 s","Trade and Business","2009 ","17","17","0",
"48 s","Trade and Business","2010 ","21","21","0",
"48 s","Trade and Business","2011 ","23","23","",
"48 s","Trade and Business","2012 ","34","33","1",
"48 s","Trade and Business","2013 ","33","29","4",
"48 s","Trade and Business","2014 ","48","46","2",
"48 s","Trade and Business","2015 ","27","26","1",
"48 s","Trade and Business","2016 ","33","31","2",
"48 s","Trade and Business","2017 ","19","19","0",
"48 s","Trade and Business","2018 ","9","9","0",
"48 s","Trade and Business","2019 ","18","16","2",
"48 s","Research","2000 ","8","7","1",
"48 s","Research","2001 ","11","9","2",
"48 s","Research","2002 ","7","7","0",
"48 s","Research","2003 ","6","6","0",
"48 s","Research","2004 ","8","7","1",
"48 s","Research","2005 ","9","8","1",
"48 s","Research","2006 ","5","4","1",
"48 s","Research","2007 ","8","6","2",
"48 s","Research","2008 ","7","5","2",
"48 s","Research","2009 ","2","2","0",
"48 s","Research","2010 ","2","2","0",
"48 s","Research","2011 ","3","3","",
"48 s","Research","2013 ","6","4","2",
"48 s","Research","2014 ","4","2","2",
"48 s","Research","2015 ","3","2","1",
"48 s","Research","2016 ","10","10","0",
"48 s","Research","2017 ","3","3","0",
"48 s","Research","2018 ","8","7","1",
"48 s","Research","2019 ","5","4","1",
"48 s","Art and Entertainment","2000 ","9","7","2",
"48 s","Art and Entertainment","2001 ","7","6","1",
"48 s","Art and Entertainment","2002 ","10","9","1",
"48 s","Art and Entertainment","2003 ","9","8","1",
"48 s","Art and Entertainment","2004 ","5","5","0",
"48 s","Art and Entertainment","2005 ","9","9","0",
"48 s","Art and Entertainment","2006 ","9","6","3",
"48 s","Art and Entertainment","2007 ","5","4","1",
"48 s","Art and Entertainment","2008 ","8","6","2",
"48 s","Art and Entertainment","2009 ","6","5","1",
"48 s","Art and Entertainment","2010 ","4","4","0",
"48 s","Art and Entertainment","2011 ","5","4","1",
"48 s","Art and Entertainment","2012 ","10","9","1",
"48 s","Art and Entertainment","2013 ","2","2","0",
"48 s","Art and Entertainment","2014 ","6","6","0",
"48 s","Art and Entertainment","2015 ","4","4","0",
"48 s","Art and Entertainment","2016 ","4","4","0",
"48 s","Art and Entertainment","2017 ","7","5","2",
"48 s","Art and Entertainment","2018 ","9","7","2",
"48 s","Art and Entertainment","2019 ","10","8","2",
"48 s","Unskilled Employment","2000 ","0","0","0",
"48 s","Unskilled Employment","2001 ","0","0","0",
"48 s","Unskilled Employment","2002 ","0","0","0",
"48 s","Unskilled Employment","2003 ","10","5","5",
"48 s","Unskilled Employment","2004 ","38","26","12",
"48 s","Unskilled Employment","2005 ","6","2","4",
"48 s","Unskilled Employment","2006 ","32","19","13",
"48 s","Unskilled Employment","2007 ","15","11","4",
"48 s","Unskilled Employment","2008 ","0","0","0",
"48 s","Unskilled Employment","2009 ","2","2","0",
"48 s","Unskilled Employment","2010 ","1","1","0",
"48 s","Unskilled Employment","2012 ","2","1","1",
"48 s","Unskilled Employment","2015 ","1","1","0",
"48 s","Unskilled Employment","2019 ","3","3","0",
"48 s","Visiting and Joining Family","2000 ","37","5","32",
"48 s","Visiting and Joining Family","2001 ","69","6","63",
"48 s","Visiting and Joining Family","2002 ","113","41","72",
"48 s","Visiting and Joining Family","2003 ","442","242","200",
"48 s","Visiting and Joining Family","2004 ","654","320","334",
"48 s","Visiting and Joining Family","2005 ","1739","858","881",
"48 s","Visiting and Joining Family","2006 ","2782","1446","1336",
"48 s","Visiting and Joining Family","2007 ","391","203","188",
"48 s","Visiting and Joining Family","2008 ","19","10","9",
"48 s","Visiting and Joining Family","2009 ","17","4","13",
"48 s","Visiting and Joining Family","2010 ","52","19","33",
"48 s","Visiting and Joining Family","2011 ","81","33","48",
"48 s","Visiting and Joining Family","2012 ","75","25","50",
"48 s","Visiting and Joining Family","2013 ","136","42","94",
"48 s","Visiting and Joining Family","2014 ","181","32","149",
"48 s","Visiting and Joining Family","2015 ","253","77","176",
"48 s","Visiting and Joining Family","2016 ","426","138","288",
"48 s","Visiting and Joining Family","2017 ","433","164","269",
"48 s","Visiting and Joining Family","2018 ","468","187","281",
"48 s","Visiting and Joining Family","2019 ","492","182","310",
"48 s","Overseas Koreans","2000 ","18","6","12",
"48 s","Overseas Koreans","2001 ","25","7","18",
"48 s","Overseas Koreans","2002 ","31","11","20",
"48 s","Overseas Koreans","2003 ","40","13","27",
"48 s","Overseas Koreans","2004 ","30","10","20",
"48 s","Overseas Koreans","2005 ","45","22","23",
"48 s","Overseas Koreans","2006 ","38","11","27",
"48 s","Overseas Koreans","2007 ","56","24","32",
"48 s","Overseas Koreans","2008 ","67","27","40",
"48 s","Overseas Koreans","2009 ","106","33","73",
"48 s","Overseas Koreans","2010 ","321","117","204",
"48 s","Overseas Koreans","2011 ","515","204","311",
"48 s","Overseas Koreans","2012 ","284","125","159",
"48 s","Overseas Koreans","2013 ","346","169","177",
"48 s","Overseas Koreans","2014 ","309","149","160",
"48 s","Overseas Koreans","2015 ","339","149","190",
"48 s","Overseas Koreans","2016 ","459","221","238",
"48 s","Overseas Koreans","2017 ","479","257","222",
"48 s","Overseas Koreans","2018 ","563","290","273",
"48 s","Overseas Koreans","2019 ","568","287","281",
"48 s","Permanent Residence","2000 ","0","0","0",
"48 s","Permanent Residence","2001 ","0","0","0",
"48 s","Permanent Residence","2002 ","0","0","0",
"48 s","Permanent Residence","2003 ","2","1","1",
"48 s","Permanent Residence","2004 ","6","3","3",
"48 s","Permanent Residence","2005 ","8","5","3",
"48 s","Permanent Residence","2006 ","5","4","1",
"48 s","Permanent Residence","2007 ","10","6","4",
"48 s","Permanent Residence","2008 ","3","2","1",
"48 s","Permanent Residence","2009 ","6","1","5",
"48 s","Permanent Residence","2010 ","14","6","8",
"48 s","Permanent Residence","2011 ","67","20","47",
"48 s","Permanent Residence","2012 ","95","43","52",
"48 s","Permanent Residence","2013 ","115","46","69",
"48 s","Permanent Residence","2014 ","114","39","75",
"48 s","Permanent Residence","2015 ","94","41","53",
"48 s","Permanent Residence","2016 ","105","38","67",
"48 s","Permanent Residence","2017 ","132","55","77",
"48 s","Permanent Residence","2018 ","140","57","83",
"48 s","Permanent Residence","2019 ","134","44","90",
"48 s","Marriage Immigration","2011 ","5","2","3",
"48 s","Marriage Immigration","2012 ","151","40","111",
"48 s","Marriage Immigration","2013 ","128","34","94",
"48 s","Marriage Immigration","2014 ","101","32","69",
"48 s","Marriage Immigration","2015 ","71","17","54",
"48 s","Marriage Immigration","2016 ","94","25","69",
"48 s","Marriage Immigration","2017 ","99","22","77",
"48 s","Marriage Immigration","2018 ","117","31","86",
"48 s","Marriage Immigration","2019 ","112","31","81",
"49 s","Total","2000 ","1440","774","666",
"49 s","Total","2001 ","1633","965","668",
"49 s","Total","2002 ","1710","1005","705",
"49 s","Total","2003 ","1920","1073","847",
"49 s","Total","2004 ","2331","1223","1108",
"49 s","Total","2005 ","3288","1666","1622",
"49 s","Total","2006 ","4189","2160","2029",
"49 s","Total","2007 ","4715","2400","2315",
"49 s","Total","2008 ","4038","2015","2023",
"49 s","Total","2009 ","3231","1568","1663",
"49 s","Total","2010 ","3752","1841","1911",
"49 s","Total","2011 ","3348","1576","1772",
"49 s","Total","2012 ","3439","1550","1889",
"49 s","Total","2013 ","5361","2577","2784",
"49 s","Total","2014 ","6289","3215","3074",
"49 s","Total","2015 ","4737","2338","2399",
"49 s","Total","2016 ","4388","2214","2174",
"49 s","Total","2017 ","5386","2838","2548",
"49 s","Total","2018 ","5893","3212","2681",
"49 s","Total","2019 ","4960","2443","2517",
"49 s","Sightseeing Pass","2000 ","197","120","77",
"49 s","Sightseeing Pass","2001 ","346","225","121",
"49 s","Sightseeing Pass","2002 ","328","205","123",
"49 s","Sightseeing Pass","2003 ","319","200","119",
"49 s","Sightseeing Pass","2004 ","310","175","135",
"49 s","Sightseeing Pass","2005 ","274","177","97",
"49 s","Sightseeing Pass","2006 ","182","102","80",
"49 s","Sightseeing Pass","2007 ","191","109","82",
"49 s","Sightseeing Pass","2008 ","180","106","74",
"49 s","Sightseeing Pass","2009 ","253","134","119",
"49 s","Sightseeing Pass","2010 ","238","125","113",
"49 s","Sightseeing Pass","2011 ","252","125","127",
"49 s","Sightseeing Pass","2012 ","228","117","111",
"49 s","Sightseeing Pass","2013 ","205","91","114",
"49 s","Sightseeing Pass","2014 ","212","123","89",
"49 s","Sightseeing Pass","2015 ","262","149","113",
"49 s","Sightseeing Pass","2016 ","262","140","122",
"49 s","Sightseeing Pass","2017 ","357","197","160",
"49 s","Sightseeing Pass","2018 ","572","357","215",
"49 s","Sightseeing Pass","2019 ","361","186","175",
"49 s","Short-term Business","2000 ","131","93","38",
"49 s","Short-term Business","2001 ","140","114","26",
"49 s","Short-term Business","2002 ","113","82","31",
"49 s","Short-term Business","2003 ","98","78","20",
"49 s","Short-term Business","2004 ","87","71","16",
"49 s","Short-term Business","2005 ","77","54","23",
"49 s","Short-term Business","2006 ","127","101","26",
"49 s","Short-term Business","2007 ","149","120","29",
"49 s","Short-term Business","2008 ","72","60","12",
"49 s","Short-term Business","2009 ","40","37","3",
"49 s","Short-term Business","2010 ","32","26","6",
"49 s","Short-term Business","2011 ","16","14","2",
"49 s","Short-term Visitors","2000 ","700","303","397",
"49 s","Short-term Visitors","2001 ","706","339","367",
"49 s","Short-term Visitors","2002 ","665","346","319",
"49 s","Short-term Visitors","2003 ","641","307","334",
"49 s","Short-term Visitors","2004 ","540","266","274",
"49 s","Short-term Visitors","2005 ","671","310","361",
"49 s","Short-term Visitors","2006 ","526","244","282",
"49 s","Short-term Visitors","2007 ","462","178","284",
"49 s","Short-term Visitors","2008 ","367","164","203",
"49 s","Short-term Visitors","2009 ","332","105","227",
"49 s","Short-term Visitors","2010 ","1151","552","599",
"49 s","Short-term Visitors","2011 ","1270","543","727",
"49 s","Short-term Visitors","2012 ","897","331","566",
"49 s","Short-term Visitors","2013 ","1319","548","771",
"49 s","Short-term Visitors","2014 ","1255","625","630",
"49 s","Short-term Visitors","2015 ","1094","557","537",
"49 s","Short-term Visitors","2016 ","1324","696","628",
"49 s","Short-term Visitors","2017 ","1340","774","566",
"49 s","Short-term Visitors","2018 ","1318","698","620",
"49 s","Short-term Visitors","2019 ","1165","601","564",
"49 s","Short-term Employment","2000 ","3","2","1",
"49 s","Short-term Employment","2001 ","2","2","0",
"49 s","Short-term Employment","2002 ","2","2","0",
"49 s","Short-term Employment","2003 ","6","6","0",
"49 s","Short-term Employment","2004 ","2","1","1",
"49 s","Short-term Employment","2005 ","3","1","2",
"49 s","Short-term Employment","2006 ","1","1","0",
"49 s","Short-term Employment","2007 ","4","4","0",
"49 s","Short-term Employment","2008 ","0","0","0",
"49 s","Short-term Employment","2009 ","1","1","0",
"49 s","Short-term Employment","2010 ","0","0","0",
"49 s","Short-term Employment","2013 ","1","1","0",
"49 s","Short-term Employment","2015 ","3","3","0",
"49 s","Short-term Employment","2016 ","4","4","0",
"49 s","Short-term Employment","2017 ","1","1","0",
"49 s","Short-term Employment","2019 ","1","1","0",
"49 s","Job Seeking","2000 ","0","0","0",
"49 s","Job Seeking","2001 ","0","0","0",
"49 s","Job Seeking","2002 ","0","0","0",
"49 s","Job Seeking","2003 ","0","0","0",
"49 s","Job Seeking","2004 ","0","0","0",
"49 s","Job Seeking","2005 ","0","0","0",
"49 s","Job Seeking","2006 ","0","0","0",
"49 s","Job Seeking","2007 ","0","0","0",
"49 s","Job Seeking","2008 ","0","0","0",
"49 s","Job Seeking","2009 ","0","0","0",
"49 s","Job Seeking","2010 ","0","0","0",
"49 s","Job Seeking","2018 ","1","1","0",
"49 s","study","2000 ","4","3","1",
"49 s","study","2001 ","3","2","1",
"49 s","study","2002 ","2","1","1",
"49 s","study","2003 ","2","0","2",
"49 s","study","2004 ","6","5","1",
"49 s","study","2005 ","1","0","1",
"49 s","study","2006 ","3","2","1",
"49 s","study","2007 ","2","2","0",
"49 s","study","2008 ","4","3","1",
"49 s","study","2009 ","3","1","2",
"49 s","study","2010 ","2","2","0",
"49 s","study","2011 ","6","4","2",
"49 s","study","2012 ","7","5","2",
"49 s","study","2013 ","6","3","3",
"49 s","study","2014 ","2","2","0",
"49 s","study","2015 ","1","1","0",
"49 s","study","2016 ","3","1","2",
"49 s","study","2017 ","5","4","1",
"49 s","study","2018 ","6","4","2",
"49 s","study","2019 ","4","4","0",
"49 s","General Trainees","2000 ","3","3","0",
"49 s","General Trainees","2001 ","2","1","1",
"49 s","General Trainees","2002 ","2","0","2",
"49 s","General Trainees","2003 ","1","0","1",
"49 s","General Trainees","2004 ","0","0","0",
"49 s","General Trainees","2005 ","4","3","1",
"49 s","General Trainees","2006 ","2","0","2",
"49 s","General Trainees","2007 ","5","4","1",
"49 s","General Trainees","2008 ","5","2","3",
"49 s","General Trainees","2009 ","1","0","1",
"49 s","General Trainees","2010 ","3","0","3",
"49 s","General Trainees","2011 ","25","16","9",
"49 s","General Trainees","2013 ","3","1","2",
"49 s","General Trainees","2014 ","1","0","1",
"49 s","General Trainees","2015 ","2","1","1",
"49 s","General Trainees","2016 ","6","4","2",
"49 s","General Trainees","2017 ","3","3","0",
"49 s","General Trainees","2018 ","4","2","2",
"49 s","General Trainees","2019 ","3","0","3",
"49 s","Religious Activities","2000 ","7","3","4",
"49 s","Religious Activities","2001 ","5","3","2",
"49 s","Religious Activities","2002 ","6","2","4",
"49 s","Religious Activities","2003 ","8","5","3",
"49 s","Religious Activities","2004 ","2","0","2",
"49 s","Religious Activities","2005 ","0","0","0",
"49 s","Religious Activities","2006 ","3","3","0",
"49 s","Religious Activities","2007 ","0","0","0",
"49 s","Religious Activities","2008 ","3","3","0",
"49 s","Religious Activities","2009 ","4","3","1",
"49 s","Religious Activities","2010 ","2","1","1",
"49 s","Religious Activities","2011 ","3","3","",
"49 s","Religious Activities","2012 ","4","1","3",
"49 s","Religious Activities","2013 ","3","2","1",
"49 s","Religious Activities","2014 ","2","2","0",
"49 s","Religious Activities","2015 ","6","4","2",
"49 s","Religious Activities","2016 ","3","2","1",
"49 s","Religious Activities","2017 ","6","4","2",
"49 s","Religious Activities","2018 ","2","2","0",
"49 s","Religious Activities","2019 ","2","1","1",
"49 s","Investors","2000 ","27","20","7",
"49 s","Investors","2001 ","29","25","4",
"49 s","Investors","2002 ","33","31","2",
"49 s","Investors","2003 ","14","13","1",
"49 s","Investors","2004 ","25","22","3",
"49 s","Investors","2005 ","22","17","5",
"49 s","Investors","2006 ","13","12","1",
"49 s","Investors","2007 ","19","17","2",
"49 s","Investors","2008 ","14","13","1",
"49 s","Investors","2009 ","15","13","2",
"49 s","Investors","2010 ","22","21","1",
"49 s","Investors","2011 ","15","13","2",
"49 s","Investors","2012 ","12","12","",
"49 s","Investors","2013 ","14","13","1",
"49 s","Investors","2014 ","10","9","1",
"49 s","Investors","2015 ","8","8","0",
"49 s","Investors","2016 ","29","27","2",
"49 s","Investors","2017 ","18","15","3",
"49 s","Investors","2018 ","11","11","0",
"49 s","Investors","2019 ","15","13","2",
"49 s","Trade and Business","2000 ","12","12","0",
"49 s","Trade and Business","2001 ","11","11","0",
"49 s","Trade and Business","2002 ","17","17","0",
"49 s","Trade and Business","2003 ","19","19","0",
"49 s","Trade and Business","2004 ","14","14","0",
"49 s","Trade and Business","2005 ","25","25","0",
"49 s","Trade and Business","2006 ","18","18","0",
"49 s","Trade and Business","2007 ","17","16","1",
"49 s","Trade and Business","2008 ","20","20","0",
"49 s","Trade and Business","2009 ","23","23","0",
"49 s","Trade and Business","2010 ","17","17","0",
"49 s","Trade and Business","2011 ","29","26","3",
"49 s","Trade and Business","2012 ","23","23","",
"49 s","Trade and Business","2013 ","44","43","1",
"49 s","Trade and Business","2014 ","27","26","1",
"49 s","Trade and Business","2015 ","35","35","0",
"49 s","Trade and Business","2016 ","22","21","1",
"49 s","Trade and Business","2017 ","18","18","0",
"49 s","Trade and Business","2018 ","22","21","1",
"49 s","Trade and Business","2019 ","11","11","0",
"49 s","Research","2000 ","9","6","3",
"49 s","Research","2001 ","7","7","0",
"49 s","Research","2002 ","6","5","1",
"49 s","Research","2003 ","11","9","2",
"49 s","Research","2004 ","6","4","2",
"49 s","Research","2005 ","13","12","1",
"49 s","Research","2006 ","9","7","2",
"49 s","Research","2007 ","3","3","0",
"49 s","Research","2008 ","6","5","1",
"49 s","Research","2009 ","3","3","0",
"49 s","Research","2010 ","2","2","0",
"49 s","Research","2011 ","5","4","1",
"49 s","Research","2012 ","3","3","",
"49 s","Research","2013 ","4","4","0",
"49 s","Research","2014 ","4","4","0",
"49 s","Research","2015 ","1","1","0",
"49 s","Research","2016 ","14","13","1",
"49 s","Research","2017 ","4","4","0",
"49 s","Research","2018 ","9","9","0",
"49 s","Research","2019 ","4","2","2",
"49 s","Art and Entertainment","2000 ","6","5","1",
"49 s","Art and Entertainment","2001 ","5","3","2",
"49 s","Art and Entertainment","2002 ","7","6","1",
"49 s","Art and Entertainment","2003 ","7","6","1",
"49 s","Art and Entertainment","2004 ","8","8","0",
"49 s","Art and Entertainment","2005 ","6","5","1",
"49 s","Art and Entertainment","2006 ","6","5","1",
"49 s","Art and Entertainment","2007 ","8","7","1",
"49 s","Art and Entertainment","2008 ","5","4","1",
"49 s","Art and Entertainment","2009 ","5","5","0",
"49 s","Art and Entertainment","2010 ","5","5","0",
"49 s","Art and Entertainment","2011 ","8","7","1",
"49 s","Art and Entertainment","2012 ","15","14","1",
"49 s","Art and Entertainment","2013 ","5","4","1",
"49 s","Art and Entertainment","2014 ","3","3","0",
"49 s","Art and Entertainment","2015 ","2","1","1",
"49 s","Art and Entertainment","2016 ","2","2","0",
"49 s","Art and Entertainment","2017 ","5","3","2",
"49 s","Art and Entertainment","2019 ","6","6","0",
"49 s","Unskilled Employment","2000 ","0","0","0",
"49 s","Unskilled Employment","2001 ","0","0","0",
"49 s","Unskilled Employment","2002 ","0","0","0",
"49 s","Unskilled Employment","2003 ","8","6","2",
"49 s","Unskilled Employment","2004 ","30","21","9",
"49 s","Unskilled Employment","2005 ","3","2","1",
"49 s","Unskilled Employment","2006 ","33","22","11",
"49 s","Unskilled Employment","2007 ","16","6","10",
"49 s","Unskilled Employment","2008 ","0","0","0",
"49 s","Unskilled Employment","2009 ","0","0","0",
"49 s","Unskilled Employment","2010 ","0","0","0",
"49 s","Unskilled Employment","2012 ","1","1","",
"49 s","Unskilled Employment","2013 ","1","0","1",
"49 s","Unskilled Employment","2019 ","1","1","0",
"49 s","Visiting and Joining Family","2000 ","35","1","34",
"49 s","Visiting and Joining Family","2001 ","46","3","43",
"49 s","Visiting and Joining Family","2002 ","117","49","68",
"49 s","Visiting and Joining Family","2003 ","382","231","151",
"49 s","Visiting and Joining Family","2004 ","694","379","315",
"49 s","Visiting and Joining Family","2005 ","1451","734","717",
"49 s","Visiting and Joining Family","2006 ","2662","1386","1276",
"49 s","Visiting and Joining Family","2007 ","432","212","220",
"49 s","Visiting and Joining Family","2008 ","18","10","8",
"49 s","Visiting and Joining Family","2009 ","25","11","14",
"49 s","Visiting and Joining Family","2010 ","39","14","25",
"49 s","Visiting and Joining Family","2011 ","35","15","20",
"49 s","Visiting and Joining Family","2012 ","107","26","81",
"49 s","Visiting and Joining Family","2013 ","156","45","111",
"49 s","Visiting and Joining Family","2014 ","176","40","136",
"49 s","Visiting and Joining Family","2015 ","280","95","185",
"49 s","Visiting and Joining Family","2016 ","447","181","266",
"49 s","Visiting and Joining Family","2017 ","439","172","267",
"49 s","Visiting and Joining Family","2018 ","470","201","269",
"49 s","Visiting and Joining Family","2019 ","580","249","331",
"49 s","Overseas Koreans","2000 ","18","7","11",
"49 s","Overseas Koreans","2001 ","21","10","11",
"49 s","Overseas Koreans","2002 ","44","14","30",
"49 s","Overseas Koreans","2003 ","27","13","14",
"49 s","Overseas Koreans","2004 ","39","14","25",
"49 s","Overseas Koreans","2005 ","63","24","39",
"49 s","Overseas Koreans","2006 ","49","17","32",
"49 s","Overseas Koreans","2007 ","56","20","36",
"49 s","Overseas Koreans","2008 ","73","28","45",
"49 s","Overseas Koreans","2009 ","84","34","50",
"49 s","Overseas Koreans","2010 ","309","121","188",
"49 s","Overseas Koreans","2011 ","366","152","214",
"49 s","Overseas Koreans","2012 ","354","155","199",
"49 s","Overseas Koreans","2013 ","411","207","204",
"49 s","Overseas Koreans","2014 ","335","154","181",
"49 s","Overseas Koreans","2015 ","354","182","172",
"49 s","Overseas Koreans","2016 ","427","216","211",
"49 s","Overseas Koreans","2017 ","509","259","250",
"49 s","Overseas Koreans","2018 ","539","276","263",
"49 s","Overseas Koreans","2019 ","525","247","278",
"49 s","Permanent Residence","2000 ","0","0","0",
"49 s","Permanent Residence","2001 ","0","0","0",
"49 s","Permanent Residence","2002 ","1","1","0",
"49 s","Permanent Residence","2003 ","7","3","4",
"49 s","Permanent Residence","2004 ","9","5","4",
"49 s","Permanent Residence","2005 ","7","5","2",
"49 s","Permanent Residence","2006 ","8","4","4",
"49 s","Permanent Residence","2007 ","12","7","5",
"49 s","Permanent Residence","2008 ","5","2","3",
"49 s","Permanent Residence","2009 ","4","3","1",
"49 s","Permanent Residence","2010 ","21","11","10",
"49 s","Permanent Residence","2011 ","48","15","33",
"49 s","Permanent Residence","2012 ","89","42","47",
"49 s","Permanent Residence","2013 ","101","47","54",
"49 s","Permanent Residence","2014 ","109","45","64",
"49 s","Permanent Residence","2015 ","120","40","80",
"49 s","Permanent Residence","2016 ","84","35","49",
"49 s","Permanent Residence","2017 ","92","35","57",
"49 s","Permanent Residence","2018 ","140","64","76",
"49 s","Permanent Residence","2019 ","127","47","80",
"49 s","Marriage Immigration","2011 ","2","1","1",
"49 s","Marriage Immigration","2012 ","140","42","98",
"49 s","Marriage Immigration","2013 ","121","40","81",
"49 s","Marriage Immigration","2014 ","102","27","75",
"49 s","Marriage Immigration","2015 ","100","27","73",
"49 s","Marriage Immigration","2016 ","75","20","55",
"49 s","Marriage Immigration","2017 ","84","22","62",
"49 s","Marriage Immigration","2018 ","114","43","71",
"49 s","Marriage Immigration","2019 ","103","29","74",
"50 s","Total","2000 ","2491","1138","1353",
"50 s","Total","2001 ","2681","1287","1394",
"50 s","Total","2002 ","1992","1129","863",
"50 s","Total","2003 ","1804","1012","792",
"50 s","Total","2004 ","2244","1111","1133",
"50 s","Total","2005 ","3374","1669","1705",
"50 s","Total","2006 ","3805","1948","1857",
"50 s","Total","2007 ","4683","2364","2319",
"50 s","Total","2008 ","4346","2113","2233",
"50 s","Total","2009 ","3037","1445","1592",
"50 s","Total","2010 ","5088","2461","2627",
"50 s","Total","2011 ","3675","1611","2064",
"50 s","Total","2012 ","2649","1111","1538",
"50 s","Total","2013 ","6138","2793","3345",
"50 s","Total","2014 ","7489","3708","3781",
"50 s","Total","2015 ","5319","2504","2815",
"50 s","Total","2016 ","5124","2560","2564",
"50 s","Total","2017 ","5077","2563","2514",
"50 s","Total","2018 ","5518","2801","2717",
"50 s","Total","2019 ","5115","2471","2644",
"50 s","Sightseeing Pass","2000 ","170","101","69",
"50 s","Sightseeing Pass","2001 ","315","219","96",
"50 s","Sightseeing Pass","2002 ","352","232","120",
"50 s","Sightseeing Pass","2003 ","315","210","105",
"50 s","Sightseeing Pass","2004 ","314","182","132",
"50 s","Sightseeing Pass","2005 ","298","188","110",
"50 s","Sightseeing Pass","2006 ","226","149","77",
"50 s","Sightseeing Pass","2007 ","145","85","60",
"50 s","Sightseeing Pass","2008 ","145","77","68",
"50 s","Sightseeing Pass","2009 ","211","111","100",
"50 s","Sightseeing Pass","2010 ","269","134","135",
"50 s","Sightseeing Pass","2011 ","253","89","164",
"50 s","Sightseeing Pass","2012 ","230","116","114",
"50 s","Sightseeing Pass","2013 ","191","89","102",
"50 s","Sightseeing Pass","2014 ","235","129","106",
"50 s","Sightseeing Pass","2015 ","257","126","131",
"50 s","Sightseeing Pass","2016 ","247","132","115",
"50 s","Sightseeing Pass","2017 ","290","156","134",
"50 s","Sightseeing Pass","2018 ","451","269","182",
"50 s","Sightseeing Pass","2019 ","328","154","174",
"50 s","Short-term Business","2000 ","107","76","31",
"50 s","Short-term Business","2001 ","96","63","33",
"50 s","Short-term Business","2002 ","85","61","24",
"50 s","Short-term Business","2003 ","80","62","18",
"50 s","Short-term Business","2004 ","88","66","22",
"50 s","Short-term Business","2005 ","103","80","23",
"50 s","Short-term Business","2006 ","102","86","16",
"50 s","Short-term Business","2007 ","112","86","26",
"50 s","Short-term Business","2008 ","79","67","12",
"50 s","Short-term Business","2009 ","24","21","3",
"50 s","Short-term Business","2010 ","24","21","3",
"50 s","Short-term Business","2011 ","26","21","5",
"50 s","Short-term Visitors","2000 ","1842","717","1125",
"50 s","Short-term Visitors","2001 ","1866","766","1100",
"50 s","Short-term Visitors","2002 ","887","426","461",
"50 s","Short-term Visitors","2003 ","546","265","281",
"50 s","Short-term Visitors","2004 ","554","263","291",
"50 s","Short-term Visitors","2005 ","726","328","398",
"50 s","Short-term Visitors","2006 ","512","228","284",
"50 s","Short-term Visitors","2007 ","430","176","254",
"50 s","Short-term Visitors","2008 ","394","139","255",
"50 s","Short-term Visitors","2009 ","277","83","194",
"50 s","Short-term Visitors","2010 ","1633","769","864",
"50 s","Short-term Visitors","2011 ","1306","581","725",
"50 s","Short-term Visitors","2012 ","750","270","480",
"50 s","Short-term Visitors","2013 ","1063","397","666",
"50 s","Short-term Visitors","2014 ","1146","546","600",
"50 s","Short-term Visitors","2015 ","1144","553","591",
"50 s","Short-term Visitors","2016 ","1617","879","738",
"50 s","Short-term Visitors","2017 ","1316","693","623",
"50 s","Short-term Visitors","2018 ","1327","703","624",
"50 s","Short-term Visitors","2019 ","1179","638","541",
"50 s","Short-term Employment","2000 ","3","3","0",
"50 s","Short-term Employment","2001 ","1","1","0",
"50 s","Short-term Employment","2002 ","1","1","0",
"50 s","Short-term Employment","2003 ","5","4","1",
"50 s","Short-term Employment","2004 ","2","1","1",
"50 s","Short-term Employment","2005 ","6","4","2",
"50 s","Short-term Employment","2006 ","2","2","0",
"50 s","Short-term Employment","2007 ","5","5","0",
"50 s","Short-term Employment","2008 ","0","0","0",
"50 s","Short-term Employment","2009 ","0","0","0",
"50 s","Short-term Employment","2010 ","1","1","0",
"50 s","Short-term Employment","2011 ","2","1","1",
"50 s","Short-term Employment","2016 ","5","5","0",
"50 s","Short-term Employment","2017 ","2","1","1",
"50 s","Short-term Employment","2019 ","1","1","0",
"50 s","Job Seeking","2000 ","0","0","0",
"50 s","Job Seeking","2001 ","0","0","0",
"50 s","Job Seeking","2002 ","0","0","0",
"50 s","Job Seeking","2003 ","0","0","0",
"50 s","Job Seeking","2004 ","0","0","0",
"50 s","Job Seeking","2005 ","0","0","0",
"50 s","Job Seeking","2006 ","0","0","0",
"50 s","Job Seeking","2007 ","0","0","0",
"50 s","Job Seeking","2008 ","0","0","0",
"50 s","Job Seeking","2009 ","0","0","0",
"50 s","Job Seeking","2010 ","0","0","0",
"50 s","Job Seeking","2016 ","1","1","0",
"50 s","study","2000 ","4","2","2",
"50 s","study","2001 ","0","0","0",
"50 s","study","2002 ","3","3","0",
"50 s","study","2003 ","2","1","1",
"50 s","study","2004 ","2","2","0",
"50 s","study","2005 ","4","3","1",
"50 s","study","2006 ","2","1","1",
"50 s","study","2007 ","3","3","0",
"50 s","study","2008 ","1","0","1",
"50 s","study","2009 ","4","4","0",
"50 s","study","2010 ","3","3","0",
"50 s","study","2011 ","3","1","2",
"50 s","study","2012 ","1","1","",
"50 s","study","2013 ","2","2","0",
"50 s","study","2014 ","4","2","2",
"50 s","study","2015 ","1","0","1",
"50 s","study","2016 ","4","2","2",
"50 s","study","2018 ","1","1","0",
"50 s","study","2019 ","1","1","0",
"50 s","General Trainees","2000 ","1","1","0",
"50 s","General Trainees","2001 ","3","2","1",
"50 s","General Trainees","2002 ","4","3","1",
"50 s","General Trainees","2003 ","0","0","0",
"50 s","General Trainees","2004 ","3","1","2",
"50 s","General Trainees","2005 ","5","4","1",
"50 s","General Trainees","2006 ","2","1","1",
"50 s","General Trainees","2007 ","2","2","0",
"50 s","General Trainees","2008 ","2","1","1",
"50 s","General Trainees","2009 ","4","2","2",
"50 s","General Trainees","2010 ","7","5","2",
"50 s","General Trainees","2011 ","31","19","12",
"50 s","General Trainees","2013 ","2","1","1",
"50 s","General Trainees","2014 ","4","4","0",
"50 s","General Trainees","2015 ","4","2","2",
"50 s","General Trainees","2016 ","10","10","0",
"50 s","General Trainees","2017 ","1","0","1",
"50 s","General Trainees","2018 ","4","2","2",
"50 s","General Trainees","2019 ","2","0","2",
"50 s","Religious Activities","2000 ","3","2","1",
"50 s","Religious Activities","2001 ","10","6","4",
"50 s","Religious Activities","2002 ","10","7","3",
"50 s","Religious Activities","2003 ","4","1","3",
"50 s","Religious Activities","2004 ","4","4","0",
"50 s","Religious Activities","2005 ","1","1","0",
"50 s","Religious Activities","2006 ","9","5","4",
"50 s","Religious Activities","2007 ","4","4","0",
"50 s","Religious Activities","2008 ","4","3","1",
"50 s","Religious Activities","2009 ","3","2","1",
"50 s","Religious Activities","2010 ","4","4","0",
"50 s","Religious Activities","2011 ","3","3","",
"50 s","Religious Activities","2012 ","2","","2",
"50 s","Religious Activities","2013 ","2","2","0",
"50 s","Religious Activities","2014 ","2","1","1",
"50 s","Religious Activities","2015 ","7","4","3",
"50 s","Religious Activities","2016 ","4","4","0",
"50 s","Religious Activities","2017 ","5","2","3",
"50 s","Religious Activities","2018 ","6","1","5",
"50 s","Religious Activities","2019 ","4","4","0",
"50 s","Investors","2000 ","20","15","5",
"50 s","Investors","2001 ","25","19","6",
"50 s","Investors","2002 ","33","33","0",
"50 s","Investors","2003 ","22","21","1",
"50 s","Investors","2004 ","25","21","4",
"50 s","Investors","2005 ","35","27","8",
"50 s","Investors","2006 ","8","6","2",
"50 s","Investors","2007 ","18","15","3",
"50 s","Investors","2008 ","16","14","2",
"50 s","Investors","2009 ","11","9","2",
"50 s","Investors","2010 ","17","16","1",
"50 s","Investors","2011 ","19","17","2",
"50 s","Investors","2012 ","17","17","",
"50 s","Investors","2013 ","25","24","1",
"50 s","Investors","2014 ","15","14","1",
"50 s","Investors","2015 ","14","14","0",
"50 s","Investors","2016 ","17","17","0",
"50 s","Investors","2017 ","11","10","1",
"50 s","Investors","2018 ","15","14","1",
"50 s","Investors","2019 ","12","12","0",
"50 s","Trade and Business","2000 ","10","9","1",
"50 s","Trade and Business","2001 ","18","18","0",
"50 s","Trade and Business","2002 ","21","21","0",
"50 s","Trade and Business","2003 ","22","21","1",
"50 s","Trade and Business","2004 ","17","17","0",
"50 s","Trade and Business","2005 ","19","19","0",
"50 s","Trade and Business","2006 ","21","21","0",
"50 s","Trade and Business","2007 ","20","20","0",
"50 s","Trade and Business","2008 ","23","22","1",
"50 s","Trade and Business","2009 ","22","22","0",
"50 s","Trade and Business","2010 ","26","25","1",
"50 s","Trade and Business","2011 ","20","19","1",
"50 s","Trade and Business","2012 ","22","21","1",
"50 s","Trade and Business","2013 ","30","29","1",
"50 s","Trade and Business","2014 ","34","34","0",
"50 s","Trade and Business","2015 ","38","37","1",
"50 s","Trade and Business","2016 ","26","25","1",
"50 s","Trade and Business","2017 ","15","15","0",
"50 s","Trade and Business","2018 ","19","19","0",
"50 s","Trade and Business","2019 ","11","10","1",
"50 s","Research","2000 ","4","3","1",
"50 s","Research","2001 ","5","4","1",
"50 s","Research","2002 ","9","9","0",
"50 s","Research","2003 ","7","6","1",
"50 s","Research","2004 ","5","3","2",
"50 s","Research","2005 ","7","6","1",
"50 s","Research","2006 ","8","6","2",
"50 s","Research","2007 ","6","5","1",
"50 s","Research","2008 ","3","3","0",
"50 s","Research","2009 ","2","2","0",
"50 s","Research","2010 ","4","4","0",
"50 s","Research","2011 ","7","6","1",
"50 s","Research","2012 ","3","3","",
"50 s","Research","2013 ","7","7","0",
"50 s","Research","2014 ","1","1","0",
"50 s","Research","2015 ","3","3","0",
"50 s","Research","2016 ","6","6","0",
"50 s","Research","2017 ","2","1","1",
"50 s","Research","2018 ","15","14","1",
"50 s","Research","2019 ","6","6","0",
"50 s","Art and Entertainment","2000 ","7","6","1",
"50 s","Art and Entertainment","2001 ","6","6","0",
"50 s","Art and Entertainment","2002 ","10","10","0",
"50 s","Art and Entertainment","2003 ","2","2","0",
"50 s","Art and Entertainment","2004 ","7","5","2",
"50 s","Art and Entertainment","2005 ","8","7","1",
"50 s","Art and Entertainment","2006 ","10","5","5",
"50 s","Art and Entertainment","2007 ","5","5","0",
"50 s","Art and Entertainment","2008 ","5","5","0",
"50 s","Art and Entertainment","2009 ","1","1","0",
"50 s","Art and Entertainment","2010 ","6","5","1",
"50 s","Art and Entertainment","2011 ","5","5","",
"50 s","Art and Entertainment","2012 ","3","3","",
"50 s","Art and Entertainment","2013 ","4","4","0",
"50 s","Art and Entertainment","2014 ","3","3","0",
"50 s","Art and Entertainment","2015 ","2","2","0",
"50 s","Art and Entertainment","2016 ","6","5","1",
"50 s","Art and Entertainment","2017 ","3","3","0",
"50 s","Art and Entertainment","2018 ","6","5","1",
"50 s","Art and Entertainment","2019 ","3","1","2",
"50 s","Unskilled Employment","2000 ","0","0","0",
"50 s","Unskilled Employment","2001 ","0","0","0",
"50 s","Unskilled Employment","2002 ","0","0","0",
"50 s","Unskilled Employment","2003 ","8","7","1",
"50 s","Unskilled Employment","2004 ","22","9","13",
"50 s","Unskilled Employment","2005 ","2","1","1",
"50 s","Unskilled Employment","2006 ","15","8","7",
"50 s","Unskilled Employment","2007 ","12","5","7",
"50 s","Unskilled Employment","2008 ","1","1","0",
"50 s","Unskilled Employment","2009 ","1","0","1",
"50 s","Unskilled Employment","2010 ","0","0","0",
"50 s","Unskilled Employment","2012 ","1","1","",
"50 s","Unskilled Employment","2013 ","1","0","1",
"50 s","Visiting and Joining Family","2000 ","34","5","29",
"50 s","Visiting and Joining Family","2001 ","50","8","42",
"50 s","Visiting and Joining Family","2002 ","167","71","96",
"50 s","Visiting and Joining Family","2003 ","401","221","180",
"50 s","Visiting and Joining Family","2004 ","619","307","312",
"50 s","Visiting and Joining Family","2005 ","1460","725","735",
"50 s","Visiting and Joining Family","2006 ","2337","1169","1168",
"50 s","Visiting and Joining Family","2007 ","405","193","212",
"50 s","Visiting and Joining Family","2008 ","32","18","14",
"50 s","Visiting and Joining Family","2009 ","17","9","8",
"50 s","Visiting and Joining Family","2010 ","45","16","29",
"50 s","Visiting and Joining Family","2011 ","50","24","26",
"50 s","Visiting and Joining Family","2012 ","73","13","60",
"50 s","Visiting and Joining Family","2013 ","178","46","132",
"50 s","Visiting and Joining Family","2014 ","240","67","173",
"50 s","Visiting and Joining Family","2015 ","351","122","229",
"50 s","Visiting and Joining Family","2016 ","503","215","288",
"50 s","Visiting and Joining Family","2017 ","494","215","279",
"50 s","Visiting and Joining Family","2018 ","466","190","276",
"50 s","Visiting and Joining Family","2019 ","557","227","330",
"50 s","Overseas Koreans","2000 ","20","9","11",
"50 s","Overseas Koreans","2001 ","19","8","11",
"50 s","Overseas Koreans","2002 ","40","14","26",
"50 s","Overseas Koreans","2003 ","41","13","28",
"50 s","Overseas Koreans","2004 ","40","14","26",
"50 s","Overseas Koreans","2005 ","62","20","42",
"50 s","Overseas Koreans","2006 ","51","20","31",
"50 s","Overseas Koreans","2007 ","58","23","35",
"50 s","Overseas Koreans","2008 ","80","25","55",
"50 s","Overseas Koreans","2009 ","82","27","55",
"50 s","Overseas Koreans","2010 ","461","186","275",
"50 s","Overseas Koreans","2011 ","455","170","285",
"50 s","Overseas Koreans","2012 ","296","112","184",
"50 s","Overseas Koreans","2013 ","512","197","315",
"50 s","Overseas Koreans","2014 ","443","183","260",
"50 s","Overseas Koreans","2015 ","475","201","274",
"50 s","Overseas Koreans","2016 ","524","244","280",
"50 s","Overseas Koreans","2017 ","422","187","235",
"50 s","Overseas Koreans","2018 ","521","233","288",
"50 s","Overseas Koreans","2019 ","581","253","328",
"50 s","Permanent Residence","2000 ","0","0","0",
"50 s","Permanent Residence","2001 ","0","0","0",
"50 s","Permanent Residence","2002 ","1","0","1",
"50 s","Permanent Residence","2003 ","8","5","3",
"50 s","Permanent Residence","2004 ","11","5","6",
"50 s","Permanent Residence","2005 ","6","3","3",
"50 s","Permanent Residence","2006 ","5","3","2",
"50 s","Permanent Residence","2007 ","8","6","2",
"50 s","Permanent Residence","2008 ","11","7","4",
"50 s","Permanent Residence","2009 ","10","5","5",
"50 s","Permanent Residence","2010 ","19","8","11",
"50 s","Permanent Residence","2011 ","30","17","13",
"50 s","Permanent Residence","2012 ","72","25","47",
"50 s","Permanent Residence","2013 ","147","47","100",
"50 s","Permanent Residence","2014 ","155","55","100",
"50 s","Permanent Residence","2015 ","128","41","87",
"50 s","Permanent Residence","2016 ","135","47","88",
"50 s","Permanent Residence","2017 ","109","43","66",
"50 s","Permanent Residence","2018 ","130","46","84",
"50 s","Permanent Residence","2019 ","155","53","102",
"50 s","Marriage Immigration","2011 ","8","1","7",
"50 s","Marriage Immigration","2012 ","97","27","70",
"50 s","Marriage Immigration","2013 ","159","40","119",
"50 s","Marriage Immigration","2014 ","112","37","75",
"50 s","Marriage Immigration","2015 ","93","23","70",
"50 s","Marriage Immigration","2016 ","82","25","57",
"50 s","Marriage Immigration","2017 ","70","4","66",
"50 s","Marriage Immigration","2018 ","92","22","70",
"50 s","Marriage Immigration","2019 ","112","29","83",
"51 s","Total","2000 ","2368","1186","1182",
"51 s","Total","2001 ","2905","1465","1440",
"51 s","Total","2002 ","1869","1036","833",
"51 s","Total","2003 ","1749","968","781",
"51 s","Total","2004 ","2023","1056","967",
"51 s","Total","2005 ","3095","1524","1571",
"51 s","Total","2006 ","3771","1889","1882",
"51 s","Total","2007 ","4302","2125","2177",
"51 s","Total","2008 ","4255","2037","2218",
"51 s","Total","2009 ","3146","1479","1667",
"51 s","Total","2010 ","4396","2126","2270",
"51 s","Total","2011 ","4292","1977","2315",
"51 s","Total","2012 ","2552","1080","1472",
"51 s","Total","2013 ","3962","1847","2115",
"51 s","Total","2014 ","7863","3747","4116",
"51 s","Total","2015 ","5504","2605","2899",
"51 s","Total","2016 ","5354","2724","2630",
"51 s","Total","2017 ","5702","2895","2807",
"51 s","Total","2018 ","5116","2667","2449",
"51 s","Total","2019 ","4421","2094","2327",
"51 s","Sightseeing Pass","2000 ","189","108","81",
"51 s","Sightseeing Pass","2001 ","299","209","90",
"51 s","Sightseeing Pass","2002 ","339","230","109",
"51 s","Sightseeing Pass","2003 ","299","198","101",
"51 s","Sightseeing Pass","2004 ","289","172","117",
"51 s","Sightseeing Pass","2005 ","253","150","103",
"51 s","Sightseeing Pass","2006 ","196","108","88",
"51 s","Sightseeing Pass","2007 ","164","81","83",
"51 s","Sightseeing Pass","2008 ","169","105","64",
"51 s","Sightseeing Pass","2009 ","204","109","95",
"51 s","Sightseeing Pass","2010 ","205","114","91",
"51 s","Sightseeing Pass","2011 ","251","123","128",
"51 s","Sightseeing Pass","2012 ","207","85","122",
"51 s","Sightseeing Pass","2013 ","189","95","94",
"51 s","Sightseeing Pass","2014 ","228","111","117",
"51 s","Sightseeing Pass","2015 ","257","142","115",
"51 s","Sightseeing Pass","2016 ","231","125","106",
"51 s","Sightseeing Pass","2017 ","283","155","128",
"51 s","Sightseeing Pass","2018 ","434","271","163",
"51 s","Sightseeing Pass","2019 ","274","130","144",
"51 s","Short-term Business","2000 ","76","52","24",
"51 s","Short-term Business","2001 ","106","74","32",
"51 s","Short-term Business","2002 ","86","62","24",
"51 s","Short-term Business","2003 ","74","56","18",
"51 s","Short-term Business","2004 ","64","48","16",
"51 s","Short-term Business","2005 ","73","57","16",
"51 s","Short-term Business","2006 ","77","58","19",
"51 s","Short-term Business","2007 ","100","86","14",
"51 s","Short-term Business","2008 ","46","35","11",
"51 s","Short-term Business","2009 ","33","24","9",
"51 s","Short-term Business","2010 ","24","22","2",
"51 s","Short-term Business","2011 ","28","26","2",
"51 s","Short-term Visitors","2000 ","1733","789","944",
"51 s","Short-term Visitors","2001 ","2068","921","1147",
"51 s","Short-term Visitors","2002 ","922","423","499",
"51 s","Short-term Visitors","2003 ","601","278","323",
"51 s","Short-term Visitors","2004 ","517","244","273",
"51 s","Short-term Visitors","2005 ","724","329","395",
"51 s","Short-term Visitors","2006 ","581","248","333",
"51 s","Short-term Visitors","2007 ","444","174","270",
"51 s","Short-term Visitors","2008 ","365","131","234",
"51 s","Short-term Visitors","2009 ","325","94","231",
"51 s","Short-term Visitors","2010 ","1359","623","736",
"51 s","Short-term Visitors","2011 ","1648","712","936",
"51 s","Short-term Visitors","2012 ","752","246","506",
"51 s","Short-term Visitors","2013 ","835","315","520",
"51 s","Short-term Visitors","2014 ","1246","571","675",
"51 s","Short-term Visitors","2015 ","1114","534","580",
"51 s","Short-term Visitors","2016 ","1692","959","733",
"51 s","Short-term Visitors","2017 ","1438","743","695",
"51 s","Short-term Visitors","2018 ","1222","662","560",
"51 s","Short-term Visitors","2019 ","1005","523","482",
"51 s","Short-term Employment","2000 ","3","2","1",
"51 s","Short-term Employment","2001 ","1","1","0",
"51 s","Short-term Employment","2002 ","3","2","1",
"51 s","Short-term Employment","2003 ","2","2","0",
"51 s","Short-term Employment","2004 ","1","1","0",
"51 s","Short-term Employment","2005 ","3","2","1",
"51 s","Short-term Employment","2006 ","2","1","1",
"51 s","Short-term Employment","2007 ","2","2","0",
"51 s","Short-term Employment","2008 ","0","0","0",
"51 s","Short-term Employment","2009 ","1","1","0",
"51 s","Short-term Employment","2010 ","1","1","0",
"51 s","Short-term Employment","2012 ","1","1","",
"51 s","Short-term Employment","2015 ","1","1","0",
"51 s","Short-term Employment","2016 ","1","1","0",
"51 s","Short-term Employment","2017 ","1","1","0",
"51 s","Short-term Employment","2018 ","2","2","0",
"51 s","Job Seeking","2000 ","0","0","0",
"51 s","Job Seeking","2001 ","0","0","0",
"51 s","Job Seeking","2002 ","0","0","0",
"51 s","Job Seeking","2003 ","0","0","0",
"51 s","Job Seeking","2004 ","0","0","0",
"51 s","Job Seeking","2005 ","0","0","0",
"51 s","Job Seeking","2006 ","0","0","0",
"51 s","Job Seeking","2007 ","0","0","0",
"51 s","Job Seeking","2008 ","0","0","0",
"51 s","Job Seeking","2009 ","0","0","0",
"51 s","Job Seeking","2010 ","0","0","0",
"51 s","Job Seeking","2017 ","1","1","0",
"51 s","study","2000 ","4","4","0",
"51 s","study","2001 ","4","2","2",
"51 s","study","2002 ","2","1","1",
"51 s","study","2003 ","3","1","2",
"51 s","study","2004 ","2","2","0",
"51 s","study","2005 ","0","0","0",
"51 s","study","2006 ","1","1","0",
"51 s","study","2007 ","3","2","1",
"51 s","study","2008 ","3","2","1",
"51 s","study","2009 ","0","0","0",
"51 s","study","2010 ","4","4","0",
"51 s","study","2011 ","6","6","",
"51 s","study","2012 ","4","2","2",
"51 s","study","2013 ","2","1","1",
"51 s","study","2014 ","1","1","0",
"51 s","study","2015 ","2","0","2",
"51 s","study","2016 ","4","2","2",
"51 s","study","2017 ","1","1","0",
"51 s","study","2018 ","3","2","1",
"51 s","study","2019 ","2","2","0",
"51 s","General Trainees","2000 ","1","0","1",
"51 s","General Trainees","2001 ","3","2","1",
"51 s","General Trainees","2002 ","1","1","0",
"51 s","General Trainees","2003 ","2","1","1",
"51 s","General Trainees","2004 ","2","1","1",
"51 s","General Trainees","2005 ","4","3","1",
"51 s","General Trainees","2006 ","0","0","0",
"51 s","General Trainees","2007 ","3","1","2",
"51 s","General Trainees","2008 ","3","1","2",
"51 s","General Trainees","2009 ","1","0","1",
"51 s","General Trainees","2010 ","4","4","0",
"51 s","General Trainees","2011 ","28","13","15",
"51 s","General Trainees","2013 ","2","1","1",
"51 s","General Trainees","2014 ","5","4","1",
"51 s","General Trainees","2015 ","4","2","2",
"51 s","General Trainees","2016 ","4","4","0",
"51 s","General Trainees","2017 ","2","1","1",
"51 s","General Trainees","2019 ","2","0","2",
"51 s","Religious Activities","2000 ","2","2","0",
"51 s","Religious Activities","2001 ","3","1","2",
"51 s","Religious Activities","2002 ","7","4","3",
"51 s","Religious Activities","2003 ","1","1","0",
"51 s","Religious Activities","2004 ","3","3","0",
"51 s","Religious Activities","2005 ","3","2","1",
"51 s","Religious Activities","2006 ","1","0","1",
"51 s","Religious Activities","2007 ","3","0","3",
"51 s","Religious Activities","2008 ","3","2","1",
"51 s","Religious Activities","2009 ","2","1","1",
"51 s","Religious Activities","2010 ","3","3","0",
"51 s","Religious Activities","2011 ","2","2","",
"51 s","Religious Activities","2012 ","4","3","1",
"51 s","Religious Activities","2013 ","5","1","4",
"51 s","Religious Activities","2014 ","4","2","2",
"51 s","Religious Activities","2015 ","5","4","1",
"51 s","Religious Activities","2016 ","3","2","1",
"51 s","Religious Activities","2017 ","2","2","0",
"51 s","Religious Activities","2018 ","4","2","2",
"51 s","Religious Activities","2019 ","5","4","1",
"51 s","Investors","2000 ","27","20","7",
"51 s","Investors","2001 ","28","24","4",
"51 s","Investors","2002 ","26","25","1",
"51 s","Investors","2003 ","24","21","3",
"51 s","Investors","2004 ","19","16","3",
"51 s","Investors","2005 ","20","14","6",
"51 s","Investors","2006 ","16","13","3",
"51 s","Investors","2007 ","14","11","3",
"51 s","Investors","2008 ","13","11","2",
"51 s","Investors","2009 ","9","9","0",
"51 s","Investors","2010 ","16","16","0",
"51 s","Investors","2011 ","6","5","1",
"51 s","Investors","2012 ","19","17","2",
"51 s","Investors","2013 ","17","17","0",
"51 s","Investors","2014 ","9","8","1",
"51 s","Investors","2015 ","8","8","0",
"51 s","Investors","2016 ","7","7","0",
"51 s","Investors","2017 ","9","9","0",
"51 s","Investors","2018 ","9","9","0",
"51 s","Investors","2019 ","13","11","2",
"51 s","Trade and Business","2000 ","7","7","0",
"51 s","Trade and Business","2001 ","17","17","0",
"51 s","Trade and Business","2002 ","8","8","0",
"51 s","Trade and Business","2003 ","19","17","2",
"51 s","Trade and Business","2004 ","18","17","1",
"51 s","Trade and Business","2005 ","16","16","0",
"51 s","Trade and Business","2006 ","21","21","0",
"51 s","Trade and Business","2007 ","16","16","0",
"51 s","Trade and Business","2008 ","20","20","0",
"51 s","Trade and Business","2009 ","15","15","0",
"51 s","Trade and Business","2010 ","19","18","1",
"51 s","Trade and Business","2011 ","33","32","1",
"51 s","Trade and Business","2012 ","31","30","1",
"51 s","Trade and Business","2013 ","35","34","1",
"51 s","Trade and Business","2014 ","37","33","4",
"51 s","Trade and Business","2015 ","32","30","2",
"51 s","Trade and Business","2016 ","29","29","0",
"51 s","Trade and Business","2017 ","13","11","2",
"51 s","Trade and Business","2018 ","11","11","0",
"51 s","Trade and Business","2019 ","20","18","2",
"51 s","Research","2000 ","3","3","0",
"51 s","Research","2001 ","7","7","0",
"51 s","Research","2002 ","8","7","1",
"51 s","Research","2003 ","5","5","0",
"51 s","Research","2004 ","10","10","0",
"51 s","Research","2005 ","6","6","0",
"51 s","Research","2006 ","7","6","1",
"51 s","Research","2007 ","4","4","0",
"51 s","Research","2008 ","3","3","0",
"51 s","Research","2009 ","0","0","0",
"51 s","Research","2010 ","3","3","0",
"51 s","Research","2011 ","2","2","",
"51 s","Research","2012 ","3","3","",
"51 s","Research","2013 ","9","9","0",
"51 s","Research","2014 ","4","4","0",
"51 s","Research","2015 ","3","3","0",
"51 s","Research","2016 ","15","14","1",
"51 s","Research","2017 ","2","2","0",
"51 s","Research","2018 ","12","11","1",
"51 s","Research","2019 ","3","3","0",
"51 s","Art and Entertainment","2000 ","4","4","0",
"51 s","Art and Entertainment","2001 ","5","4","1",
"51 s","Art and Entertainment","2002 ","5","3","2",
"51 s","Art and Entertainment","2003 ","2","2","0",
"51 s","Art and Entertainment","2004 ","8","8","0",
"51 s","Art and Entertainment","2005 ","7","4","3",
"51 s","Art and Entertainment","2006 ","10","9","1",
"51 s","Art and Entertainment","2007 ","5","4","1",
"51 s","Art and Entertainment","2008 ","2","2","0",
"51 s","Art and Entertainment","2009 ","2","2","0",
"51 s","Art and Entertainment","2010 ","5","4","1",
"51 s","Art and Entertainment","2011 ","6","6","",
"51 s","Art and Entertainment","2012 ","5","4","1",
"51 s","Art and Entertainment","2013 ","3","3","0",
"51 s","Art and Entertainment","2014 ","7","7","0",
"51 s","Art and Entertainment","2015 ","3","3","0",
"51 s","Art and Entertainment","2016 ","2","2","0",
"51 s","Art and Entertainment","2018 ","2","2","0",
"51 s","Art and Entertainment","2019 ","7","3","4",
"51 s","Unskilled Employment","2000 ","0","0","0",
"51 s","Unskilled Employment","2001 ","0","0","0",
"51 s","Unskilled Employment","2002 ","0","0","0",
"51 s","Unskilled Employment","2003 ","5","5","0",
"51 s","Unskilled Employment","2004 ","18","7","11",
"51 s","Unskilled Employment","2005 ","9","8","1",
"51 s","Unskilled Employment","2006 ","11","7","4",
"51 s","Unskilled Employment","2007 ","9","1","8",
"51 s","Unskilled Employment","2008 ","2","1","1",
"51 s","Unskilled Employment","2009 ","1","1","0",
"51 s","Unskilled Employment","2010 ","0","0","0",
"51 s","Unskilled Employment","2012 ","1","1","",
"51 s","Unskilled Employment","2013 ","2","2","0",
"51 s","Visiting and Joining Family","2000 ","26","3","23",
"51 s","Visiting and Joining Family","2001 ","49","4","45",
"51 s","Visiting and Joining Family","2002 ","169","76","93",
"51 s","Visiting and Joining Family","2003 ","362","196","166",
"51 s","Visiting and Joining Family","2004 ","556","305","251",
"51 s","Visiting and Joining Family","2005 ","1374","661","713",
"51 s","Visiting and Joining Family","2006 ","2396","1220","1176",
"51 s","Visiting and Joining Family","2007 ","376","172","204",
"51 s","Visiting and Joining Family","2008 ","19","7","12",
"51 s","Visiting and Joining Family","2009 ","27","10","17",
"51 s","Visiting and Joining Family","2010 ","46","21","25",
"51 s","Visiting and Joining Family","2011 ","52","20","32",
"51 s","Visiting and Joining Family","2012 ","69","23","46",
"51 s","Visiting and Joining Family","2013 ","128","28","100",
"51 s","Visiting and Joining Family","2014 ","286","72","214",
"51 s","Visiting and Joining Family","2015 ","398","140","258",
"51 s","Visiting and Joining Family","2016 ","545","220","325",
"51 s","Visiting and Joining Family","2017 ","527","228","299",
"51 s","Visiting and Joining Family","2018 ","480","215","265",
"51 s","Visiting and Joining Family","2019 ","530","209","321",
"51 s","Overseas Koreans","2000 ","17","6","11",
"51 s","Overseas Koreans","2001 ","23","11","12",
"51 s","Overseas Koreans","2002 ","33","20","13",
"51 s","Overseas Koreans","2003 ","24","11","13",
"51 s","Overseas Koreans","2004 ","41","14","27",
"51 s","Overseas Koreans","2005 ","56","23","33",
"51 s","Overseas Koreans","2006 ","40","12","28",
"51 s","Overseas Koreans","2007 ","59","26","33",
"51 s","Overseas Koreans","2008 ","75","25","50",
"51 s","Overseas Koreans","2009 ","100","38","62",
"51 s","Overseas Koreans","2010 ","485","207","278",
"51 s","Overseas Koreans","2011 ","556","241","315",
"51 s","Overseas Koreans","2012 ","304","126","178",
"51 s","Overseas Koreans","2013 ","343","148","195",
"51 s","Overseas Koreans","2014 ","517","199","318",
"51 s","Overseas Koreans","2015 ","464","209","255",
"51 s","Overseas Koreans","2016 ","540","239","301",
"51 s","Overseas Koreans","2017 ","526","238","288",
"51 s","Overseas Koreans","2018 ","440","193","247",
"51 s","Overseas Koreans","2019 ","499","220","279",
"51 s","Permanent Residence","2000 ","0","0","0",
"51 s","Permanent Residence","2001 ","0","0","0",
"51 s","Permanent Residence","2002 ","0","0","0",
"51 s","Permanent Residence","2003 ","2","2","0",
"51 s","Permanent Residence","2004 ","15","10","5",
"51 s","Permanent Residence","2005 ","10","5","5",
"51 s","Permanent Residence","2006 ","7","2","5",
"51 s","Permanent Residence","2007 ","9","7","2",
"51 s","Permanent Residence","2008 ","8","5","3",
"51 s","Permanent Residence","2009 ","6","3","3",
"51 s","Permanent Residence","2010 ","13","2","11",
"51 s","Permanent Residence","2011 ","49","21","28",
"51 s","Permanent Residence","2012 ","56","20","36",
"51 s","Permanent Residence","2013 ","84","32","52",
"51 s","Permanent Residence","2014 ","170","67","103",
"51 s","Permanent Residence","2015 ","139","45","94",
"51 s","Permanent Residence","2016 ","148","47","101",
"51 s","Permanent Residence","2017 ","115","30","85",
"51 s","Permanent Residence","2018 ","100","28","72",
"51 s","Permanent Residence","2019 ","109","34","75",
"51 s","Marriage Immigration","2011 ","6","1","5",
"51 s","Marriage Immigration","2012 ","85","24","61",
"51 s","Marriage Immigration","2013 ","90","22","68",
"51 s","Marriage Immigration","2014 ","113","27","86",
"51 s","Marriage Immigration","2015 ","94","18","76",
"51 s","Marriage Immigration","2016 ","91","26","65",
"51 s","Marriage Immigration","2017 ","85","17","68",
"51 s","Marriage Immigration","2018 ","63","20","43",
"51 s","Marriage Immigration","2019 ","90","30","60",
"52 s","Total","2000 ","1952","1013","939",
"52 s","Total","2001 ","2418","1347","1071",
"52 s","Total","2002 ","1815","1071","744",
"52 s","Total","2003 ","1461","832","629",
"52 s","Total","2004 ","1881","972","909",
"52 s","Total","2005 ","2803","1427","1376",
"52 s","Total","2006 ","3410","1725","1685",
"52 s","Total","2007 ","4416","2221","2195",
"52 s","Total","2008 ","3797","1855","1942",
"52 s","Total","2009 ","3171","1522","1649",
"52 s","Total","2010 ","4785","2310","2475",
"52 s","Total","2011 ","3796","1773","2023",
"52 s","Total","2012 ","3004","1267","1737",
"52 s","Total","2013 ","3706","1671","2035",
"52 s","Total","2014 ","5307","2524","2783",
"52 s","Total","2015 ","6494","3074","3420",
"52 s","Total","2016 ","5729","2747","2982",
"52 s","Total","2017 ","5895","2953","2942",
"52 s","Total","2018 ","5467","2725","2742",
"52 s","Total","2019 ","4158","1924","2234",
"52 s","Sightseeing Pass","2000 ","217","130","87",
"52 s","Sightseeing Pass","2001 ","294","205","89",
"52 s","Sightseeing Pass","2002 ","340","236","104",
"52 s","Sightseeing Pass","2003 ","289","189","100",
"52 s","Sightseeing Pass","2004 ","278","160","118",
"52 s","Sightseeing Pass","2005 ","223","131","92",
"52 s","Sightseeing Pass","2006 ","204","120","84",
"52 s","Sightseeing Pass","2007 ","175","99","76",
"52 s","Sightseeing Pass","2008 ","174","100","74",
"52 s","Sightseeing Pass","2009 ","207","94","113",
"52 s","Sightseeing Pass","2010 ","240","131","109",
"52 s","Sightseeing Pass","2011 ","226","100","126",
"52 s","Sightseeing Pass","2012 ","222","88","134",
"52 s","Sightseeing Pass","2013 ","200","80","120",
"52 s","Sightseeing Pass","2014 ","216","97","119",
"52 s","Sightseeing Pass","2015 ","266","147","119",
"52 s","Sightseeing Pass","2016 ","257","124","133",
"52 s","Sightseeing Pass","2017 ","257","141","116",
"52 s","Sightseeing Pass","2018 ","389","236","153",
"52 s","Sightseeing Pass","2019 ","238","120","118",
"52 s","Short-term Business","2000 ","68","52","16",
"52 s","Short-term Business","2001 ","62","49","13",
"52 s","Short-term Business","2002 ","67","51","16",
"52 s","Short-term Business","2003 ","56","43","13",
"52 s","Short-term Business","2004 ","63","49","14",
"52 s","Short-term Business","2005 ","54","46","8",
"52 s","Short-term Business","2006 ","60","47","13",
"52 s","Short-term Business","2007 ","79","64","15",
"52 s","Short-term Business","2008 ","34","28","6",
"52 s","Short-term Business","2009 ","12","10","2",
"52 s","Short-term Business","2010 ","22","16","6",
"52 s","Short-term Business","2011 ","17","14","3",
"52 s","Short-term Visitors","2000 ","1348","625","723",
"52 s","Short-term Visitors","2001 ","1694","856","838",
"52 s","Short-term Visitors","2002 ","891","464","427",
"52 s","Short-term Visitors","2003 ","474","229","245",
"52 s","Short-term Visitors","2004 ","491","237","254",
"52 s","Short-term Visitors","2005 ","663","309","354",
"52 s","Short-term Visitors","2006 ","549","250","299",
"52 s","Short-term Visitors","2007 ","478","200","278",
"52 s","Short-term Visitors","2008 ","335","136","199",
"52 s","Short-term Visitors","2009 ","334","107","227",
"52 s","Short-term Visitors","2010 ","1427","650","777",
"52 s","Short-term Visitors","2011 ","1332","597","735",
"52 s","Short-term Visitors","2012 ","845","298","547",
"52 s","Short-term Visitors","2013 ","822","322","500",
"52 s","Short-term Visitors","2014 ","964","455","509",
"52 s","Short-term Visitors","2015 ","1299","643","656",
"52 s","Short-term Visitors","2016 ","1761","919","842",
"52 s","Short-term Visitors","2017 ","1484","781","703",
"52 s","Short-term Visitors","2018 ","1287","646","641",
"52 s","Short-term Visitors","2019 ","993","488","505",
"52 s","Short-term Employment","2000 ","0","0","0",
"52 s","Short-term Employment","2001 ","1","1","0",
"52 s","Short-term Employment","2002 ","2","1","1",
"52 s","Short-term Employment","2003 ","6","5","1",
"52 s","Short-term Employment","2004 ","1","1","0",
"52 s","Short-term Employment","2005 ","6","4","2",
"52 s","Short-term Employment","2006 ","0","0","0",
"52 s","Short-term Employment","2007 ","3","3","0",
"52 s","Short-term Employment","2008 ","0","0","0",
"52 s","Short-term Employment","2009 ","1","1","0",
"52 s","Short-term Employment","2010 ","1","1","0",
"52 s","Short-term Employment","2014 ","1","1","0",
"52 s","Short-term Employment","2015 ","1","1","0",
"52 s","Short-term Employment","2016 ","3","1","2",
"52 s","Job Seeking","2000 ","0","0","0",
"52 s","Job Seeking","2001 ","0","0","0",
"52 s","Job Seeking","2002 ","0","0","0",
"52 s","Job Seeking","2003 ","0","0","0",
"52 s","Job Seeking","2004 ","0","0","0",
"52 s","Job Seeking","2005 ","0","0","0",
"52 s","Job Seeking","2006 ","0","0","0",
"52 s","Job Seeking","2007 ","0","0","0",
"52 s","Job Seeking","2008 ","0","0","0",
"52 s","Job Seeking","2009 ","0","0","0",
"52 s","Job Seeking","2010 ","0","0","0",
"52 s","study","2000 ","2","1","1",
"52 s","study","2001 ","0","0","0",
"52 s","study","2002 ","0","0","0",
"52 s","study","2003 ","1","1","0",
"52 s","study","2004 ","1","0","1",
"52 s","study","2005 ","3","1","2",
"52 s","study","2006 ","2","1","1",
"52 s","study","2007 ","3","3","0",
"52 s","study","2008 ","3","3","0",
"52 s","study","2009 ","1","1","0",
"52 s","study","2010 ","1","1","0",
"52 s","study","2011 ","3","3","",
"52 s","study","2012 ","2","2","",
"52 s","study","2013 ","2","0","2",
"52 s","study","2014 ","4","2","2",
"52 s","study","2015 ","1","0","1",
"52 s","study","2016 ","1","1","0",
"52 s","study","2017 ","2","1","1",
"52 s","study","2019 ","2","1","1",
"52 s","General Trainees","2000 ","0","0","0",
"52 s","General Trainees","2001 ","0","0","0",
"52 s","General Trainees","2002 ","0","0","0",
"52 s","General Trainees","2003 ","1","0","1",
"52 s","General Trainees","2004 ","3","1","2",
"52 s","General Trainees","2005 ","1","1","0",
"52 s","General Trainees","2006 ","0","0","0",
"52 s","General Trainees","2007 ","2","0","2",
"52 s","General Trainees","2008 ","3","3","0",
"52 s","General Trainees","2009 ","3","1","2",
"52 s","General Trainees","2010 ","4","2","2",
"52 s","General Trainees","2011 ","20","9","11",
"52 s","General Trainees","2013 ","1","0","1",
"52 s","General Trainees","2014 ","2","0","2",
"52 s","General Trainees","2015 ","2","2","0",
"52 s","General Trainees","2016 ","1","1","0",
"52 s","General Trainees","2017 ","1","0","1",
"52 s","General Trainees","2018 ","2","1","1",
"52 s","General Trainees","2019 ","2","0","2",
"52 s","Religious Activities","2000 ","0","0","0",
"52 s","Religious Activities","2001 ","8","3","5",
"52 s","Religious Activities","2002 ","2","2","0",
"52 s","Religious Activities","2003 ","1","1","0",
"52 s","Religious Activities","2004 ","3","1","2",
"52 s","Religious Activities","2005 ","2","2","0",
"52 s","Religious Activities","2006 ","6","4","2",
"52 s","Religious Activities","2007 ","0","0","0",
"52 s","Religious Activities","2008 ","3","1","2",
"52 s","Religious Activities","2009 ","5","4","1",
"52 s","Religious Activities","2010 ","4","2","2",
"52 s","Religious Activities","2011 ","4","3","1",
"52 s","Religious Activities","2012 ","3","3","",
"52 s","Religious Activities","2013 ","3","2","1",
"52 s","Religious Activities","2014 ","3","2","1",
"52 s","Religious Activities","2015 ","1","1","0",
"52 s","Religious Activities","2016 ","1","1","0",
"52 s","Religious Activities","2017 ","5","3","2",
"52 s","Religious Activities","2018 ","1","1","0",
"52 s","Investors","2000 ","16","12","4",
"52 s","Investors","2001 ","20","19","1",
"52 s","Investors","2002 ","28","27","1",
"52 s","Investors","2003 ","29","29","0",
"52 s","Investors","2004 ","15","15","0",
"52 s","Investors","2005 ","23","17","6",
"52 s","Investors","2006 ","11","10","1",
"52 s","Investors","2007 ","14","13","1",
"52 s","Investors","2008 ","16","13","3",
"52 s","Investors","2009 ","12","11","1",
"52 s","Investors","2010 ","10","7","3",
"52 s","Investors","2011 ","9","8","1",
"52 s","Investors","2012 ","14","14","",
"52 s","Investors","2013 ","13","11","2",
"52 s","Investors","2014 ","10","9","1",
"52 s","Investors","2015 ","9","9","0",
"52 s","Investors","2016 ","13","13","0",
"52 s","Investors","2017 ","11","10","1",
"52 s","Investors","2018 ","13","12","1",
"52 s","Investors","2019 ","15","14","1",
"52 s","Trade and Business","2000 ","6","6","0",
"52 s","Trade and Business","2001 ","14","14","0",
"52 s","Trade and Business","2002 ","17","16","1",
"52 s","Trade and Business","2003 ","19","18","1",
"52 s","Trade and Business","2004 ","15","14","1",
"52 s","Trade and Business","2005 ","19","19","0",
"52 s","Trade and Business","2006 ","9","9","0",
"52 s","Trade and Business","2007 ","15","15","0",
"52 s","Trade and Business","2008 ","12","12","0",
"52 s","Trade and Business","2009 ","15","15","0",
"52 s","Trade and Business","2010 ","25","25","0",
"52 s","Trade and Business","2011 ","27","25","2",
"52 s","Trade and Business","2012 ","30","30","",
"52 s","Trade and Business","2013 ","46","46","0",
"52 s","Trade and Business","2014 ","24","23","1",
"52 s","Trade and Business","2015 ","33","31","2",
"52 s","Trade and Business","2016 ","26","26","0",
"52 s","Trade and Business","2017 ","15","14","1",
"52 s","Trade and Business","2018 ","15","14","1",
"52 s","Trade and Business","2019 ","10","10","0",
"52 s","Research","2000 ","5","5","0",
"52 s","Research","2001 ","6","6","0",
"52 s","Research","2002 ","5","5","0",
"52 s","Research","2003 ","5","4","1",
"52 s","Research","2004 ","11","11","0",
"52 s","Research","2005 ","6","6","0",
"52 s","Research","2006 ","2","2","0",
"52 s","Research","2007 ","8","8","0",
"52 s","Research","2008 ","3","3","0",
"52 s","Research","2009 ","7","7","0",
"52 s","Research","2010 ","0","0","0",
"52 s","Research","2011 ","1","1","",
"52 s","Research","2012 ","4","4","",
"52 s","Research","2013 ","3","3","0",
"52 s","Research","2014 ","1","1","0",
"52 s","Research","2015 ","3","3","0",
"52 s","Research","2016 ","8","8","0",
"52 s","Research","2017 ","2","2","0",
"52 s","Research","2018 ","8","8","0",
"52 s","Research","2019 ","5","4","1",
"52 s","Art and Entertainment","2000 ","5","5","0",
"52 s","Art and Entertainment","2001 ","5","4","1",
"52 s","Art and Entertainment","2002 ","3","1","2",
"52 s","Art and Entertainment","2003 ","5","5","0",
"52 s","Art and Entertainment","2004 ","4","4","0",
"52 s","Art and Entertainment","2005 ","4","4","0",
"52 s","Art and Entertainment","2006 ","1","1","0",
"52 s","Art and Entertainment","2007 ","10","8","2",
"52 s","Art and Entertainment","2008 ","2","0","2",
"52 s","Art and Entertainment","2009 ","4","4","0",
"52 s","Art and Entertainment","2010 ","3","3","0",
"52 s","Art and Entertainment","2011 ","4","3","1",
"52 s","Art and Entertainment","2012 ","8","6","2",
"52 s","Art and Entertainment","2013 ","4","4","0",
"52 s","Art and Entertainment","2014 ","3","3","0",
"52 s","Art and Entertainment","2015 ","4","3","1",
"52 s","Art and Entertainment","2016 ","1","1","0",
"52 s","Art and Entertainment","2017 ","3","3","0",
"52 s","Art and Entertainment","2018 ","7","7","0",
"52 s","Art and Entertainment","2019 ","7","4","3",
"52 s","Unskilled Employment","2000 ","0","0","0",
"52 s","Unskilled Employment","2001 ","0","0","0",
"52 s","Unskilled Employment","2002 ","0","0","0",
"52 s","Unskilled Employment","2003 ","4","4","0",
"52 s","Unskilled Employment","2004 ","16","13","3",
"52 s","Unskilled Employment","2005 ","6","4","2",
"52 s","Unskilled Employment","2006 ","14","8","6",
"52 s","Unskilled Employment","2007 ","12","4","8",
"52 s","Unskilled Employment","2008 ","0","0","0",
"52 s","Unskilled Employment","2009 ","2","0","2",
"52 s","Unskilled Employment","2010 ","1","1","0",
"52 s","Visiting and Joining Family","2000 ","25","7","18",
"52 s","Visiting and Joining Family","2001 ","33","8","25",
"52 s","Visiting and Joining Family","2002 ","135","63","72",
"52 s","Visiting and Joining Family","2003 ","291","164","127",
"52 s","Visiting and Joining Family","2004 ","492","244","248",
"52 s","Visiting and Joining Family","2005 ","1259","634","625",
"52 s","Visiting and Joining Family","2006 ","2152","1098","1054",
"52 s","Visiting and Joining Family","2007 ","414","192","222",
"52 s","Visiting and Joining Family","2008 ","16","8","8",
"52 s","Visiting and Joining Family","2009 ","22","8","14",
"52 s","Visiting and Joining Family","2010 ","38","15","23",
"52 s","Visiting and Joining Family","2011 ","58","24","34",
"52 s","Visiting and Joining Family","2012 ","69","16","53",
"52 s","Visiting and Joining Family","2013 ","145","42","103",
"52 s","Visiting and Joining Family","2014 ","221","61","160",
"52 s","Visiting and Joining Family","2015 ","420","143","277",
"52 s","Visiting and Joining Family","2016 ","565","236","329",
"52 s","Visiting and Joining Family","2017 ","546","239","307",
"52 s","Visiting and Joining Family","2018 ","503","223","280",
"52 s","Visiting and Joining Family","2019 ","560","237","323",
"52 s","Overseas Koreans","2000 ","18","9","9",
"52 s","Overseas Koreans","2001 ","25","7","18",
"52 s","Overseas Koreans","2002 ","31","10","21",
"52 s","Overseas Koreans","2003 ","44","21","23",
"52 s","Overseas Koreans","2004 ","32","13","19",
"52 s","Overseas Koreans","2005 ","52","20","32",
"52 s","Overseas Koreans","2006 ","43","15","28",
"52 s","Overseas Koreans","2007 ","68","22","46",
"52 s","Overseas Koreans","2008 ","72","24","48",
"52 s","Overseas Koreans","2009 ","110","43","67",
"52 s","Overseas Koreans","2010 ","588","264","324",
"52 s","Overseas Koreans","2011 ","565","247","318",
"52 s","Overseas Koreans","2012 ","377","153","224",
"52 s","Overseas Koreans","2013 ","398","165","233",
"52 s","Overseas Koreans","2014 ","375","149","226",
"52 s","Overseas Koreans","2015 ","572","240","332",
"52 s","Overseas Koreans","2016 ","606","279","327",
"52 s","Overseas Koreans","2017 ","563","243","320",
"52 s","Overseas Koreans","2018 ","567","247","320",
"52 s","Overseas Koreans","2019 ","444","195","249",
"52 s","Permanent Residence","2000 ","0","0","0",
"52 s","Permanent Residence","2001 ","0","0","0",
"52 s","Permanent Residence","2002 ","1","1","0",
"52 s","Permanent Residence","2003 ","4","1","3",
"52 s","Permanent Residence","2004 ","14","11","3",
"52 s","Permanent Residence","2005 ","14","8","6",
"52 s","Permanent Residence","2006 ","8","4","4",
"52 s","Permanent Residence","2007 ","4","1","3",
"52 s","Permanent Residence","2008 ","7","4","3",
"52 s","Permanent Residence","2009 ","10","5","5",
"52 s","Permanent Residence","2010 ","19","10","9",
"52 s","Permanent Residence","2011 ","47","23","24",
"52 s","Permanent Residence","2012 ","82","32","50",
"52 s","Permanent Residence","2013 ","78","30","48",
"52 s","Permanent Residence","2014 ","91","35","56",
"52 s","Permanent Residence","2015 ","143","51","92",
"52 s","Permanent Residence","2016 ","166","54","112",
"52 s","Permanent Residence","2017 ","130","34","96",
"52 s","Permanent Residence","2018 ","140","43","97",
"52 s","Permanent Residence","2019 ","115","37","78",
"52 s","Marriage Immigration","2011 ","2","1","1",
"52 s","Marriage Immigration","2012 ","91","25","66",
"52 s","Marriage Immigration","2013 ","80","22","58",
"52 s","Marriage Immigration","2014 ","70","19","51",
"52 s","Marriage Immigration","2015 ","90","28","62",
"52 s","Marriage Immigration","2016 ","92","28","64",
"52 s","Marriage Immigration","2017 ","67","20","47",
"52 s","Marriage Immigration","2018 ","60","15","45",
"52 s","Marriage Immigration","2019 ","68","19","49",
"53 s","Total","2000 ","1796","947","849",
"53 s","Total","2001 ","2042","1148","894",
"53 s","Total","2002 ","1479","883","596",
"53 s","Total","2003 ","1437","821","616",
"53 s","Total","2004 ","1645","889","756",
"53 s","Total","2005 ","2660","1357","1303",
"53 s","Total","2006 ","3051","1504","1547",
"53 s","Total","2007 ","3852","1916","1936",
"53 s","Total","2008 ","3949","1925","2024",
"53 s","Total","2009 ","2875","1294","1581",
"53 s","Total","2010 ","4629","2257","2372",
"53 s","Total","2011 ","4267","1956","2311",
"53 s","Total","2012 ","2698","1188","1510",
"53 s","Total","2013 ","4583","2117","2466",
"53 s","Total","2014 ","5399","2569","2830",
"53 s","Total","2015 ","4470","2050","2420",
"53 s","Total","2016 ","6262","3016","3246",
"53 s","Total","2017 ","6083","2927","3156",
"53 s","Total","2018 ","5790","2902","2888",
"53 s","Total","2019 ","4571","2139","2432",
"53 s","Sightseeing Pass","2000 ","206","121","85",
"53 s","Sightseeing Pass","2001 ","305","206","99",
"53 s","Sightseeing Pass","2002 ","314","218","96",
"53 s","Sightseeing Pass","2003 ","303","191","112",
"53 s","Sightseeing Pass","2004 ","278","190","88",
"53 s","Sightseeing Pass","2005 ","247","150","97",
"53 s","Sightseeing Pass","2006 ","175","92","83",
"53 s","Sightseeing Pass","2007 ","144","85","59",
"53 s","Sightseeing Pass","2008 ","179","71","108",
"53 s","Sightseeing Pass","2009 ","207","105","102",
"53 s","Sightseeing Pass","2010 ","234","120","114",
"53 s","Sightseeing Pass","2011 ","240","101","139",
"53 s","Sightseeing Pass","2012 ","197","88","109",
"53 s","Sightseeing Pass","2013 ","180","81","99",
"53 s","Sightseeing Pass","2014 ","211","95","116",
"53 s","Sightseeing Pass","2015 ","220","101","119",
"53 s","Sightseeing Pass","2016 ","225","120","105",
"53 s","Sightseeing Pass","2017 ","229","120","109",
"53 s","Sightseeing Pass","2018 ","322","199","123",
"53 s","Sightseeing Pass","2019 ","223","128","95",
"53 s","Short-term Business","2000 ","47","30","17",
"53 s","Short-term Business","2001 ","73","56","17",
"53 s","Short-term Business","2002 ","58","45","13",
"53 s","Short-term Business","2003 ","51","35","16",
"53 s","Short-term Business","2004 ","41","31","10",
"53 s","Short-term Business","2005 ","41","32","9",
"53 s","Short-term Business","2006 ","51","41","10",
"53 s","Short-term Business","2007 ","58","45","13",
"53 s","Short-term Business","2008 ","34","29","5",
"53 s","Short-term Business","2009 ","17","15","2",
"53 s","Short-term Business","2010 ","20","18","2",
"53 s","Short-term Business","2011 ","19","16","3",
"53 s","Short-term Visitors","2000 ","1236","590","646",
"53 s","Short-term Visitors","2001 ","1337","677","660",
"53 s","Short-term Visitors","2002 ","640","334","306",
"53 s","Short-term Visitors","2003 ","470","227","243",
"53 s","Short-term Visitors","2004 ","403","196","207",
"53 s","Short-term Visitors","2005 ","686","327","359",
"53 s","Short-term Visitors","2006 ","483","198","285",
"53 s","Short-term Visitors","2007 ","409","174","235",
"53 s","Short-term Visitors","2008 ","362","142","220",
"53 s","Short-term Visitors","2009 ","320","83","237",
"53 s","Short-term Visitors","2010 ","1374","646","728",
"53 s","Short-term Visitors","2011 ","1464","652","812",
"53 s","Short-term Visitors","2012 ","747","269","478",
"53 s","Short-term Visitors","2013 ","978","384","594",
"53 s","Short-term Visitors","2014 ","883","389","494",
"53 s","Short-term Visitors","2015 ","1034","493","541",
"53 s","Short-term Visitors","2016 ","2091","1112","979",
"53 s","Short-term Visitors","2017 ","1540","767","773",
"53 s","Short-term Visitors","2018 ","1309","708","601",
"53 s","Short-term Visitors","2019 ","987","495","492",
"53 s","Short-term Employment","2000 ","1","1","0",
"53 s","Short-term Employment","2001 ","1","1","0",
"53 s","Short-term Employment","2002 ","4","3","1",
"53 s","Short-term Employment","2003 ","5","5","0",
"53 s","Short-term Employment","2004 ","0","0","0",
"53 s","Short-term Employment","2005 ","1","1","0",
"53 s","Short-term Employment","2006 ","7","7","0",
"53 s","Short-term Employment","2007 ","3","2","1",
"53 s","Short-term Employment","2008 ","1","1","0",
"53 s","Short-term Employment","2009 ","0","0","0",
"53 s","Short-term Employment","2010 ","1","1","0",
"53 s","Short-term Employment","2013 ","1","1","0",
"53 s","Short-term Employment","2014 ","2","2","0",
"53 s","Short-term Employment","2016 ","1","1","0",
"53 s","Short-term Employment","2017 ","1","1","0",
"53 s","Short-term Employment","2018 ","2","1","1",
"53 s","Short-term Employment","2019 ","1","0","1",
"53 s","Job Seeking","2000 ","0","0","0",
"53 s","Job Seeking","2001 ","0","0","0",
"53 s","Job Seeking","2002 ","0","0","0",
"53 s","Job Seeking","2003 ","0","0","0",
"53 s","Job Seeking","2004 ","0","0","0",
"53 s","Job Seeking","2005 ","0","0","0",
"53 s","Job Seeking","2006 ","0","0","0",
"53 s","Job Seeking","2007 ","0","0","0",
"53 s","Job Seeking","2008 ","0","0","0",
"53 s","Job Seeking","2009 ","0","0","0",
"53 s","Job Seeking","2010 ","0","0","0",
"53 s","study","2000 ","0","0","0",
"53 s","study","2001 ","1","0","1",
"53 s","study","2002 ","4","3","1",
"53 s","study","2003 ","0","0","0",
"53 s","study","2004 ","1","0","1",
"53 s","study","2005 ","3","1","2",
"53 s","study","2006 ","2","0","2",
"53 s","study","2007 ","1","1","0",
"53 s","study","2008 ","2","1","1",
"53 s","study","2009 ","1","0","1",
"53 s","study","2010 ","3","1","2",
"53 s","study","2011 ","1","","1",
"53 s","study","2012 ","2","","2",
"53 s","study","2013 ","1","0","1",
"53 s","study","2014 ","1","1","0",
"53 s","study","2015 ","1","0","1",
"53 s","study","2016 ","3","3","0",
"53 s","study","2017 ","1","1","0",
"53 s","study","2019 ","5","2","3",
"53 s","General Trainees","2000 ","1","1","0",
"53 s","General Trainees","2001 ","2","1","1",
"53 s","General Trainees","2002 ","0","0","0",
"53 s","General Trainees","2003 ","2","1","1",
"53 s","General Trainees","2004 ","2","1","1",
"53 s","General Trainees","2005 ","1","1","0",
"53 s","General Trainees","2006 ","1","0","1",
"53 s","General Trainees","2007 ","1","1","0",
"53 s","General Trainees","2008 ","2","1","1",
"53 s","General Trainees","2009 ","3","1","2",
"53 s","General Trainees","2010 ","7","5","2",
"53 s","General Trainees","2011 ","25","15","10",
"53 s","General Trainees","2013 ","1","0","1",
"53 s","General Trainees","2014 ","2","0","2",
"53 s","General Trainees","2015 ","5","3","2",
"53 s","General Trainees","2016 ","3","1","2",
"53 s","General Trainees","2017 ","1","1","0",
"53 s","General Trainees","2018 ","1","1","0",
"53 s","Religious Activities","2000 ","2","0","2",
"53 s","Religious Activities","2001 ","3","2","1",
"53 s","Religious Activities","2002 ","4","3","1",
"53 s","Religious Activities","2003 ","2","2","0",
"53 s","Religious Activities","2004 ","4","3","1",
"53 s","Religious Activities","2005 ","5","2","3",
"53 s","Religious Activities","2006 ","4","2","2",
"53 s","Religious Activities","2007 ","4","2","2",
"53 s","Religious Activities","2008 ","1","0","1",
"53 s","Religious Activities","2009 ","5","2","3",
"53 s","Religious Activities","2010 ","2","2","0",
"53 s","Religious Activities","2011 ","3","","3",
"53 s","Religious Activities","2012 ","3","2","1",
"53 s","Religious Activities","2014 ","3","1","2",
"53 s","Religious Activities","2015 ","1","1","0",
"53 s","Religious Activities","2016 ","3","2","1",
"53 s","Religious Activities","2017 ","4","2","2",
"53 s","Religious Activities","2018 ","2","2","0",
"53 s","Religious Activities","2019 ","2","1","1",
"53 s","Investors","2000 ","21","20","1",
"53 s","Investors","2001 ","21","19","2",
"53 s","Investors","2002 ","29","27","2",
"53 s","Investors","2003 ","22","22","0",
"53 s","Investors","2004 ","17","16","1",
"53 s","Investors","2005 ","24","20","4",
"53 s","Investors","2006 ","15","13","2",
"53 s","Investors","2007 ","6","5","1",
"53 s","Investors","2008 ","9","7","2",
"53 s","Investors","2009 ","12","11","1",
"53 s","Investors","2010 ","7","6","1",
"53 s","Investors","2011 ","11","11","",
"53 s","Investors","2012 ","14","14","",
"53 s","Investors","2013 ","18","16","2",
"53 s","Investors","2014 ","8","8","0",
"53 s","Investors","2015 ","5","5","0",
"53 s","Investors","2016 ","10","10","0",
"53 s","Investors","2017 ","8","7","1",
"53 s","Investors","2018 ","6","5","1",
"53 s","Investors","2019 ","14","13","1",
"53 s","Trade and Business","2000 ","7","7","0",
"53 s","Trade and Business","2001 ","12","12","0",
"53 s","Trade and Business","2002 ","15","15","0",
"53 s","Trade and Business","2003 ","24","24","0",
"53 s","Trade and Business","2004 ","23","22","1",
"53 s","Trade and Business","2005 ","24","24","0",
"53 s","Trade and Business","2006 ","12","12","0",
"53 s","Trade and Business","2007 ","13","13","0",
"53 s","Trade and Business","2008 ","16","16","0",
"53 s","Trade and Business","2009 ","28","28","0",
"53 s","Trade and Business","2010 ","19","19","0",
"53 s","Trade and Business","2011 ","28","28","",
"53 s","Trade and Business","2012 ","29","27","2",
"53 s","Trade and Business","2013 ","40","39","1",
"53 s","Trade and Business","2014 ","38","37","1",
"53 s","Trade and Business","2015 ","25","25","0",
"53 s","Trade and Business","2016 ","21","19","2",
"53 s","Trade and Business","2017 ","15","14","1",
"53 s","Trade and Business","2018 ","8","8","0",
"53 s","Trade and Business","2019 ","13","11","2",
"53 s","Research","2000 ","2","2","0",
"53 s","Research","2001 ","4","3","1",
"53 s","Research","2002 ","4","4","0",
"53 s","Research","2003 ","8","7","1",
"53 s","Research","2004 ","8","8","0",
"53 s","Research","2005 ","3","3","0",
"53 s","Research","2006 ","7","5","2",
"53 s","Research","2007 ","4","3","1",
"53 s","Research","2008 ","1","1","0",
"53 s","Research","2009 ","3","3","0",
"53 s","Research","2010 ","3","3","0",
"53 s","Research","2011 ","4","4","",
"53 s","Research","2013 ","10","10","0",
"53 s","Research","2014 ","6","5","1",
"53 s","Research","2015 ","3","3","0",
"53 s","Research","2016 ","11","11","0",
"53 s","Research","2017 ","1","1","0",
"53 s","Research","2018 ","5","4","1",
"53 s","Research","2019 ","3","3","0",
"53 s","Art and Entertainment","2000 ","4","2","2",
"53 s","Art and Entertainment","2001 ","2","1","1",
"53 s","Art and Entertainment","2002 ","6","5","1",
"53 s","Art and Entertainment","2003 ","6","6","0",
"53 s","Art and Entertainment","2004 ","3","3","0",
"53 s","Art and Entertainment","2005 ","4","4","0",
"53 s","Art and Entertainment","2006 ","2","2","0",
"53 s","Art and Entertainment","2007 ","8","6","2",
"53 s","Art and Entertainment","2008 ","4","4","0",
"53 s","Art and Entertainment","2009 ","4","3","1",
"53 s","Art and Entertainment","2010 ","2","2","0",
"53 s","Art and Entertainment","2011 ","4","4","",
"53 s","Art and Entertainment","2012 ","4","4","",
"53 s","Art and Entertainment","2013 ","1","1","0",
"53 s","Art and Entertainment","2014 ","4","4","0",
"53 s","Art and Entertainment","2015 ","6","5","1",
"53 s","Art and Entertainment","2016 ","5","5","0",
"53 s","Art and Entertainment","2017 ","2","2","0",
"53 s","Art and Entertainment","2018 ","2","2","0",
"53 s","Art and Entertainment","2019 ","2","2","0",
"53 s","Unskilled Employment","2000 ","0","0","0",
"53 s","Unskilled Employment","2001 ","0","0","0",
"53 s","Unskilled Employment","2002 ","0","0","0",
"53 s","Unskilled Employment","2003 ","2","2","0",
"53 s","Unskilled Employment","2004 ","24","10","14",
"53 s","Unskilled Employment","2005 ","3","0","3",
"53 s","Unskilled Employment","2006 ","14","11","3",
"53 s","Unskilled Employment","2007 ","13","5","8",
"53 s","Unskilled Employment","2008 ","0","0","0",
"53 s","Unskilled Employment","2009 ","0","0","0",
"53 s","Unskilled Employment","2010 ","0","0","0",
"53 s","Visiting and Joining Family","2000 ","29","7","22",
"53 s","Visiting and Joining Family","2001 ","37","5","32",
"53 s","Visiting and Joining Family","2002 ","121","51","70",
"53 s","Visiting and Joining Family","2003 ","234","134","100",
"53 s","Visiting and Joining Family","2004 ","448","230","218",
"53 s","Visiting and Joining Family","2005 ","1142","562","580",
"53 s","Visiting and Joining Family","2006 ","1922","960","962",
"53 s","Visiting and Joining Family","2007 ","355","175","180",
"53 s","Visiting and Joining Family","2008 ","16","9","7",
"53 s","Visiting and Joining Family","2009 ","31","11","20",
"53 s","Visiting and Joining Family","2010 ","40","18","22",
"53 s","Visiting and Joining Family","2011 ","45","16","29",
"53 s","Visiting and Joining Family","2012 ","76","21","55",
"53 s","Visiting and Joining Family","2013 ","156","43","113",
"53 s","Visiting and Joining Family","2014 ","213","64","149",
"53 s","Visiting and Joining Family","2015 ","309","101","208",
"53 s","Visiting and Joining Family","2016 ","638","248","390",
"53 s","Visiting and Joining Family","2017 ","577","263","314",
"53 s","Visiting and Joining Family","2018 ","564","266","298",
"53 s","Visiting and Joining Family","2019 ","591","262","329",
"53 s","Overseas Koreans","2000 ","18","9","9",
"53 s","Overseas Koreans","2001 ","28","14","14",
"53 s","Overseas Koreans","2002 ","40","15","25",
"53 s","Overseas Koreans","2003 ","33","18","15",
"53 s","Overseas Koreans","2004 ","29","12","17",
"53 s","Overseas Koreans","2005 ","47","18","29",
"53 s","Overseas Koreans","2006 ","45","13","32",
"53 s","Overseas Koreans","2007 ","60","13","47",
"53 s","Overseas Koreans","2008 ","85","31","54",
"53 s","Overseas Koreans","2009 ","106","44","62",
"53 s","Overseas Koreans","2010 ","579","263","316",
"53 s","Overseas Koreans","2011 ","631","276","355",
"53 s","Overseas Koreans","2012 ","357","139","218",
"53 s","Overseas Koreans","2013 ","442","191","251",
"53 s","Overseas Koreans","2014 ","373","145","228",
"53 s","Overseas Koreans","2015 ","392","184","208",
"53 s","Overseas Koreans","2016 ","689","307","382",
"53 s","Overseas Koreans","2017 ","591","256","335",
"53 s","Overseas Koreans","2018 ","591","244","347",
"53 s","Overseas Koreans","2019 ","569","236","333",
"53 s","Permanent Residence","2000 ","0","0","0",
"53 s","Permanent Residence","2001 ","0","0","0",
"53 s","Permanent Residence","2002 ","1","0","1",
"53 s","Permanent Residence","2003 ","5","3","2",
"53 s","Permanent Residence","2004 ","6","2","4",
"53 s","Permanent Residence","2005 ","5","2","3",
"53 s","Permanent Residence","2006 ","6","4","2",
"53 s","Permanent Residence","2007 ","7","0","7",
"53 s","Permanent Residence","2008 ","8","4","4",
"53 s","Permanent Residence","2009 ","14","8","6",
"53 s","Permanent Residence","2010 ","11","8","3",
"53 s","Permanent Residence","2011 ","38","21","17",
"53 s","Permanent Residence","2012 ","59","27","32",
"53 s","Permanent Residence","2013 ","106","40","66",
"53 s","Permanent Residence","2014 ","105","40","65",
"53 s","Permanent Residence","2015 ","116","38","78",
"53 s","Permanent Residence","2016 ","167","44","123",
"53 s","Permanent Residence","2017 ","164","53","111",
"53 s","Permanent Residence","2018 ","147","41","106",
"53 s","Permanent Residence","2019 ","131","37","94",
"53 s","Marriage Immigration","2011 ","2","2","",
"53 s","Marriage Immigration","2012 ","53","20","33",
"53 s","Marriage Immigration","2013 ","72","20","52",
"53 s","Marriage Immigration","2014 ","54","17","37",
"53 s","Marriage Immigration","2015 ","57","16","41",
"53 s","Marriage Immigration","2016 ","88","25","63",
"53 s","Marriage Immigration","2017 ","73","17","56",
"53 s","Marriage Immigration","2018 ","83","19","64",
"53 s","Marriage Immigration","2019 ","74","21","53",
"54 s","Total","2000 ","1524","806","718",
"54 s","Total","2001 ","1804","1032","772",
"54 s","Total","2002 ","1313","806","507",
"54 s","Total","2003 ","1320","776","544",
"54 s","Total","2004 ","1612","876","736",
"54 s","Total","2005 ","2571","1332","1239",
"54 s","Total","2006 ","3006","1504","1502",
"54 s","Total","2007 ","3431","1759","1672",
"54 s","Total","2008 ","3583","1803","1780",
"54 s","Total","2009 ","2945","1394","1551",
"54 s","Total","2010 ","4057","1933","2124",
"54 s","Total","2011 ","4075","1845","2230",
"54 s","Total","2012 ","2906","1208","1698",
"54 s","Total","2013 ","4100","1905","2195",
"54 s","Total","2014 ","6628","3148","3480",
"54 s","Total","2015 ","4414","1982","2432",
"54 s","Total","2016 ","4399","2050","2349",
"54 s","Total","2017 ","6635","3165","3470",
"54 s","Total","2018 ","6093","2946","3147",
"54 s","Total","2019 ","4820","2184","2636",
"54 s","Sightseeing Pass","2000 ","135","83","52",
"54 s","Sightseeing Pass","2001 ","302","201","101",
"54 s","Sightseeing Pass","2002 ","348","245","103",
"54 s","Sightseeing Pass","2003 ","298","205","93",
"54 s","Sightseeing Pass","2004 ","303","202","101",
"54 s","Sightseeing Pass","2005 ","224","142","82",
"54 s","Sightseeing Pass","2006 ","171","109","62",
"54 s","Sightseeing Pass","2007 ","153","81","72",
"54 s","Sightseeing Pass","2008 ","129","65","64",
"54 s","Sightseeing Pass","2009 ","167","79","88",
"54 s","Sightseeing Pass","2010 ","194","85","109",
"54 s","Sightseeing Pass","2011 ","227","109","118",
"54 s","Sightseeing Pass","2012 ","230","96","134",
"54 s","Sightseeing Pass","2013 ","195","91","104",
"54 s","Sightseeing Pass","2014 ","185","90","95",
"54 s","Sightseeing Pass","2015 ","214","91","123",
"54 s","Sightseeing Pass","2016 ","215","96","119",
"54 s","Sightseeing Pass","2017 ","220","118","102",
"54 s","Sightseeing Pass","2018 ","340","186","154",
"54 s","Sightseeing Pass","2019 ","221","120","101",
"54 s","Short-term Business","2000 ","37","33","4",
"54 s","Short-term Business","2001 ","30","20","10",
"54 s","Short-term Business","2002 ","41","30","11",
"54 s","Short-term Business","2003 ","33","32","1",
"54 s","Short-term Business","2004 ","45","33","12",
"54 s","Short-term Business","2005 ","38","30","8",
"54 s","Short-term Business","2006 ","34","24","10",
"54 s","Short-term Business","2007 ","40","34","6",
"54 s","Short-term Business","2008 ","18","13","5",
"54 s","Short-term Business","2009 ","19","17","2",
"54 s","Short-term Business","2010 ","17","14","3",
"54 s","Short-term Business","2011 ","16","14","2",
"54 s","Short-term Visitors","2000 ","1073","516","557",
"54 s","Short-term Visitors","2001 ","1109","566","543",
"54 s","Short-term Visitors","2002 ","493","244","249",
"54 s","Short-term Visitors","2003 ","437","205","232",
"54 s","Short-term Visitors","2004 ","453","229","224",
"54 s","Short-term Visitors","2005 ","650","313","337",
"54 s","Short-term Visitors","2006 ","485","218","267",
"54 s","Short-term Visitors","2007 ","425","192","233",
"54 s","Short-term Visitors","2008 ","339","133","206",
"54 s","Short-term Visitors","2009 ","322","113","209",
"54 s","Short-term Visitors","2010 ","1140","536","604",
"54 s","Short-term Visitors","2011 ","1239","548","691",
"54 s","Short-term Visitors","2012 ","775","263","512",
"54 s","Short-term Visitors","2013 ","869","333","536",
"54 s","Short-term Visitors","2014 ","1008","420","588",
"54 s","Short-term Visitors","2015 ","853","368","485",
"54 s","Short-term Visitors","2016 ","1455","722","733",
"54 s","Short-term Visitors","2017 ","1621","814","807",
"54 s","Short-term Visitors","2018 ","1295","642","653",
"54 s","Short-term Visitors","2019 ","956","493","463",
"54 s","Short-term Employment","2000 ","0","0","0",
"54 s","Short-term Employment","2001 ","2","2","0",
"54 s","Short-term Employment","2002 ","4","3","1",
"54 s","Short-term Employment","2003 ","1","0","1",
"54 s","Short-term Employment","2004 ","0","0","0",
"54 s","Short-term Employment","2005 ","3","3","0",
"54 s","Short-term Employment","2006 ","1","1","0",
"54 s","Short-term Employment","2007 ","1","1","0",
"54 s","Short-term Employment","2008 ","1","1","0",
"54 s","Short-term Employment","2009 ","0","0","0",
"54 s","Short-term Employment","2010 ","0","0","0",
"54 s","Short-term Employment","2014 ","1","1","0",
"54 s","Short-term Employment","2016 ","2","2","0",
"54 s","Short-term Employment","2019 ","1","1","0",
"54 s","Job Seeking","2000 ","0","0","0",
"54 s","Job Seeking","2001 ","0","0","0",
"54 s","Job Seeking","2002 ","0","0","0",
"54 s","Job Seeking","2003 ","0","0","0",
"54 s","Job Seeking","2004 ","0","0","0",
"54 s","Job Seeking","2005 ","0","0","0",
"54 s","Job Seeking","2006 ","0","0","0",
"54 s","Job Seeking","2007 ","0","0","0",
"54 s","Job Seeking","2008 ","0","0","0",
"54 s","Job Seeking","2009 ","0","0","0",
"54 s","Job Seeking","2010 ","0","0","0",
"54 s","Job Seeking","2018 ","1","1","0",
"54 s","study","2000 ","0","0","0",
"54 s","study","2001 ","1","1","0",
"54 s","study","2002 ","0","0","0",
"54 s","study","2003 ","1","1","0",
"54 s","study","2004 ","2","2","0",
"54 s","study","2005 ","0","0","0",
"54 s","study","2006 ","1","1","0",
"54 s","study","2007 ","3","3","0",
"54 s","study","2008 ","2","0","2",
"54 s","study","2009 ","1","1","0",
"54 s","study","2010 ","0","0","0",
"54 s","study","2012 ","1","1","",
"54 s","study","2013 ","1","0","1",
"54 s","study","2014 ","1","1","0",
"54 s","study","2015 ","2","1","1",
"54 s","study","2016 ","4","4","0",
"54 s","study","2017 ","1","1","0",
"54 s","study","2018 ","1","0","1",
"54 s","study","2019 ","2","1","1",
"54 s","General Trainees","2000 ","1","0","1",
"54 s","General Trainees","2001 ","1","1","0",
"54 s","General Trainees","2002 ","0","0","0",
"54 s","General Trainees","2003 ","0","0","0",
"54 s","General Trainees","2004 ","0","0","0",
"54 s","General Trainees","2005 ","0","0","0",
"54 s","General Trainees","2006 ","0","0","0",
"54 s","General Trainees","2007 ","0","0","0",
"54 s","General Trainees","2008 ","2","1","1",
"54 s","General Trainees","2009 ","1","1","0",
"54 s","General Trainees","2010 ","4","2","2",
"54 s","General Trainees","2011 ","26","13","13",
"54 s","General Trainees","2013 ","3","1","2",
"54 s","General Trainees","2014 ","2","1","1",
"54 s","General Trainees","2015 ","1","1","0",
"54 s","General Trainees","2016 ","1","1","0",
"54 s","General Trainees","2017 ","1","0","1",
"54 s","General Trainees","2018 ","3","2","1",
"54 s","General Trainees","2019 ","2","1","1",
"54 s","Religious Activities","2000 ","4","2","2",
"54 s","Religious Activities","2001 ","3","1","2",
"54 s","Religious Activities","2002 ","1","0","1",
"54 s","Religious Activities","2003 ","2","2","0",
"54 s","Religious Activities","2004 ","1","1","0",
"54 s","Religious Activities","2005 ","5","4","1",
"54 s","Religious Activities","2006 ","2","1","1",
"54 s","Religious Activities","2007 ","2","0","2",
"54 s","Religious Activities","2008 ","6","2","4",
"54 s","Religious Activities","2009 ","2","1","1",
"54 s","Religious Activities","2010 ","5","2","3",
"54 s","Religious Activities","2011 ","1","1","",
"54 s","Religious Activities","2012 ","1","","1",
"54 s","Religious Activities","2013 ","4","3","1",
"54 s","Religious Activities","2014 ","2","2","0",
"54 s","Religious Activities","2016 ","3","2","1",
"54 s","Religious Activities","2017 ","2","1","1",
"54 s","Religious Activities","2018 ","3","0","3",
"54 s","Religious Activities","2019 ","4","2","2",
"54 s","Investors","2000 ","12","12","0",
"54 s","Investors","2001 ","18","17","1",
"54 s","Investors","2002 ","43","42","1",
"54 s","Investors","2003 ","23","23","0",
"54 s","Investors","2004 ","24","22","2",
"54 s","Investors","2005 ","22","21","1",
"54 s","Investors","2006 ","10","10","0",
"54 s","Investors","2007 ","8","8","0",
"54 s","Investors","2008 ","5","4","1",
"54 s","Investors","2009 ","4","3","1",
"54 s","Investors","2010 ","9","8","1",
"54 s","Investors","2011 ","11","11","",
"54 s","Investors","2012 ","8","8","",
"54 s","Investors","2013 ","11","11","0",
"54 s","Investors","2014 ","6","6","0",
"54 s","Investors","2015 ","6","5","1",
"54 s","Investors","2016 ","16","16","0",
"54 s","Investors","2017 ","6","6","0",
"54 s","Investors","2018 ","13","13","0",
"54 s","Investors","2019 ","6","6","0",
"54 s","Trade and Business","2000 ","6","6","0",
"54 s","Trade and Business","2001 ","16","16","0",
"54 s","Trade and Business","2002 ","13","13","0",
"54 s","Trade and Business","2003 ","16","16","0",
"54 s","Trade and Business","2004 ","21","21","0",
"54 s","Trade and Business","2005 ","13","13","0",
"54 s","Trade and Business","2006 ","11","11","0",
"54 s","Trade and Business","2007 ","17","17","0",
"54 s","Trade and Business","2008 ","23","23","0",
"54 s","Trade and Business","2009 ","24","24","0",
"54 s","Trade and Business","2010 ","17","17","0",
"54 s","Trade and Business","2011 ","24","24","",
"54 s","Trade and Business","2012 ","24","24","",
"54 s","Trade and Business","2013 ","38","38","0",
"54 s","Trade and Business","2014 ","33","32","1",
"54 s","Trade and Business","2015 ","26","25","1",
"54 s","Trade and Business","2016 ","17","16","1",
"54 s","Trade and Business","2017 ","17","16","1",
"54 s","Trade and Business","2018 ","16","16","0",
"54 s","Trade and Business","2019 ","10","10","0",
"54 s","Research","2000 ","3","2","1",
"54 s","Research","2001 ","3","3","0",
"54 s","Research","2002 ","4","4","0",
"54 s","Research","2003 ","7","6","1",
"54 s","Research","2004 ","2","2","0",
"54 s","Research","2005 ","5","4","1",
"54 s","Research","2006 ","5","5","0",
"54 s","Research","2007 ","6","6","0",
"54 s","Research","2008 ","1","1","0",
"54 s","Research","2009 ","0","0","0",
"54 s","Research","2010 ","2","2","0",
"54 s","Research","2011 ","2","2","",
"54 s","Research","2012 ","3","3","",
"54 s","Research","2013 ","8","8","0",
"54 s","Research","2014 ","3","3","0",
"54 s","Research","2015 ","2","2","0",
"54 s","Research","2016 ","9","9","0",
"54 s","Research","2017 ","2","2","0",
"54 s","Research","2018 ","6","6","0",
"54 s","Research","2019 ","3","2","1",
"54 s","Art and Entertainment","2000 ","2","2","0",
"54 s","Art and Entertainment","2001 ","2","2","0",
"54 s","Art and Entertainment","2002 ","3","2","1",
"54 s","Art and Entertainment","2003 ","6","6","0",
"54 s","Art and Entertainment","2004 ","3","3","0",
"54 s","Art and Entertainment","2005 ","6","4","2",
"54 s","Art and Entertainment","2006 ","7","6","1",
"54 s","Art and Entertainment","2007 ","2","2","0",
"54 s","Art and Entertainment","2008 ","1","0","1",
"54 s","Art and Entertainment","2009 ","5","5","0",
"54 s","Art and Entertainment","2010 ","4","3","1",
"54 s","Art and Entertainment","2011 ","1","1","",
"54 s","Art and Entertainment","2012 ","5","4","1",
"54 s","Art and Entertainment","2013 ","2","1","1",
"54 s","Art and Entertainment","2014 ","3","3","0",
"54 s","Art and Entertainment","2015 ","5","5","0",
"54 s","Art and Entertainment","2016 ","3","3","0",
"54 s","Art and Entertainment","2017 ","5","5","0",
"54 s","Art and Entertainment","2019 ","3","3","0",
"54 s","Unskilled Employment","2000 ","0","0","0",
"54 s","Unskilled Employment","2001 ","0","0","0",
"54 s","Unskilled Employment","2002 ","0","0","0",
"54 s","Unskilled Employment","2003 ","2","2","0",
"54 s","Unskilled Employment","2004 ","28","10","18",
"54 s","Unskilled Employment","2005 ","7","3","4",
"54 s","Unskilled Employment","2006 ","9","8","1",
"54 s","Unskilled Employment","2007 ","14","2","12",
"54 s","Unskilled Employment","2008 ","0","0","0",
"54 s","Unskilled Employment","2009 ","0","0","0",
"54 s","Unskilled Employment","2010 ","0","0","0",
"54 s","Visiting and Joining Family","2000 ","31","7","24",
"54 s","Visiting and Joining Family","2001 ","31","11","20",
"54 s","Visiting and Joining Family","2002 ","69","31","38",
"54 s","Visiting and Joining Family","2003 ","179","100","79",
"54 s","Visiting and Joining Family","2004 ","368","186","182",
"54 s","Visiting and Joining Family","2005 ","1179","586","593",
"54 s","Visiting and Joining Family","2006 ","1923","941","982",
"54 s","Visiting and Joining Family","2007 ","379","186","193",
"54 s","Visiting and Joining Family","2008 ","19","6","13",
"54 s","Visiting and Joining Family","2009 ","14","5","9",
"54 s","Visiting and Joining Family","2010 ","45","20","25",
"54 s","Visiting and Joining Family","2011 ","59","21","38",
"54 s","Visiting and Joining Family","2012 ","69","17","52",
"54 s","Visiting and Joining Family","2013 ","139","47","92",
"54 s","Visiting and Joining Family","2014 ","270","79","191",
"54 s","Visiting and Joining Family","2015 ","350","123","227",
"54 s","Visiting and Joining Family","2016 ","457","190","267",
"54 s","Visiting and Joining Family","2017 ","598","250","348",
"54 s","Visiting and Joining Family","2018 ","558","257","301",
"54 s","Visiting and Joining Family","2019 ","588","251","337",
"54 s","Overseas Koreans","2000 ","16","6","10",
"54 s","Overseas Koreans","2001 ","33","14","19",
"54 s","Overseas Koreans","2002 ","35","17","18",
"54 s","Overseas Koreans","2003 ","36","10","26",
"54 s","Overseas Koreans","2004 ","43","16","27",
"54 s","Overseas Koreans","2005 ","33","11","22",
"54 s","Overseas Koreans","2006 ","48","15","33",
"54 s","Overseas Koreans","2007 ","66","23","43",
"54 s","Overseas Koreans","2008 ","79","23","56",
"54 s","Overseas Koreans","2009 ","113","50","63",
"54 s","Overseas Koreans","2010 ","516","239","277",
"54 s","Overseas Koreans","2011 ","692","307","385",
"54 s","Overseas Koreans","2012 ","405","163","242",
"54 s","Overseas Koreans","2013 ","468","193","275",
"54 s","Overseas Koreans","2014 ","501","215","286",
"54 s","Overseas Koreans","2015 ","457","179","278",
"54 s","Overseas Koreans","2016 ","546","228","318",
"54 s","Overseas Koreans","2017 ","720","275","445",
"54 s","Overseas Koreans","2018 ","723","274","449",
"54 s","Overseas Koreans","2019 ","652","253","399",
"54 s","Permanent Residence","2000 ","0","0","0",
"54 s","Permanent Residence","2001 ","0","0","0",
"54 s","Permanent Residence","2002 ","0","0","0",
"54 s","Permanent Residence","2003 ","9","5","4",
"54 s","Permanent Residence","2004 ","8","3","5",
"54 s","Permanent Residence","2005 ","4","3","1",
"54 s","Permanent Residence","2006 ","8","4","4",
"54 s","Permanent Residence","2007 ","7","6","1",
"54 s","Permanent Residence","2008 ","2","0","2",
"54 s","Permanent Residence","2009 ","8","5","3",
"54 s","Permanent Residence","2010 ","16","7","9",
"54 s","Permanent Residence","2011 ","33","11","22",
"54 s","Permanent Residence","2012 ","59","24","35",
"54 s","Permanent Residence","2013 ","91","33","58",
"54 s","Permanent Residence","2014 ","117","38","79",
"54 s","Permanent Residence","2015 ","104","34","70",
"54 s","Permanent Residence","2016 ","97","28","69",
"54 s","Permanent Residence","2017 ","148","37","111",
"54 s","Permanent Residence","2018 ","158","47","111",
"54 s","Permanent Residence","2019 ","171","41","130",
"54 s","Marriage Immigration","2012 ","76","27","49",
"54 s","Marriage Immigration","2013 ","68","24","44",
"54 s","Marriage Immigration","2014 ","66","20","46",
"54 s","Marriage Immigration","2015 ","57","21","36",
"54 s","Marriage Immigration","2016 ","44","9","35",
"54 s","Marriage Immigration","2017 ","86","14","72",
"54 s","Marriage Immigration","2018 ","70","15","55",
"54 s","Marriage Immigration","2019 ","83","21","62",
"55 s","Total","2000 ","1406","740","666",
"55 s","Total","2001 ","1443","843","600",
"55 s","Total","2002 ","1257","778","479",
"55 s","Total","2003 ","1043","633","410",
"55 s","Total","2004 ","1350","763","587",
"55 s","Total","2005 ","2623","1328","1295",
"55 s","Total","2006 ","2980","1519","1461",
"55 s","Total","2007 ","3176","1634","1542",
"55 s","Total","2008 ","3319","1667","1652",
"55 s","Total","2009 ","2754","1285","1469",
"55 s","Total","2010 ","4280","2080","2200",
"55 s","Total","2011 ","3472","1521","1951",
"55 s","Total","2012 ","3028","1262","1766",
"55 s","Total","2013 ","4594","2054","2540",
"55 s","Total","2014 ","5975","2866","3109",
"55 s","Total","2015 ","5607","2545","3062",
"55 s","Total","2016 ","4108","1881","2227",
"55 s","Total","2017 ","4774","2112","2662",
"55 s","Total","2018 ","6664","3149","3515",
"55 s","Total","2019 ","5368","2389","2979",
"55 s","Sightseeing Pass","2000 ","127","81","46",
"55 s","Sightseeing Pass","2001 ","220","151","69",
"55 s","Sightseeing Pass","2002 ","292","206","86",
"55 s","Sightseeing Pass","2003 ","271","191","80",
"55 s","Sightseeing Pass","2004 ","249","158","91",
"55 s","Sightseeing Pass","2005 ","218","142","76",
"55 s","Sightseeing Pass","2006 ","168","108","60",
"55 s","Sightseeing Pass","2007 ","141","76","65",
"55 s","Sightseeing Pass","2008 ","138","67","71",
"55 s","Sightseeing Pass","2009 ","184","87","97",
"55 s","Sightseeing Pass","2010 ","187","85","102",
"55 s","Sightseeing Pass","2011 ","258","108","150",
"55 s","Sightseeing Pass","2012 ","222","88","134",
"55 s","Sightseeing Pass","2013 ","193","95","98",
"55 s","Sightseeing Pass","2014 ","170","84","86",
"55 s","Sightseeing Pass","2015 ","212","105","107",
"55 s","Sightseeing Pass","2016 ","197","87","110",
"55 s","Sightseeing Pass","2017 ","191","100","91",
"55 s","Sightseeing Pass","2018 ","244","145","99",
"55 s","Sightseeing Pass","2019 ","218","121","97",
"55 s","Short-term Business","2000 ","25","20","5",
"55 s","Short-term Business","2001 ","35","23","12",
"55 s","Short-term Business","2002 ","35","32","3",
"55 s","Short-term Business","2003 ","39","30","9",
"55 s","Short-term Business","2004 ","39","33","6",
"55 s","Short-term Business","2005 ","41","33","8",
"55 s","Short-term Business","2006 ","32","27","5",
"55 s","Short-term Business","2007 ","28","26","2",
"55 s","Short-term Business","2008 ","26","17","9",
"55 s","Short-term Business","2009 ","16","11","5",
"55 s","Short-term Business","2010 ","15","13","2",
"55 s","Short-term Business","2011 ","11","11","",
"55 s","Short-term Visitors","2000 ","1002","481","521",
"55 s","Short-term Visitors","2001 ","889","487","402",
"55 s","Short-term Visitors","2002 ","455","235","220",
"55 s","Short-term Visitors","2003 ","315","153","162",
"55 s","Short-term Visitors","2004 ","350","185","165",
"55 s","Short-term Visitors","2005 ","541","265","276",
"55 s","Short-term Visitors","2006 ","420","186","234",
"55 s","Short-term Visitors","2007 ","392","159","233",
"55 s","Short-term Visitors","2008 ","298","105","193",
"55 s","Short-term Visitors","2009 ","293","88","205",
"55 s","Short-term Visitors","2010 ","1073","499","574",
"55 s","Short-term Visitors","2011 ","718","259","459",
"55 s","Short-term Visitors","2012 ","763","283","480",
"55 s","Short-term Visitors","2013 ","928","355","573",
"55 s","Short-term Visitors","2014 ","873","377","496",
"55 s","Short-term Visitors","2015 ","1053","476","577",
"55 s","Short-term Visitors","2016 ","1061","508","553",
"55 s","Short-term Visitors","2017 ","1015","486","529",
"55 s","Short-term Visitors","2018 ","1309","643","666",
"55 s","Short-term Visitors","2019 ","1108","503","605",
"55 s","Short-term Employment","2000 ","1","0","1",
"55 s","Short-term Employment","2001 ","0","0","0",
"55 s","Short-term Employment","2002 ","1","1","0",
"55 s","Short-term Employment","2003 ","3","3","0",
"55 s","Short-term Employment","2004 ","1","1","0",
"55 s","Short-term Employment","2005 ","1","1","0",
"55 s","Short-term Employment","2006 ","2","2","0",
"55 s","Short-term Employment","2007 ","2","2","0",
"55 s","Short-term Employment","2008 ","0","0","0",
"55 s","Short-term Employment","2009 ","0","0","0",
"55 s","Short-term Employment","2010 ","0","0","0",
"55 s","Short-term Employment","2012 ","1","1","",
"55 s","Short-term Employment","2013 ","1","1","0",
"55 s","Short-term Employment","2015 ","1","1","0",
"55 s","Short-term Employment","2016 ","3","3","0",
"55 s","Short-term Employment","2017 ","1","1","0",
"55 s","Job Seeking","2000 ","0","0","0",
"55 s","Job Seeking","2001 ","0","0","0",
"55 s","Job Seeking","2002 ","0","0","0",
"55 s","Job Seeking","2003 ","0","0","0",
"55 s","Job Seeking","2004 ","0","0","0",
"55 s","Job Seeking","2005 ","0","0","0",
"55 s","Job Seeking","2006 ","0","0","0",
"55 s","Job Seeking","2007 ","0","0","0",
"55 s","Job Seeking","2008 ","0","0","0",
"55 s","Job Seeking","2009 ","0","0","0",
"55 s","Job Seeking","2010 ","0","0","0",
"55 s","Job Seeking","2014 ","1","0","1",
"55 s","Job Seeking","2015 ","1","0","1",
"55 s","study","2000 ","0","0","0",
"55 s","study","2001 ","0","0","0",
"55 s","study","2002 ","1","1","0",
"55 s","study","2003 ","1","0","1",
"55 s","study","2004 ","1","1","0",
"55 s","study","2005 ","0","0","0",
"55 s","study","2006 ","1","1","0",
"55 s","study","2007 ","2","2","0",
"55 s","study","2008 ","2","1","1",
"55 s","study","2009 ","1","0","1",
"55 s","study","2010 ","1","1","0",
"55 s","study","2012 ","2","2","",
"55 s","study","2014 ","2","0","2",
"55 s","study","2015 ","2","1","1",
"55 s","study","2016 ","2","1","1",
"55 s","study","2018 ","1","1","0",
"55 s","General Trainees","2000 ","1","1","0",
"55 s","General Trainees","2001 ","1","1","0",
"55 s","General Trainees","2002 ","1","1","0",
"55 s","General Trainees","2003 ","0","0","0",
"55 s","General Trainees","2004 ","0","0","0",
"55 s","General Trainees","2005 ","1","0","1",
"55 s","General Trainees","2006 ","0","0","0",
"55 s","General Trainees","2007 ","1","1","0",
"55 s","General Trainees","2008 ","2","1","1",
"55 s","General Trainees","2009 ","0","0","0",
"55 s","General Trainees","2010 ","2","1","1",
"55 s","General Trainees","2011 ","7","5","2",
"55 s","General Trainees","2014 ","2","1","1",
"55 s","General Trainees","2015 ","1","0","1",
"55 s","General Trainees","2016 ","1","1","0",
"55 s","General Trainees","2017 ","2","1","1",
"55 s","General Trainees","2018 ","2","1","1",
"55 s","General Trainees","2019 ","1","0","1",
"55 s","Religious Activities","2000 ","6","1","5",
"55 s","Religious Activities","2001 ","1","1","0",
"55 s","Religious Activities","2002 ","3","2","1",
"55 s","Religious Activities","2003 ","3","2","1",
"55 s","Religious Activities","2004 ","1","1","0",
"55 s","Religious Activities","2005 ","1","1","0",
"55 s","Religious Activities","2006 ","4","3","1",
"55 s","Religious Activities","2007 ","2","1","1",
"55 s","Religious Activities","2008 ","7","3","4",
"55 s","Religious Activities","2009 ","2","0","2",
"55 s","Religious Activities","2010 ","0","0","0",
"55 s","Religious Activities","2013 ","5","3","2",
"55 s","Religious Activities","2015 ","1","0","1",
"55 s","Religious Activities","2016 ","8","3","5",
"55 s","Religious Activities","2017 ","2","1","1",
"55 s","Religious Activities","2018 ","4","3","1",
"55 s","Religious Activities","2019 ","1","0","1",
"55 s","Investors","2000 ","9","9","0",
"55 s","Investors","2001 ","16","14","2",
"55 s","Investors","2002 ","28","27","1",
"55 s","Investors","2003 ","12","12","0",
"55 s","Investors","2004 ","15","15","0",
"55 s","Investors","2005 ","21","19","2",
"55 s","Investors","2006 ","14","12","2",
"55 s","Investors","2007 ","11","10","1",
"55 s","Investors","2008 ","9","9","0",
"55 s","Investors","2009 ","8","7","1",
"55 s","Investors","2010 ","9","9","0",
"55 s","Investors","2011 ","2","2","",
"55 s","Investors","2012 ","8","8","",
"55 s","Investors","2013 ","13","12","1",
"55 s","Investors","2014 ","6","6","0",
"55 s","Investors","2015 ","8","7","1",
"55 s","Investors","2016 ","10","10","0",
"55 s","Investors","2017 ","5","5","0",
"55 s","Investors","2018 ","10","10","0",
"55 s","Investors","2019 ","11","11","0",
"55 s","Trade and Business","2000 ","4","4","0",
"55 s","Trade and Business","2001 ","12","12","0",
"55 s","Trade and Business","2002 ","15","15","0",
"55 s","Trade and Business","2003 ","12","11","1",
"55 s","Trade and Business","2004 ","14","14","0",
"55 s","Trade and Business","2005 ","17","17","0",
"55 s","Trade and Business","2006 ","14","14","0",
"55 s","Trade and Business","2007 ","11","11","0",
"55 s","Trade and Business","2008 ","24","23","1",
"55 s","Trade and Business","2009 ","17","17","0",
"55 s","Trade and Business","2010 ","17","16","1",
"55 s","Trade and Business","2011 ","23","21","2",
"55 s","Trade and Business","2012 ","23","23","",
"55 s","Trade and Business","2013 ","30","29","1",
"55 s","Trade and Business","2014 ","29","29","0",
"55 s","Trade and Business","2015 ","29","27","2",
"55 s","Trade and Business","2016 ","24","23","1",
"55 s","Trade and Business","2017 ","17","17","0",
"55 s","Trade and Business","2018 ","10","9","1",
"55 s","Trade and Business","2019 ","19","18","1",
"55 s","Research","2000 ","2","2","0",
"55 s","Research","2001 ","5","4","1",
"55 s","Research","2002 ","3","3","0",
"55 s","Research","2003 ","4","4","0",
"55 s","Research","2004 ","6","6","0",
"55 s","Research","2005 ","3","3","0",
"55 s","Research","2006 ","2","1","1",
"55 s","Research","2007 ","4","4","0",
"55 s","Research","2008 ","2","2","0",
"55 s","Research","2009 ","1","1","0",
"55 s","Research","2010 ","2","2","0",
"55 s","Research","2011 ","3","3","",
"55 s","Research","2012 ","4","4","",
"55 s","Research","2013 ","4","4","0",
"55 s","Research","2014 ","3","3","0",
"55 s","Research","2015 ","2","2","0",
"55 s","Research","2016 ","5","5","0",
"55 s","Research","2017 ","5","4","1",
"55 s","Research","2018 ","9","9","0",
"55 s","Research","2019 ","2","2","0",
"55 s","Art and Entertainment","2000 ","0","0","0",
"55 s","Art and Entertainment","2001 ","1","1","0",
"55 s","Art and Entertainment","2002 ","4","4","0",
"55 s","Art and Entertainment","2003 ","3","2","1",
"55 s","Art and Entertainment","2004 ","8","7","1",
"55 s","Art and Entertainment","2005 ","4","4","0",
"55 s","Art and Entertainment","2006 ","4","3","1",
"55 s","Art and Entertainment","2007 ","5","4","1",
"55 s","Art and Entertainment","2008 ","5","5","0",
"55 s","Art and Entertainment","2009 ","2","2","0",
"55 s","Art and Entertainment","2010 ","2","2","0",
"55 s","Art and Entertainment","2011 ","3","2","1",
"55 s","Art and Entertainment","2012 ","1","","1",
"55 s","Art and Entertainment","2013 ","3","3","0",
"55 s","Art and Entertainment","2014 ","5","5","0",
"55 s","Art and Entertainment","2015 ","3","3","0",
"55 s","Art and Entertainment","2017 ","7","5","2",
"55 s","Art and Entertainment","2018 ","5","4","1",
"55 s","Unskilled Employment","2000 ","0","0","0",
"55 s","Unskilled Employment","2001 ","0","0","0",
"55 s","Unskilled Employment","2002 ","0","0","0",
"55 s","Unskilled Employment","2003 ","4","3","1",
"55 s","Unskilled Employment","2004 ","23","13","10",
"55 s","Unskilled Employment","2005 ","3","2","1",
"55 s","Unskilled Employment","2006 ","11","4","7",
"55 s","Unskilled Employment","2007 ","7","3","4",
"55 s","Unskilled Employment","2008 ","0","0","0",
"55 s","Unskilled Employment","2009 ","0","0","0",
"55 s","Unskilled Employment","2010 ","0","0","0",
"55 s","Unskilled Employment","2015 ","1","0","1",
"55 s","Visiting and Joining Family","2000 ","56","26","30",
"55 s","Visiting and Joining Family","2001 ","32","9","23",
"55 s","Visiting and Joining Family","2002 ","93","55","38",
"55 s","Visiting and Joining Family","2003 ","132","83","49",
"55 s","Visiting and Joining Family","2004 ","300","163","137",
"55 s","Visiting and Joining Family","2005 ","1365","637","728",
"55 s","Visiting and Joining Family","2006 ","2012","1008","1004",
"55 s","Visiting and Joining Family","2007 ","289","143","146",
"55 s","Visiting and Joining Family","2008 ","17","5","12",
"55 s","Visiting and Joining Family","2009 ","23","5","18",
"55 s","Visiting and Joining Family","2010 ","42","19","23",
"55 s","Visiting and Joining Family","2011 ","56","22","34",
"55 s","Visiting and Joining Family","2012 ","87","25","62",
"55 s","Visiting and Joining Family","2013 ","142","45","97",
"55 s","Visiting and Joining Family","2014 ","250","73","177",
"55 s","Visiting and Joining Family","2015 ","388","119","269",
"55 s","Visiting and Joining Family","2016 ","433","186","247",
"55 s","Visiting and Joining Family","2017 ","511","214","297",
"55 s","Visiting and Joining Family","2018 ","567","259","308",
"55 s","Visiting and Joining Family","2019 ","600","268","332",
"55 s","Overseas Koreans","2000 ","15","5","10",
"55 s","Overseas Koreans","2001 ","29","8","21",
"55 s","Overseas Koreans","2002 ","38","14","24",
"55 s","Overseas Koreans","2003 ","42","17","25",
"55 s","Overseas Koreans","2004 ","35","12","23",
"55 s","Overseas Koreans","2005 ","46","22","24",
"55 s","Overseas Koreans","2006 ","36","13","23",
"55 s","Overseas Koreans","2007 ","52","15","37",
"55 s","Overseas Koreans","2008 ","91","36","55",
"55 s","Overseas Koreans","2009 ","105","47","58",
"55 s","Overseas Koreans","2010 ","528","230","298",
"55 s","Overseas Koreans","2011 ","600","267","333",
"55 s","Overseas Koreans","2012 ","508","203","305",
"55 s","Overseas Koreans","2013 ","591","215","376",
"55 s","Overseas Koreans","2014 ","552","212","340",
"55 s","Overseas Koreans","2015 ","662","236","426",
"55 s","Overseas Koreans","2016 ","603","225","378",
"55 s","Overseas Koreans","2017 ","668","202","466",
"55 s","Overseas Koreans","2018 ","958","335","623",
"55 s","Overseas Koreans","2019 ","814","287","527",
"55 s","Permanent Residence","2000 ","0","0","0",
"55 s","Permanent Residence","2001 ","0","0","0",
"55 s","Permanent Residence","2002 ","0","0","0",
"55 s","Permanent Residence","2003 ","4","2","2",
"55 s","Permanent Residence","2004 ","2","1","1",
"55 s","Permanent Residence","2005 ","4","4","0",
"55 s","Permanent Residence","2006 ","5","2","3",
"55 s","Permanent Residence","2007 ","5","2","3",
"55 s","Permanent Residence","2008 ","11","6","5",
"55 s","Permanent Residence","2009 ","8","1","7",
"55 s","Permanent Residence","2010 ","14","8","6",
"55 s","Permanent Residence","2011 ","35","11","24",
"55 s","Permanent Residence","2012 ","56","24","32",
"55 s","Permanent Residence","2013 ","94","33","61",
"55 s","Permanent Residence","2014 ","112","46","66",
"55 s","Permanent Residence","2015 ","138","47","91",
"55 s","Permanent Residence","2016 ","98","33","65",
"55 s","Permanent Residence","2017 ","119","44","75",
"55 s","Permanent Residence","2018 ","183","64","119",
"55 s","Permanent Residence","2019 ","188","49","139",
"55 s","Marriage Immigration","2011 ","1","1","",
"55 s","Marriage Immigration","2012 ","66","21","45",
"55 s","Marriage Immigration","2013 ","82","31","51",
"55 s","Marriage Immigration","2014 ","68","19","49",
"55 s","Marriage Immigration","2015 ","68","19","49",
"55 s","Marriage Immigration","2016 ","57","13","44",
"55 s","Marriage Immigration","2017 ","46","11","35",
"55 s","Marriage Immigration","2018 ","72","15","57",
"55 s","Marriage Immigration","2019 ","77","19","58",
"56 s","Total","2000 ","1481","808","673",
"56 s","Total","2001 ","1255","716","539",
"56 s","Total","2002 ","881","551","330",
"56 s","Total","2003 ","1042","604","438",
"56 s","Total","2004 ","1119","663","456",
"56 s","Total","2005 ","2274","1198","1076",
"56 s","Total","2006 ","2698","1443","1255",
"56 s","Total","2007 ","2672","1386","1286",
"56 s","Total","2008 ","2968","1532","1436",
"56 s","Total","2009 ","2515","1220","1295",
"56 s","Total","2010 ","3818","1900","1918",
"56 s","Total","2011 ","3642","1723","1919",
"56 s","Total","2012 ","2790","1215","1575",
"56 s","Total","2013 ","3976","1908","2068",
"56 s","Total","2014 ","5380","2465","2915",
"56 s","Total","2015 ","4874","2169","2705",
"56 s","Total","2016 ","4659","2111","2548",
"56 s","Total","2017 ","4269","1912","2357",
"56 s","Total","2018 ","4663","2182","2481",
"56 s","Total","2019 ","5545","2561","2984",
"56 s","Sightseeing Pass","2000 ","145","103","42",
"56 s","Sightseeing Pass","2001 ","215","141","74",
"56 s","Sightseeing Pass","2002 ","215","160","55",
"56 s","Sightseeing Pass","2003 ","275","183","92",
"56 s","Sightseeing Pass","2004 ","237","161","76",
"56 s","Sightseeing Pass","2005 ","202","133","69",
"56 s","Sightseeing Pass","2006 ","178","96","82",
"56 s","Sightseeing Pass","2007 ","124","76","48",
"56 s","Sightseeing Pass","2008 ","123","63","60",
"56 s","Sightseeing Pass","2009 ","141","74","67",
"56 s","Sightseeing Pass","2010 ","153","77","76",
"56 s","Sightseeing Pass","2011 ","211","98","113",
"56 s","Sightseeing Pass","2012 ","192","87","105",
"56 s","Sightseeing Pass","2013 ","184","93","91",
"56 s","Sightseeing Pass","2014 ","176","78","98",
"56 s","Sightseeing Pass","2015 ","198","96","102",
"56 s","Sightseeing Pass","2016 ","188","86","102",
"56 s","Sightseeing Pass","2017 ","176","88","88",
"56 s","Sightseeing Pass","2018 ","187","99","88",
"56 s","Sightseeing Pass","2019 ","207","115","92",
"56 s","Short-term Business","2000 ","27","21","6",
"56 s","Short-term Business","2001 ","26","21","5",
"56 s","Short-term Business","2002 ","20","14","6",
"56 s","Short-term Business","2003 ","21","19","2",
"56 s","Short-term Business","2004 ","31","29","2",
"56 s","Short-term Business","2005 ","27","21","6",
"56 s","Short-term Business","2006 ","31","26","5",
"56 s","Short-term Business","2007 ","28","23","5",
"56 s","Short-term Business","2008 ","16","12","4",
"56 s","Short-term Business","2009 ","15","14","1",
"56 s","Short-term Business","2010 ","12","12","0",
"56 s","Short-term Business","2011 ","7","7","",
"56 s","Short-term Visitors","2000 ","1011","491","520",
"56 s","Short-term Visitors","2001 ","732","364","368",
"56 s","Short-term Visitors","2002 ","324","155","169",
"56 s","Short-term Visitors","2003 ","325","149","176",
"56 s","Short-term Visitors","2004 ","280","142","138",
"56 s","Short-term Visitors","2005 ","499","249","250",
"56 s","Short-term Visitors","2006 ","419","198","221",
"56 s","Short-term Visitors","2007 ","311","130","181",
"56 s","Short-term Visitors","2008 ","285","119","166",
"56 s","Short-term Visitors","2009 ","250","67","183",
"56 s","Short-term Visitors","2010 ","894","431","463",
"56 s","Short-term Visitors","2011 ","684","280","404",
"56 s","Short-term Visitors","2012 ","704","254","450",
"56 s","Short-term Visitors","2013 ","907","400","507",
"56 s","Short-term Visitors","2014 ","844","356","488",
"56 s","Short-term Visitors","2015 ","917","390","527",
"56 s","Short-term Visitors","2016 ","1194","574","620",
"56 s","Short-term Visitors","2017 ","923","419","504",
"56 s","Short-term Visitors","2018 ","1135","536","599",
"56 s","Short-term Visitors","2019 ","1095","517","578",
"56 s","Short-term Employment","2000 ","0","0","0",
"56 s","Short-term Employment","2001 ","0","0","0",
"56 s","Short-term Employment","2002 ","0","0","0",
"56 s","Short-term Employment","2003 ","1","1","0",
"56 s","Short-term Employment","2004 ","2","1","1",
"56 s","Short-term Employment","2005 ","5","4","1",
"56 s","Short-term Employment","2006 ","3","2","1",
"56 s","Short-term Employment","2007 ","1","1","0",
"56 s","Short-term Employment","2008 ","0","0","0",
"56 s","Short-term Employment","2009 ","1","1","0",
"56 s","Short-term Employment","2010 ","1","1","0",
"56 s","Short-term Employment","2016 ","2","2","0",
"56 s","Short-term Employment","2018 ","1","0","1",
"56 s","Short-term Employment","2019 ","1","1","0",
"56 s","Job Seeking","2000 ","0","0","0",
"56 s","Job Seeking","2001 ","0","0","0",
"56 s","Job Seeking","2002 ","0","0","0",
"56 s","Job Seeking","2003 ","0","0","0",
"56 s","Job Seeking","2004 ","0","0","0",
"56 s","Job Seeking","2005 ","0","0","0",
"56 s","Job Seeking","2006 ","0","0","0",
"56 s","Job Seeking","2007 ","0","0","0",
"56 s","Job Seeking","2008 ","0","0","0",
"56 s","Job Seeking","2009 ","0","0","0",
"56 s","Job Seeking","2010 ","0","0","0",
"56 s","Job Seeking","2016 ","1","1","0",
"56 s","study","2000 ","2","2","0",
"56 s","study","2001 ","2","1","1",
"56 s","study","2002 ","2","1","1",
"56 s","study","2003 ","1","0","1",
"56 s","study","2004 ","0","0","0",
"56 s","study","2005 ","0","0","0",
"56 s","study","2006 ","0","0","0",
"56 s","study","2007 ","0","0","0",
"56 s","study","2008 ","2","2","0",
"56 s","study","2009 ","0","0","0",
"56 s","study","2010 ","0","0","0",
"56 s","study","2011 ","1","1","",
"56 s","study","2012 ","1","","1",
"56 s","study","2013 ","2","2","0",
"56 s","study","2015 ","2","0","2",
"56 s","study","2016 ","3","3","0",
"56 s","study","2018 ","1","1","0",
"56 s","study","2019 ","2","1","1",
"56 s","General Trainees","2000 ","0","0","0",
"56 s","General Trainees","2001 ","0","0","0",
"56 s","General Trainees","2002 ","0","0","0",
"56 s","General Trainees","2003 ","1","1","0",
"56 s","General Trainees","2004 ","1","1","0",
"56 s","General Trainees","2005 ","1","1","0",
"56 s","General Trainees","2006 ","0","0","0",
"56 s","General Trainees","2007 ","3","1","2",
"56 s","General Trainees","2008 ","2","1","1",
"56 s","General Trainees","2009 ","0","0","0",
"56 s","General Trainees","2010 ","3","3","0",
"56 s","General Trainees","2011 ","4","2","2",
"56 s","General Trainees","2014 ","1","1","0",
"56 s","General Trainees","2015 ","2","0","2",
"56 s","General Trainees","2019 ","2","1","1",
"56 s","Religious Activities","2000 ","1","0","1",
"56 s","Religious Activities","2001 ","8","4","4",
"56 s","Religious Activities","2002 ","1","1","0",
"56 s","Religious Activities","2003 ","6","4","2",
"56 s","Religious Activities","2004 ","1","1","0",
"56 s","Religious Activities","2005 ","3","0","3",
"56 s","Religious Activities","2006 ","2","0","2",
"56 s","Religious Activities","2007 ","7","4","3",
"56 s","Religious Activities","2008 ","3","2","1",
"56 s","Religious Activities","2009 ","3","3","0",
"56 s","Religious Activities","2010 ","4","1","3",
"56 s","Religious Activities","2011 ","2","","2",
"56 s","Religious Activities","2012 ","2","2","",
"56 s","Religious Activities","2013 ","1","0","1",
"56 s","Religious Activities","2014 ","3","2","1",
"56 s","Religious Activities","2015 ","2","0","2",
"56 s","Religious Activities","2016 ","3","0","3",
"56 s","Religious Activities","2017 ","2","1","1",
"56 s","Religious Activities","2018 ","1","0","1",
"56 s","Religious Activities","2019 ","2","2","0",
"56 s","Investors","2000 ","7","6","1",
"56 s","Investors","2001 ","18","16","2",
"56 s","Investors","2002 ","16","15","1",
"56 s","Investors","2003 ","15","14","1",
"56 s","Investors","2004 ","24","22","2",
"56 s","Investors","2005 ","36","36","0",
"56 s","Investors","2006 ","7","7","0",
"56 s","Investors","2007 ","10","9","1",
"56 s","Investors","2008 ","12","11","1",
"56 s","Investors","2009 ","10","10","0",
"56 s","Investors","2010 ","7","6","1",
"56 s","Investors","2011 ","4","4","",
"56 s","Investors","2012 ","9","9","",
"56 s","Investors","2013 ","10","8","2",
"56 s","Investors","2014 ","5","5","0",
"56 s","Investors","2015 ","9","9","0",
"56 s","Investors","2016 ","9","9","0",
"56 s","Investors","2017 ","4","4","0",
"56 s","Investors","2018 ","12","12","0",
"56 s","Investors","2019 ","6","6","0",
"56 s","Trade and Business","2000 ","5","5","0",
"56 s","Trade and Business","2001 ","14","14","0",
"56 s","Trade and Business","2002 ","17","17","0",
"56 s","Trade and Business","2003 ","8","7","1",
"56 s","Trade and Business","2004 ","23","23","0",
"56 s","Trade and Business","2005 ","21","20","1",
"56 s","Trade and Business","2006 ","16","16","0",
"56 s","Trade and Business","2007 ","10","10","0",
"56 s","Trade and Business","2008 ","8","8","0",
"56 s","Trade and Business","2009 ","16","16","0",
"56 s","Trade and Business","2010 ","23","23","0",
"56 s","Trade and Business","2011 ","32","30","2",
"56 s","Trade and Business","2012 ","39","39","",
"56 s","Trade and Business","2013 ","35","35","0",
"56 s","Trade and Business","2014 ","32","32","0",
"56 s","Trade and Business","2015 ","24","24","0",
"56 s","Trade and Business","2016 ","17","17","0",
"56 s","Trade and Business","2017 ","18","17","1",
"56 s","Trade and Business","2018 ","10","10","0",
"56 s","Trade and Business","2019 ","13","12","1",
"56 s","Research","2000 ","1","1","0",
"56 s","Research","2001 ","2","2","0",
"56 s","Research","2002 ","4","4","0",
"56 s","Research","2003 ","6","6","0",
"56 s","Research","2004 ","1","1","0",
"56 s","Research","2005 ","2","2","0",
"56 s","Research","2006 ","2","1","1",
"56 s","Research","2007 ","6","6","0",
"56 s","Research","2008 ","4","4","0",
"56 s","Research","2009 ","1","1","0",
"56 s","Research","2010 ","1","1","0",
"56 s","Research","2011 ","3","3","",
"56 s","Research","2012 ","1","1","",
"56 s","Research","2013 ","8","7","1",
"56 s","Research","2014 ","3","3","0",
"56 s","Research","2015 ","2","2","0",
"56 s","Research","2016 ","5","5","0",
"56 s","Research","2018 ","5","5","0",
"56 s","Research","2019 ","4","4","0",
"56 s","Art and Entertainment","2000 ","0","0","0",
"56 s","Art and Entertainment","2001 ","1","1","0",
"56 s","Art and Entertainment","2002 ","2","1","1",
"56 s","Art and Entertainment","2003 ","3","3","0",
"56 s","Art and Entertainment","2004 ","3","2","1",
"56 s","Art and Entertainment","2005 ","4","4","0",
"56 s","Art and Entertainment","2006 ","7","7","0",
"56 s","Art and Entertainment","2007 ","4","4","0",
"56 s","Art and Entertainment","2008 ","3","3","0",
"56 s","Art and Entertainment","2009 ","4","4","0",
"56 s","Art and Entertainment","2010 ","3","2","1",
"56 s","Art and Entertainment","2011 ","2","2","",
"56 s","Art and Entertainment","2012 ","7","6","1",
"56 s","Art and Entertainment","2013 ","4","3","1",
"56 s","Art and Entertainment","2014 ","3","3","0",
"56 s","Art and Entertainment","2015 ","1","1","0",
"56 s","Art and Entertainment","2018 ","2","2","0",
"56 s","Art and Entertainment","2019 ","1","1","0",
"56 s","Unskilled Employment","2000 ","0","0","0",
"56 s","Unskilled Employment","2001 ","0","0","0",
"56 s","Unskilled Employment","2002 ","0","0","0",
"56 s","Unskilled Employment","2003 ","1","0","1",
"56 s","Unskilled Employment","2004 ","13","6","7",
"56 s","Unskilled Employment","2005 ","3","1","2",
"56 s","Unskilled Employment","2006 ","6","5","1",
"56 s","Unskilled Employment","2007 ","10","4","6",
"56 s","Unskilled Employment","2008 ","0","0","0",
"56 s","Unskilled Employment","2009 ","1","1","0",
"56 s","Unskilled Employment","2010 ","0","0","0",
"56 s","Visiting and Joining Family","2000 ","90","56","34",
"56 s","Visiting and Joining Family","2001 ","64","29","35",
"56 s","Visiting and Joining Family","2002 ","49","29","20",
"56 s","Visiting and Joining Family","2003 ","107","57","50",
"56 s","Visiting and Joining Family","2004 ","229","134","95",
"56 s","Visiting and Joining Family","2005 ","1101","538","563",
"56 s","Visiting and Joining Family","2006 ","1745","925","820",
"56 s","Visiting and Joining Family","2007 ","290","155","135",
"56 s","Visiting and Joining Family","2008 ","15","6","9",
"56 s","Visiting and Joining Family","2009 ","31","10","21",
"56 s","Visiting and Joining Family","2010 ","40","14","26",
"56 s","Visiting and Joining Family","2011 ","61","26","35",
"56 s","Visiting and Joining Family","2012 ","65","15","50",
"56 s","Visiting and Joining Family","2013 ","156","41","115",
"56 s","Visiting and Joining Family","2014 ","257","87","170",
"56 s","Visiting and Joining Family","2015 ","315","120","195",
"56 s","Visiting and Joining Family","2016 ","477","178","299",
"56 s","Visiting and Joining Family","2017 ","474","179","295",
"56 s","Visiting and Joining Family","2018 ","456","209","247",
"56 s","Visiting and Joining Family","2019 ","590","281","309",
"56 s","Overseas Koreans","2000 ","10","5","5",
"56 s","Overseas Koreans","2001 ","23","13","10",
"56 s","Overseas Koreans","2002 ","28","11","17",
"56 s","Overseas Koreans","2003 ","46","19","27",
"56 s","Overseas Koreans","2004 ","45","17","28",
"56 s","Overseas Koreans","2005 ","49","14","35",
"56 s","Overseas Koreans","2006 ","41","16","25",
"56 s","Overseas Koreans","2007 ","38","12","26",
"56 s","Overseas Koreans","2008 ","85","33","52",
"56 s","Overseas Koreans","2009 ","113","43","70",
"56 s","Overseas Koreans","2010 ","512","251","261",
"56 s","Overseas Koreans","2011 ","609","315","294",
"56 s","Overseas Koreans","2012 ","425","179","246",
"56 s","Overseas Koreans","2013 ","573","247","326",
"56 s","Overseas Koreans","2014 ","512","196","316",
"56 s","Overseas Koreans","2015 ","536","207","329",
"56 s","Overseas Koreans","2016 ","645","260","385",
"56 s","Overseas Koreans","2017 ","568","222","346",
"56 s","Overseas Koreans","2018 ","623","243","380",
"56 s","Overseas Koreans","2019 ","766","311","455",
"56 s","Permanent Residence","2000 ","0","0","0",
"56 s","Permanent Residence","2001 ","0","0","0",
"56 s","Permanent Residence","2002 ","0","0","0",
"56 s","Permanent Residence","2003 ","4","3","1",
"56 s","Permanent Residence","2004 ","7","3","4",
"56 s","Permanent Residence","2005 ","12","2","10",
"56 s","Permanent Residence","2006 ","2","1","1",
"56 s","Permanent Residence","2007 ","4","2","2",
"56 s","Permanent Residence","2008 ","7","2","5",
"56 s","Permanent Residence","2009 ","8","6","2",
"56 s","Permanent Residence","2010 ","9","2","7",
"56 s","Permanent Residence","2011 ","41","12","29",
"56 s","Permanent Residence","2012 ","64","28","36",
"56 s","Permanent Residence","2013 ","80","32","48",
"56 s","Permanent Residence","2014 ","104","38","66",
"56 s","Permanent Residence","2015 ","117","44","73",
"56 s","Permanent Residence","2016 ","144","47","97",
"56 s","Permanent Residence","2017 ","122","35","87",
"56 s","Permanent Residence","2018 ","108","28","80",
"56 s","Permanent Residence","2019 ","213","68","145",
"56 s","Marriage Immigration","2012 ","64","28","36",
"56 s","Marriage Immigration","2013 ","65","34","31",
"56 s","Marriage Immigration","2014 ","48","21","27",
"56 s","Marriage Immigration","2015 ","54","22","32",
"56 s","Marriage Immigration","2016 ","61","21","40",
"56 s","Marriage Immigration","2017 ","46","10","36",
"56 s","Marriage Immigration","2018 ","44","12","32",
"56 s","Marriage Immigration","2019 ","60","14","46",
"57 s","Total","2000 ","1432","784","648",
"57 s","Total","2001 ","1213","726","487",
"57 s","Total","2002 ","865","538","327",
"57 s","Total","2003 ","811","495","316",
"57 s","Total","2004 ","1059","597","462",
"57 s","Total","2005 ","1697","939","758",
"57 s","Total","2006 ","2166","1146","1020",
"57 s","Total","2007 ","2869","1474","1395",
"57 s","Total","2008 ","2504","1293","1211",
"57 s","Total","2009 ","2278","1089","1189",
"57 s","Total","2010 ","3177","1536","1641",
"57 s","Total","2011 ","3186","1541","1645",
"57 s","Total","2012 ","2883","1253","1630",
"57 s","Total","2013 ","3211","1499","1712",
"57 s","Total","2014 ","5112","2452","2660",
"57 s","Total","2015 ","4992","2211","2781",
"57 s","Total","2016 ","4223","1927","2296",
"57 s","Total","2017 ","4937","2267","2670",
"57 s","Total","2018 ","4551","2054","2497",
"57 s","Total","2019 ","4046","1813","2233",
"57 s","Sightseeing Pass","2000 ","122","71","51",
"57 s","Sightseeing Pass","2001 ","215","163","52",
"57 s","Sightseeing Pass","2002 ","219","163","56",
"57 s","Sightseeing Pass","2003 ","176","142","34",
"57 s","Sightseeing Pass","2004 ","252","158","94",
"57 s","Sightseeing Pass","2005 ","201","125","76",
"57 s","Sightseeing Pass","2006 ","159","96","63",
"57 s","Sightseeing Pass","2007 ","109","58","51",
"57 s","Sightseeing Pass","2008 ","121","71","50",
"57 s","Sightseeing Pass","2009 ","158","77","81",
"57 s","Sightseeing Pass","2010 ","162","69","93",
"57 s","Sightseeing Pass","2011 ","183","100","83",
"57 s","Sightseeing Pass","2012 ","204","94","110",
"57 s","Sightseeing Pass","2013 ","209","101","108",
"57 s","Sightseeing Pass","2014 ","162","73","89",
"57 s","Sightseeing Pass","2015 ","200","90","110",
"57 s","Sightseeing Pass","2016 ","214","115","99",
"57 s","Sightseeing Pass","2017 ","175","102","73",
"57 s","Sightseeing Pass","2018 ","238","127","111",
"57 s","Sightseeing Pass","2019 ","171","95","76",
"57 s","Short-term Business","2000 ","25","15","10",
"57 s","Short-term Business","2001 ","29","22","7",
"57 s","Short-term Business","2002 ","21","15","6",
"57 s","Short-term Business","2003 ","29","23","6",
"57 s","Short-term Business","2004 ","24","21","3",
"57 s","Short-term Business","2005 ","25","21","4",
"57 s","Short-term Business","2006 ","16","14","2",
"57 s","Short-term Business","2007 ","20","17","3",
"57 s","Short-term Business","2008 ","17","15","2",
"57 s","Short-term Business","2009 ","11","8","3",
"57 s","Short-term Business","2010 ","6","6","0",
"57 s","Short-term Business","2011 ","11","11","",
"57 s","Short-term Visitors","2000 ","945","478","467",
"57 s","Short-term Visitors","2001 ","658","354","304",
"57 s","Short-term Visitors","2002 ","304","166","138",
"57 s","Short-term Visitors","2003 ","270","133","137",
"57 s","Short-term Visitors","2004 ","268","148","120",
"57 s","Short-term Visitors","2005 ","386","187","199",
"57 s","Short-term Visitors","2006 ","327","152","175",
"57 s","Short-term Visitors","2007 ","315","137","178",
"57 s","Short-term Visitors","2008 ","238","104","134",
"57 s","Short-term Visitors","2009 ","244","67","177",
"57 s","Short-term Visitors","2010 ","667","291","376",
"57 s","Short-term Visitors","2011 ","608","240","368",
"57 s","Short-term Visitors","2012 ","727","271","456",
"57 s","Short-term Visitors","2013 ","974","438","536",
"57 s","Short-term Visitors","2014 ","826","341","485",
"57 s","Short-term Visitors","2015 ","909","382","527",
"57 s","Short-term Visitors","2016 ","1017","469","548",
"57 s","Short-term Visitors","2017 ","1009","472","537",
"57 s","Short-term Visitors","2018 ","1003","462","541",
"57 s","Short-term Visitors","2019 ","851","376","475",
"57 s","Short-term Employment","2000 ","0","0","0",
"57 s","Short-term Employment","2001 ","0","0","0",
"57 s","Short-term Employment","2002 ","0","0","0",
"57 s","Short-term Employment","2003 ","2","1","1",
"57 s","Short-term Employment","2004 ","0","0","0",
"57 s","Short-term Employment","2005 ","1","0","1",
"57 s","Short-term Employment","2006 ","2","2","0",
"57 s","Short-term Employment","2007 ","2","1","1",
"57 s","Short-term Employment","2008 ","1","1","0",
"57 s","Short-term Employment","2009 ","0","0","0",
"57 s","Short-term Employment","2010 ","1","1","0",
"57 s","Short-term Employment","2012 ","1","1","",
"57 s","Job Seeking","2000 ","0","0","0",
"57 s","Job Seeking","2001 ","0","0","0",
"57 s","Job Seeking","2002 ","0","0","0",
"57 s","Job Seeking","2003 ","0","0","0",
"57 s","Job Seeking","2004 ","0","0","0",
"57 s","Job Seeking","2005 ","0","0","0",
"57 s","Job Seeking","2006 ","0","0","0",
"57 s","Job Seeking","2007 ","0","0","0",
"57 s","Job Seeking","2008 ","0","0","0",
"57 s","Job Seeking","2009 ","0","0","0",
"57 s","Job Seeking","2010 ","0","0","0",
"57 s","Job Seeking","2013 ","1","1","0",
"57 s","study","2000 ","1","1","0",
"57 s","study","2001 ","0","0","0",
"57 s","study","2002 ","0","0","0",
"57 s","study","2003 ","1","1","0",
"57 s","study","2004 ","0","0","0",
"57 s","study","2005 ","1","1","0",
"57 s","study","2006 ","0","0","0",
"57 s","study","2007 ","0","0","0",
"57 s","study","2008 ","1","1","0",
"57 s","study","2009 ","1","0","1",
"57 s","study","2010 ","0","0","0",
"57 s","study","2012 ","1","1","",
"57 s","study","2014 ","1","1","0",
"57 s","study","2019 ","1","1","0",
"57 s","General Trainees","2000 ","0","0","0",
"57 s","General Trainees","2001 ","0","0","0",
"57 s","General Trainees","2002 ","1","1","0",
"57 s","General Trainees","2003 ","0","0","0",
"57 s","General Trainees","2004 ","0","0","0",
"57 s","General Trainees","2005 ","0","0","0",
"57 s","General Trainees","2006 ","1","0","1",
"57 s","General Trainees","2007 ","0","0","0",
"57 s","General Trainees","2008 ","0","0","0",
"57 s","General Trainees","2009 ","0","0","0",
"57 s","General Trainees","2010 ","2","1","1",
"57 s","General Trainees","2011 ","8","4","4",
"57 s","General Trainees","2014 ","1","0","1",
"57 s","General Trainees","2016 ","1","0","1",
"57 s","General Trainees","2019 ","1","0","1",
"57 s","Religious Activities","2000 ","2","1","1",
"57 s","Religious Activities","2001 ","6","3","3",
"57 s","Religious Activities","2002 ","3","0","3",
"57 s","Religious Activities","2003 ","3","1","2",
"57 s","Religious Activities","2004 ","4","2","2",
"57 s","Religious Activities","2005 ","2","2","0",
"57 s","Religious Activities","2006 ","1","1","0",
"57 s","Religious Activities","2007 ","6","4","2",
"57 s","Religious Activities","2008 ","5","4","1",
"57 s","Religious Activities","2009 ","1","1","0",
"57 s","Religious Activities","2010 ","3","2","1",
"57 s","Religious Activities","2011 ","3","2","1",
"57 s","Religious Activities","2012 ","2","1","1",
"57 s","Religious Activities","2013 ","6","3","3",
"57 s","Religious Activities","2014 ","2","1","1",
"57 s","Religious Activities","2015 ","2","2","0",
"57 s","Religious Activities","2016 ","1","1","0",
"57 s","Religious Activities","2018 ","3","0","3",
"57 s","Religious Activities","2019 ","2","2","0",
"57 s","Investors","2000 ","14","11","3",
"57 s","Investors","2001 ","14","14","0",
"57 s","Investors","2002 ","12","11","1",
"57 s","Investors","2003 ","21","20","1",
"57 s","Investors","2004 ","18","17","1",
"57 s","Investors","2005 ","18","18","0",
"57 s","Investors","2006 ","5","4","1",
"57 s","Investors","2007 ","16","16","0",
"57 s","Investors","2008 ","8","7","1",
"57 s","Investors","2009 ","7","7","0",
"57 s","Investors","2010 ","6","6","0",
"57 s","Investors","2011 ","6","5","1",
"57 s","Investors","2012 ","7","5","2",
"57 s","Investors","2013 ","15","14","1",
"57 s","Investors","2014 ","10","9","1",
"57 s","Investors","2015 ","9","8","1",
"57 s","Investors","2016 ","5","5","0",
"57 s","Investors","2017 ","9","9","0",
"57 s","Investors","2018 ","10","10","0",
"57 s","Investors","2019 ","6","6","0",
"57 s","Trade and Business","2000 ","10","10","0",
"57 s","Trade and Business","2001 ","6","6","0",
"57 s","Trade and Business","2002 ","17","17","0",
"57 s","Trade and Business","2003 ","14","14","0",
"57 s","Trade and Business","2004 ","15","15","0",
"57 s","Trade and Business","2005 ","19","18","1",
"57 s","Trade and Business","2006 ","7","7","0",
"57 s","Trade and Business","2007 ","16","16","0",
"57 s","Trade and Business","2008 ","28","27","1",
"57 s","Trade and Business","2009 ","15","15","0",
"57 s","Trade and Business","2010 ","27","27","0",
"57 s","Trade and Business","2011 ","23","23","",
"57 s","Trade and Business","2012 ","32","32","",
"57 s","Trade and Business","2013 ","36","35","1",
"57 s","Trade and Business","2014 ","32","32","0",
"57 s","Trade and Business","2015 ","27","26","1",
"57 s","Trade and Business","2016 ","26","26","0",
"57 s","Trade and Business","2017 ","6","5","1",
"57 s","Trade and Business","2018 ","8","7","1",
"57 s","Trade and Business","2019 ","10","10","0",
"57 s","Research","2000 ","0","0","0",
"57 s","Research","2001 ","3","3","0",
"57 s","Research","2002 ","2","2","0",
"57 s","Research","2003 ","7","7","0",
"57 s","Research","2004 ","2","2","0",
"57 s","Research","2005 ","5","5","0",
"57 s","Research","2006 ","3","3","0",
"57 s","Research","2007 ","4","4","0",
"57 s","Research","2008 ","2","2","0",
"57 s","Research","2009 ","0","0","0",
"57 s","Research","2010 ","2","2","0",
"57 s","Research","2011 ","3","2","1",
"57 s","Research","2012 ","4","4","",
"57 s","Research","2013 ","8","8","0",
"57 s","Research","2014 ","6","6","0",
"57 s","Research","2015 ","2","2","0",
"57 s","Research","2016 ","2","2","0",
"57 s","Research","2017 ","3","3","0",
"57 s","Research","2019 ","2","2","0",
"57 s","Art and Entertainment","2000 ","0","0","0",
"57 s","Art and Entertainment","2001 ","2","1","1",
"57 s","Art and Entertainment","2002 ","3","3","0",
"57 s","Art and Entertainment","2003 ","1","1","0",
"57 s","Art and Entertainment","2004 ","3","2","1",
"57 s","Art and Entertainment","2005 ","3","2","1",
"57 s","Art and Entertainment","2006 ","1","1","0",
"57 s","Art and Entertainment","2007 ","3","2","1",
"57 s","Art and Entertainment","2008 ","1","1","0",
"57 s","Art and Entertainment","2009 ","6","6","0",
"57 s","Art and Entertainment","2010 ","1","0","1",
"57 s","Art and Entertainment","2011 ","1","1","",
"57 s","Art and Entertainment","2012 ","3","2","1",
"57 s","Art and Entertainment","2013 ","1","1","0",
"57 s","Art and Entertainment","2015 ","1","1","0",
"57 s","Art and Entertainment","2016 ","1","1","0",
"57 s","Art and Entertainment","2017 ","1","1","0",
"57 s","Art and Entertainment","2018 ","1","1","0",
"57 s","Art and Entertainment","2019 ","1","1","0",
"57 s","Unskilled Employment","2000 ","0","0","0",
"57 s","Unskilled Employment","2001 ","0","0","0",
"57 s","Unskilled Employment","2002 ","0","0","0",
"57 s","Unskilled Employment","2003 ","0","0","0",
"57 s","Unskilled Employment","2004 ","22","9","13",
"57 s","Unskilled Employment","2005 ","2","2","0",
"57 s","Unskilled Employment","2006 ","1","0","1",
"57 s","Unskilled Employment","2007 ","17","6","11",
"57 s","Unskilled Employment","2008 ","0","0","0",
"57 s","Unskilled Employment","2009 ","0","0","0",
"57 s","Unskilled Employment","2010 ","0","0","0",
"57 s","Visiting and Joining Family","2000 ","138","78","60",
"57 s","Visiting and Joining Family","2001 ","90","44","46",
"57 s","Visiting and Joining Family","2002 ","65","35","30",
"57 s","Visiting and Joining Family","2003 ","85","44","41",
"57 s","Visiting and Joining Family","2004 ","208","111","97",
"57 s","Visiting and Joining Family","2005 ","750","399","351",
"57 s","Visiting and Joining Family","2006 ","1411","741","670",
"57 s","Visiting and Joining Family","2007 ","278","146","132",
"57 s","Visiting and Joining Family","2008 ","18","9","9",
"57 s","Visiting and Joining Family","2009 ","27","11","16",
"57 s","Visiting and Joining Family","2010 ","42","20","22",
"57 s","Visiting and Joining Family","2011 ","44","17","27",
"57 s","Visiting and Joining Family","2012 ","81","25","56",
"57 s","Visiting and Joining Family","2013 ","148","47","101",
"57 s","Visiting and Joining Family","2014 ","235","81","154",
"57 s","Visiting and Joining Family","2015 ","335","97","238",
"57 s","Visiting and Joining Family","2016 ","444","172","272",
"57 s","Visiting and Joining Family","2017 ","514","199","315",
"57 s","Visiting and Joining Family","2018 ","445","179","266",
"57 s","Visiting and Joining Family","2019 ","495","200","295",
"57 s","Overseas Koreans","2000 ","16","6","10",
"57 s","Overseas Koreans","2001 ","28","9","19",
"57 s","Overseas Koreans","2002 ","48","18","30",
"57 s","Overseas Koreans","2003 ","32","12","20",
"57 s","Overseas Koreans","2004 ","42","13","29",
"57 s","Overseas Koreans","2005 ","48","17","31",
"57 s","Overseas Koreans","2006 ","37","14","23",
"57 s","Overseas Koreans","2007 ","69","25","44",
"57 s","Overseas Koreans","2008 ","58","20","38",
"57 s","Overseas Koreans","2009 ","81","27","54",
"57 s","Overseas Koreans","2010 ","425","203","222",
"57 s","Overseas Koreans","2011 ","527","289","238",
"57 s","Overseas Koreans","2012 ","441","200","241",
"57 s","Overseas Koreans","2013 ","469","199","270",
"57 s","Overseas Koreans","2014 ","611","279","332",
"57 s","Overseas Koreans","2015 ","567","237","330",
"57 s","Overseas Koreans","2016 ","631","264","367",
"57 s","Overseas Koreans","2017 ","629","259","370",
"57 s","Overseas Koreans","2018 ","619","226","393",
"57 s","Overseas Koreans","2019 ","553","230","323",
"57 s","Permanent Residence","2000 ","0","0","0",
"57 s","Permanent Residence","2001 ","0","0","0",
"57 s","Permanent Residence","2002 ","0","0","0",
"57 s","Permanent Residence","2003 ","2","0","2",
"57 s","Permanent Residence","2004 ","8","5","3",
"57 s","Permanent Residence","2005 ","5","2","3",
"57 s","Permanent Residence","2006 ","3","3","0",
"57 s","Permanent Residence","2007 ","5","2","3",
"57 s","Permanent Residence","2008 ","4","4","0",
"57 s","Permanent Residence","2009 ","5","3","2",
"57 s","Permanent Residence","2010 ","16","9","7",
"57 s","Permanent Residence","2011 ","42","10","32",
"57 s","Permanent Residence","2012 ","59","27","32",
"57 s","Permanent Residence","2013 ","86","34","52",
"57 s","Permanent Residence","2014 ","116","42","74",
"57 s","Permanent Residence","2015 ","104","36","68",
"57 s","Permanent Residence","2016 ","110","44","66",
"57 s","Permanent Residence","2017 ","143","43","100",
"57 s","Permanent Residence","2018 ","127","44","83",
"57 s","Permanent Residence","2019 ","135","39","96",
"57 s","Marriage Immigration","2011 ","1","1","",
"57 s","Marriage Immigration","2012 ","40","13","27",
"57 s","Marriage Immigration","2013 ","50","21","29",
"57 s","Marriage Immigration","2014 ","45","17","28",
"57 s","Marriage Immigration","2015 ","35","13","22",
"57 s","Marriage Immigration","2016 ","48","15","33",
"57 s","Marriage Immigration","2017 ","53","13","40",
"57 s","Marriage Immigration","2018 ","43","10","33",
"57 s","Marriage Immigration","2019 ","54","17","37",
"58 s","Total","2000 ","1279","699","580",
"58 s","Total","2001 ","1143","687","456",
"58 s","Total","2002 ","846","529","317",
"58 s","Total","2003 ","681","405","276",
"58 s","Total","2004 ","786","435","351",
"58 s","Total","2005 ","1565","857","708",
"58 s","Total","2006 ","1735","984","751",
"58 s","Total","2007 ","5267","2813","2454",
"58 s","Total","2008 ","3087","1606","1481",
"58 s","Total","2009 ","2008","1040","968",
"58 s","Total","2010 ","2782","1364","1418",
"58 s","Total","2011 ","2877","1377","1500",
"58 s","Total","2012 ","2627","1184","1443",
"58 s","Total","2013 ","3254","1548","1706",
"58 s","Total","2014 ","4562","2257","2305",
"58 s","Total","2015 ","4897","2291","2606",
"58 s","Total","2016 ","4311","1935","2376",
"58 s","Total","2017 ","4331","1984","2347",
"58 s","Total","2018 ","5109","2393","2716",
"58 s","Total","2019 ","3562","1550","2012",
"58 s","Sightseeing Pass","2000 ","105","71","34",
"58 s","Sightseeing Pass","2001 ","192","138","54",
"58 s","Sightseeing Pass","2002 ","226","159","67",
"58 s","Sightseeing Pass","2003 ","176","115","61",
"58 s","Sightseeing Pass","2004 ","186","125","61",
"58 s","Sightseeing Pass","2005 ","195","132","63",
"58 s","Sightseeing Pass","2006 ","158","97","61",
"58 s","Sightseeing Pass","2007 ","111","63","48",
"58 s","Sightseeing Pass","2008 ","99","59","40",
"58 s","Sightseeing Pass","2009 ","124","72","52",
"58 s","Sightseeing Pass","2010 ","155","85","70",
"58 s","Sightseeing Pass","2011 ","172","86","86",
"58 s","Sightseeing Pass","2012 ","164","77","87",
"58 s","Sightseeing Pass","2013 ","189","79","110",
"58 s","Sightseeing Pass","2014 ","164","78","86",
"58 s","Sightseeing Pass","2015 ","172","79","93",
"58 s","Sightseeing Pass","2016 ","188","102","86",
"58 s","Sightseeing Pass","2017 ","141","70","71",
"58 s","Sightseeing Pass","2018 ","203","114","89",
"58 s","Sightseeing Pass","2019 ","181","91","90",
"58 s","Short-term Business","2000 ","20","17","3",
"58 s","Short-term Business","2001 ","25","21","4",
"58 s","Short-term Business","2002 ","21","17","4",
"58 s","Short-term Business","2003 ","16","14","2",
"58 s","Short-term Business","2004 ","12","10","2",
"58 s","Short-term Business","2005 ","21","21","0",
"58 s","Short-term Business","2006 ","20","17","3",
"58 s","Short-term Business","2007 ","13","12","1",
"58 s","Short-term Business","2008 ","16","13","3",
"58 s","Short-term Business","2009 ","10","9","1",
"58 s","Short-term Business","2010 ","10","8","2",
"58 s","Short-term Business","2011 ","4","4","",
"58 s","Short-term Visitors","2000 ","823","398","425",
"58 s","Short-term Visitors","2001 ","591","315","276",
"58 s","Short-term Visitors","2002 ","267","140","127",
"58 s","Short-term Visitors","2003 ","209","99","110",
"58 s","Short-term Visitors","2004 ","226","108","118",
"58 s","Short-term Visitors","2005 ","351","157","194",
"58 s","Short-term Visitors","2006 ","293","162","131",
"58 s","Short-term Visitors","2007 ","209","93","116",
"58 s","Short-term Visitors","2008 ","204","77","127",
"58 s","Short-term Visitors","2009 ","160","45","115",
"58 s","Short-term Visitors","2010 ","557","246","311",
"58 s","Short-term Visitors","2011 ","537","203","334",
"58 s","Short-term Visitors","2012 ","665","221","444",
"58 s","Short-term Visitors","2013 ","861","393","468",
"58 s","Short-term Visitors","2014 ","730","311","419",
"58 s","Short-term Visitors","2015 ","909","387","522",
"58 s","Short-term Visitors","2016 ","1027","451","576",
"58 s","Short-term Visitors","2017 ","814","346","468",
"58 s","Short-term Visitors","2018 ","1144","562","582",
"58 s","Short-term Visitors","2019 ","662","300","362",
"58 s","Short-term Employment","2000 ","1","1","0",
"58 s","Short-term Employment","2001 ","0","0","0",
"58 s","Short-term Employment","2002 ","0","0","0",
"58 s","Short-term Employment","2003 ","1","1","0",
"58 s","Short-term Employment","2004 ","0","0","0",
"58 s","Short-term Employment","2005 ","1","1","0",
"58 s","Short-term Employment","2006 ","2","1","1",
"58 s","Short-term Employment","2007 ","2","1","1",
"58 s","Short-term Employment","2008 ","0","0","0",
"58 s","Short-term Employment","2009 ","0","0","0",
"58 s","Short-term Employment","2010 ","1","1","0",
"58 s","Short-term Employment","2012 ","1","1","",
"58 s","Short-term Employment","2018 ","1","1","0",
"58 s","Job Seeking","2000 ","0","0","0",
"58 s","Job Seeking","2001 ","0","0","0",
"58 s","Job Seeking","2002 ","0","0","0",
"58 s","Job Seeking","2003 ","0","0","0",
"58 s","Job Seeking","2004 ","0","0","0",
"58 s","Job Seeking","2005 ","0","0","0",
"58 s","Job Seeking","2006 ","0","0","0",
"58 s","Job Seeking","2007 ","0","0","0",
"58 s","Job Seeking","2008 ","0","0","0",
"58 s","Job Seeking","2009 ","0","0","0",
"58 s","Job Seeking","2010 ","0","0","0",
"58 s","study","2000 ","0","0","0",
"58 s","study","2001 ","1","1","0",
"58 s","study","2002 ","1","1","0",
"58 s","study","2003 ","1","1","0",
"58 s","study","2004 ","1","0","1",
"58 s","study","2005 ","0","0","0",
"58 s","study","2006 ","1","1","0",
"58 s","study","2007 ","0","0","0",
"58 s","study","2008 ","0","0","0",
"58 s","study","2009 ","1","1","0",
"58 s","study","2010 ","1","1","0",
"58 s","study","2015 ","1","1","0",
"58 s","study","2016 ","1","0","1",
"58 s","study","2018 ","1","0","1",
"58 s","General Trainees","2000 ","0","0","0",
"58 s","General Trainees","2001 ","0","0","0",
"58 s","General Trainees","2002 ","0","0","0",
"58 s","General Trainees","2003 ","0","0","0",
"58 s","General Trainees","2004 ","0","0","0",
"58 s","General Trainees","2005 ","0","0","0",
"58 s","General Trainees","2006 ","0","0","0",
"58 s","General Trainees","2007 ","1","0","1",
"58 s","General Trainees","2008 ","0","0","0",
"58 s","General Trainees","2009 ","3","2","1",
"58 s","General Trainees","2010 ","2","0","2",
"58 s","General Trainees","2011 ","3","","3",
"58 s","General Trainees","2013 ","1","1","0",
"58 s","General Trainees","2015 ","1","0","1",
"58 s","Religious Activities","2000 ","8","7","1",
"58 s","Religious Activities","2001 ","1","1","0",
"58 s","Religious Activities","2002 ","5","2","3",
"58 s","Religious Activities","2003 ","11","5","6",
"58 s","Religious Activities","2004 ","2","2","0",
"58 s","Religious Activities","2005 ","2","2","0",
"58 s","Religious Activities","2006 ","2","1","1",
"58 s","Religious Activities","2007 ","0","0","0",
"58 s","Religious Activities","2008 ","7","4","3",
"58 s","Religious Activities","2009 ","1","0","1",
"58 s","Religious Activities","2010 ","4","3","1",
"58 s","Religious Activities","2011 ","2","1","1",
"58 s","Religious Activities","2012 ","3","2","1",
"58 s","Religious Activities","2013 ","1","1","0",
"58 s","Religious Activities","2014 ","3","1","2",
"58 s","Religious Activities","2015 ","3","2","1",
"58 s","Religious Activities","2017 ","2","1","1",
"58 s","Religious Activities","2018 ","6","3","3",
"58 s","Religious Activities","2019 ","4","1","3",
"58 s","Investors","2000 ","11","9","2",
"58 s","Investors","2001 ","6","5","1",
"58 s","Investors","2002 ","16","14","2",
"58 s","Investors","2003 ","9","9","0",
"58 s","Investors","2004 ","11","10","1",
"58 s","Investors","2005 ","18","18","0",
"58 s","Investors","2006 ","10","10","0",
"58 s","Investors","2007 ","8","8","0",
"58 s","Investors","2008 ","8","8","0",
"58 s","Investors","2009 ","7","7","0",
"58 s","Investors","2010 ","1","1","0",
"58 s","Investors","2011 ","6","6","",
"58 s","Investors","2012 ","4","4","",
"58 s","Investors","2013 ","7","7","0",
"58 s","Investors","2014 ","5","5","0",
"58 s","Investors","2015 ","6","6","0",
"58 s","Investors","2016 ","7","5","2",
"58 s","Investors","2017 ","8","7","1",
"58 s","Investors","2018 ","7","7","0",
"58 s","Investors","2019 ","8","8","0",
"58 s","Trade and Business","2000 ","5","5","0",
"58 s","Trade and Business","2001 ","13","12","1",
"58 s","Trade and Business","2002 ","10","10","0",
"58 s","Trade and Business","2003 ","10","10","0",
"58 s","Trade and Business","2004 ","13","13","0",
"58 s","Trade and Business","2005 ","16","16","0",
"58 s","Trade and Business","2006 ","9","9","0",
"58 s","Trade and Business","2007 ","15","15","0",
"58 s","Trade and Business","2008 ","15","15","0",
"58 s","Trade and Business","2009 ","14","14","0",
"58 s","Trade and Business","2010 ","18","18","0",
"58 s","Trade and Business","2011 ","20","19","1",
"58 s","Trade and Business","2012 ","26","25","1",
"58 s","Trade and Business","2013 ","23","23","0",
"58 s","Trade and Business","2014 ","33","32","1",
"58 s","Trade and Business","2015 ","26","26","0",
"58 s","Trade and Business","2016 ","10","10","0",
"58 s","Trade and Business","2017 ","15","14","1",
"58 s","Trade and Business","2018 ","13","13","0",
"58 s","Trade and Business","2019 ","11","10","1",
"58 s","Research","2000 ","3","3","0",
"58 s","Research","2001 ","4","4","0",
"58 s","Research","2002 ","5","3","2",
"58 s","Research","2003 ","1","1","0",
"58 s","Research","2004 ","1","1","0",
"58 s","Research","2005 ","3","3","0",
"58 s","Research","2006 ","6","6","0",
"58 s","Research","2007 ","4","4","0",
"58 s","Research","2008 ","2","2","0",
"58 s","Research","2009 ","3","3","0",
"58 s","Research","2010 ","0","0","0",
"58 s","Research","2011 ","2","2","",
"58 s","Research","2012 ","3","3","",
"58 s","Research","2013 ","8","7","1",
"58 s","Research","2014 ","3","3","0",
"58 s","Research","2015 ","1","0","1",
"58 s","Research","2016 ","5","5","0",
"58 s","Research","2017 ","1","1","0",
"58 s","Research","2018 ","3","3","0",
"58 s","Research","2019 ","1","1","0",
"58 s","Art and Entertainment","2000 ","1","1","0",
"58 s","Art and Entertainment","2001 ","4","3","1",
"58 s","Art and Entertainment","2002 ","1","1","0",
"58 s","Art and Entertainment","2003 ","0","0","0",
"58 s","Art and Entertainment","2004 ","0","0","0",
"58 s","Art and Entertainment","2005 ","2","1","1",
"58 s","Art and Entertainment","2006 ","3","2","1",
"58 s","Art and Entertainment","2007 ","2","2","0",
"58 s","Art and Entertainment","2008 ","1","0","1",
"58 s","Art and Entertainment","2009 ","2","2","0",
"58 s","Art and Entertainment","2010 ","0","0","0",
"58 s","Art and Entertainment","2011 ","2","2","",
"58 s","Art and Entertainment","2012 ","4","4","",
"58 s","Art and Entertainment","2015 ","1","1","0",
"58 s","Art and Entertainment","2019 ","3","3","0",
"58 s","Unskilled Employment","2000 ","0","0","0",
"58 s","Unskilled Employment","2001 ","0","0","0",
"58 s","Unskilled Employment","2002 ","0","0","0",
"58 s","Unskilled Employment","2003 ","1","0","1",
"58 s","Unskilled Employment","2004 ","12","6","6",
"58 s","Unskilled Employment","2005 ","4","3","1",
"58 s","Unskilled Employment","2006 ","6","4","2",
"58 s","Unskilled Employment","2007 ","6","3","3",
"58 s","Unskilled Employment","2008 ","0","0","0",
"58 s","Unskilled Employment","2009 ","0","0","0",
"58 s","Unskilled Employment","2010 ","0","0","0",
"58 s","Visiting and Joining Family","2000 ","143","84","59",
"58 s","Visiting and Joining Family","2001 ","143","83","60",
"58 s","Visiting and Joining Family","2002 ","80","49","31",
"58 s","Visiting and Joining Family","2003 ","90","47","43",
"58 s","Visiting and Joining Family","2004 ","136","70","66",
"58 s","Visiting and Joining Family","2005 ","653","346","307",
"58 s","Visiting and Joining Family","2006 ","990","544","446",
"58 s","Visiting and Joining Family","2007 ","199","108","91",
"58 s","Visiting and Joining Family","2008 ","24","12","12",
"58 s","Visiting and Joining Family","2009 ","24","7","17",
"58 s","Visiting and Joining Family","2010 ","31","13","18",
"58 s","Visiting and Joining Family","2011 ","37","18","19",
"58 s","Visiting and Joining Family","2012 ","72","24","48",
"58 s","Visiting and Joining Family","2013 ","173","56","117",
"58 s","Visiting and Joining Family","2014 ","272","93","179",
"58 s","Visiting and Joining Family","2015 ","310","104","206",
"58 s","Visiting and Joining Family","2016 ","445","172","273",
"58 s","Visiting and Joining Family","2017 ","443","165","278",
"58 s","Visiting and Joining Family","2018 ","473","189","284",
"58 s","Visiting and Joining Family","2019 ","449","171","278",
"58 s","Overseas Koreans","2000 ","12","7","5",
"58 s","Overseas Koreans","2001 ","26","9","17",
"58 s","Overseas Koreans","2002 ","31","11","20",
"58 s","Overseas Koreans","2003 ","30","17","13",
"58 s","Overseas Koreans","2004 ","32","14","18",
"58 s","Overseas Koreans","2005 ","55","22","33",
"58 s","Overseas Koreans","2006 ","47","19","28",
"58 s","Overseas Koreans","2007 ","56","20","36",
"58 s","Overseas Koreans","2008 ","75","24","51",
"58 s","Overseas Koreans","2009 ","71","25","46",
"58 s","Overseas Koreans","2010 ","310","132","178",
"58 s","Overseas Koreans","2011 ","450","235","215",
"58 s","Overseas Koreans","2012 ","381","186","195",
"58 s","Overseas Koreans","2013 ","470","208","262",
"58 s","Overseas Koreans","2014 ","459","203","256",
"58 s","Overseas Koreans","2015 ","608","284","324",
"58 s","Overseas Koreans","2016 ","624","269","355",
"58 s","Overseas Koreans","2017 ","627","254","373",
"58 s","Overseas Koreans","2018 ","674","271","403",
"58 s","Overseas Koreans","2019 ","575","226","349",
"58 s","Permanent Residence","2000 ","0","0","0",
"58 s","Permanent Residence","2001 ","0","0","0",
"58 s","Permanent Residence","2002 ","0","0","0",
"58 s","Permanent Residence","2003 ","3","3","0",
"58 s","Permanent Residence","2004 ","9","3","6",
"58 s","Permanent Residence","2005 ","10","3","7",
"58 s","Permanent Residence","2006 ","5","2","3",
"58 s","Permanent Residence","2007 ","5","2","3",
"58 s","Permanent Residence","2008 ","6","1","5",
"58 s","Permanent Residence","2009 ","5","1","4",
"58 s","Permanent Residence","2010 ","11","5","6",
"58 s","Permanent Residence","2011 ","34","14","20",
"58 s","Permanent Residence","2012 ","48","23","25",
"58 s","Permanent Residence","2013 ","90","41","49",
"58 s","Permanent Residence","2014 ","102","38","64",
"58 s","Permanent Residence","2015 ","108","42","66",
"58 s","Permanent Residence","2016 ","136","46","90",
"58 s","Permanent Residence","2017 ","123","42","81",
"58 s","Permanent Residence","2018 ","169","63","106",
"58 s","Permanent Residence","2019 ","127","37","90",
"58 s","Marriage Immigration","2011 ","1","","1",
"58 s","Marriage Immigration","2012 ","39","19","20",
"58 s","Marriage Immigration","2013 ","46","20","26",
"58 s","Marriage Immigration","2014 ","42","12","30",
"58 s","Marriage Immigration","2015 ","33","8","25",
"58 s","Marriage Immigration","2016 ","46","19","27",
"58 s","Marriage Immigration","2017 ","44","19","25",
"58 s","Marriage Immigration","2018 ","63","20","43",
"58 s","Marriage Immigration","2019 ","38","9","29",
"59 s","Total","2000 ","1176","624","552",
"59 s","Total","2001 ","1078","614","464",
"59 s","Total","2002 ","845","510","335",
"59 s","Total","2003 ","674","401","273",
"59 s","Total","2004 ","743","425","318",
"59 s","Total","2005 ","1110","634","476",
"59 s","Total","2006 ","1323","721","602",
"59 s","Total","2007 ","4029","2123","1906",
"59 s","Total","2008 ","3536","1821","1715",
"59 s","Total","2009 ","1999","1014","985",
"59 s","Total","2010 ","2395","1234","1161",
"59 s","Total","2011 ","2448","1183","1265",
"59 s","Total","2012 ","2426","1094","1332",
"59 s","Total","2013 ","2817","1245","1572",
"59 s","Total","2014 ","4649","2207","2442",
"59 s","Total","2015 ","4237","1915","2322",
"59 s","Total","2016 ","4186","1853","2333",
"59 s","Total","2017 ","4558","2103","2455",
"59 s","Total","2018 ","4288","1921","2367",
"59 s","Total","2019 ","4068","1766","2302",
"59 s","Sightseeing Pass","2000 ","99","59","40",
"59 s","Sightseeing Pass","2001 ","179","117","62",
"59 s","Sightseeing Pass","2002 ","227","159","68",
"59 s","Sightseeing Pass","2003 ","189","135","54",
"59 s","Sightseeing Pass","2004 ","157","96","61",
"59 s","Sightseeing Pass","2005 ","138","93","45",
"59 s","Sightseeing Pass","2006 ","140","81","59",
"59 s","Sightseeing Pass","2007 ","102","60","42",
"59 s","Sightseeing Pass","2008 ","109","60","49",
"59 s","Sightseeing Pass","2009 ","131","69","62",
"59 s","Sightseeing Pass","2010 ","118","65","53",
"59 s","Sightseeing Pass","2011 ","157","77","80",
"59 s","Sightseeing Pass","2012 ","171","73","98",
"59 s","Sightseeing Pass","2013 ","131","61","70",
"59 s","Sightseeing Pass","2014 ","138","50","88",
"59 s","Sightseeing Pass","2015 ","180","71","109",
"59 s","Sightseeing Pass","2016 ","170","65","105",
"59 s","Sightseeing Pass","2017 ","125","53","72",
"59 s","Sightseeing Pass","2018 ","175","88","87",
"59 s","Sightseeing Pass","2019 ","153","86","67",
"59 s","Short-term Business","2000 ","20","16","4",
"59 s","Short-term Business","2001 ","19","13","6",
"59 s","Short-term Business","2002 ","16","16","0",
"59 s","Short-term Business","2003 ","20","19","1",
"59 s","Short-term Business","2004 ","13","11","2",
"59 s","Short-term Business","2005 ","17","16","1",
"59 s","Short-term Business","2006 ","6","5","1",
"59 s","Short-term Business","2007 ","7","6","1",
"59 s","Short-term Business","2008 ","12","12","0",
"59 s","Short-term Business","2009 ","1","1","0",
"59 s","Short-term Business","2010 ","6","6","0",
"59 s","Short-term Business","2011 ","7","6","1",
"59 s","Short-term Visitors","2000 ","785","372","413",
"59 s","Short-term Visitors","2001 ","548","275","273",
"59 s","Short-term Visitors","2002 ","278","133","145",
"59 s","Short-term Visitors","2003 ","206","97","109",
"59 s","Short-term Visitors","2004 ","178","84","94",
"59 s","Short-term Visitors","2005 ","258","132","126",
"59 s","Short-term Visitors","2006 ","252","117","135",
"59 s","Short-term Visitors","2007 ","201","95","106",
"59 s","Short-term Visitors","2008 ","148","58","90",
"59 s","Short-term Visitors","2009 ","184","57","127",
"59 s","Short-term Visitors","2010 ","454","211","243",
"59 s","Short-term Visitors","2011 ","462","170","292",
"59 s","Short-term Visitors","2012 ","570","224","346",
"59 s","Short-term Visitors","2013 ","911","356","555",
"59 s","Short-term Visitors","2014 ","960","408","552",
"59 s","Short-term Visitors","2015 ","1003","403","600",
"59 s","Short-term Visitors","2016 ","1089","460","629",
"59 s","Short-term Visitors","2017 ","1064","473","591",
"59 s","Short-term Visitors","2018 ","1025","422","603",
"59 s","Short-term Visitors","2019 ","864","374","490",
"59 s","Short-term Employment","2000 ","2","1","1",
"59 s","Short-term Employment","2001 ","0","0","0",
"59 s","Short-term Employment","2002 ","0","0","0",
"59 s","Short-term Employment","2003 ","1","1","0",
"59 s","Short-term Employment","2004 ","0","0","0",
"59 s","Short-term Employment","2005 ","1","1","0",
"59 s","Short-term Employment","2006 ","0","0","0",
"59 s","Short-term Employment","2007 ","1","1","0",
"59 s","Short-term Employment","2008 ","0","0","0",
"59 s","Short-term Employment","2009 ","0","0","0",
"59 s","Short-term Employment","2010 ","0","0","0",
"59 s","Short-term Employment","2015 ","1","1","0",
"59 s","Short-term Employment","2016 ","2","2","0",
"59 s","Job Seeking","2000 ","0","0","0",
"59 s","Job Seeking","2001 ","0","0","0",
"59 s","Job Seeking","2002 ","0","0","0",
"59 s","Job Seeking","2003 ","0","0","0",
"59 s","Job Seeking","2004 ","0","0","0",
"59 s","Job Seeking","2005 ","0","0","0",
"59 s","Job Seeking","2006 ","0","0","0",
"59 s","Job Seeking","2007 ","0","0","0",
"59 s","Job Seeking","2008 ","0","0","0",
"59 s","Job Seeking","2009 ","0","0","0",
"59 s","Job Seeking","2010 ","0","0","0",
"59 s","study","2000 ","0","0","0",
"59 s","study","2001 ","0","0","0",
"59 s","study","2002 ","0","0","0",
"59 s","study","2003 ","0","0","0",
"59 s","study","2004 ","1","1","0",
"59 s","study","2005 ","1","1","0",
"59 s","study","2006 ","0","0","0",
"59 s","study","2007 ","0","0","0",
"59 s","study","2008 ","0","0","0",
"59 s","study","2009 ","0","0","0",
"59 s","study","2010 ","0","0","0",
"59 s","study","2015 ","1","0","1",
"59 s","study","2017 ","1","1","0",
"59 s","study","2018 ","1","0","1",
"59 s","General Trainees","2000 ","0","0","0",
"59 s","General Trainees","2001 ","1","0","1",
"59 s","General Trainees","2002 ","0","0","0",
"59 s","General Trainees","2003 ","0","0","0",
"59 s","General Trainees","2004 ","1","1","0",
"59 s","General Trainees","2005 ","0","0","0",
"59 s","General Trainees","2006 ","0","0","0",
"59 s","General Trainees","2007 ","0","0","0",
"59 s","General Trainees","2008 ","1","0","1",
"59 s","General Trainees","2009 ","0","0","0",
"59 s","General Trainees","2010 ","1","1","0",
"59 s","General Trainees","2011 ","3","2","1",
"59 s","General Trainees","2013 ","1","0","1",
"59 s","General Trainees","2014 ","1","1","0",
"59 s","Religious Activities","2000 ","9","7","2",
"59 s","Religious Activities","2001 ","2","2","0",
"59 s","Religious Activities","2002 ","8","3","5",
"59 s","Religious Activities","2003 ","3","0","3",
"59 s","Religious Activities","2004 ","4","2","2",
"59 s","Religious Activities","2005 ","3","1","2",
"59 s","Religious Activities","2006 ","1","1","0",
"59 s","Religious Activities","2007 ","2","1","1",
"59 s","Religious Activities","2008 ","3","1","2",
"59 s","Religious Activities","2009 ","5","3","2",
"59 s","Religious Activities","2010 ","4","2","2",
"59 s","Religious Activities","2011 ","2","1","1",
"59 s","Religious Activities","2012 ","2","1","1",
"59 s","Religious Activities","2013 ","1","0","1",
"59 s","Religious Activities","2014 ","2","1","1",
"59 s","Religious Activities","2015 ","5","2","3",
"59 s","Religious Activities","2016 ","3","1","2",
"59 s","Religious Activities","2017 ","1","0","1",
"59 s","Religious Activities","2018 ","2","2","0",
"59 s","Religious Activities","2019 ","3","1","2",
"59 s","Investors","2000 ","6","6","0",
"59 s","Investors","2001 ","9","9","0",
"59 s","Investors","2002 ","13","11","2",
"59 s","Investors","2003 ","9","8","1",
"59 s","Investors","2004 ","9","8","1",
"59 s","Investors","2005 ","10","9","1",
"59 s","Investors","2006 ","4","3","1",
"59 s","Investors","2007 ","7","5","2",
"59 s","Investors","2008 ","9","8","1",
"59 s","Investors","2009 ","9","9","0",
"59 s","Investors","2010 ","5","4","1",
"59 s","Investors","2011 ","7","7","",
"59 s","Investors","2012 ","8","8","",
"59 s","Investors","2013 ","4","4","0",
"59 s","Investors","2014 ","5","5","0",
"59 s","Investors","2016 ","5","5","0",
"59 s","Investors","2017 ","3","3","0",
"59 s","Investors","2018 ","6","6","0",
"59 s","Investors","2019 ","6","5","1",
"59 s","Trade and Business","2000 ","5","5","0",
"59 s","Trade and Business","2001 ","7","7","0",
"59 s","Trade and Business","2002 ","7","7","0",
"59 s","Trade and Business","2003 ","10","10","0",
"59 s","Trade and Business","2004 ","12","12","0",
"59 s","Trade and Business","2005 ","20","20","0",
"59 s","Trade and Business","2006 ","11","11","0",
"59 s","Trade and Business","2007 ","12","12","0",
"59 s","Trade and Business","2008 ","9","9","0",
"59 s","Trade and Business","2009 ","13","13","0",
"59 s","Trade and Business","2010 ","15","15","0",
"59 s","Trade and Business","2011 ","15","15","",
"59 s","Trade and Business","2012 ","17","17","",
"59 s","Trade and Business","2013 ","38","37","1",
"59 s","Trade and Business","2014 ","19","19","0",
"59 s","Trade and Business","2015 ","34","34","0",
"59 s","Trade and Business","2016 ","19","19","0",
"59 s","Trade and Business","2017 ","9","9","0",
"59 s","Trade and Business","2018 ","8","8","0",
"59 s","Trade and Business","2019 ","7","7","0",
"59 s","Research","2000 ","4","3","1",
"59 s","Research","2001 ","6","6","0",
"59 s","Research","2002 ","2","1","1",
"59 s","Research","2003 ","2","2","0",
"59 s","Research","2004 ","0","0","0",
"59 s","Research","2005 ","3","3","0",
"59 s","Research","2006 ","3","3","0",
"59 s","Research","2007 ","4","4","0",
"59 s","Research","2008 ","1","1","0",
"59 s","Research","2009 ","1","1","0",
"59 s","Research","2010 ","1","1","0",
"59 s","Research","2011 ","3","3","",
"59 s","Research","2012 ","4","4","",
"59 s","Research","2013 ","4","4","0",
"59 s","Research","2014 ","2","1","1",
"59 s","Research","2016 ","3","2","1",
"59 s","Research","2017 ","1","1","0",
"59 s","Research","2018 ","1","1","0",
"59 s","Art and Entertainment","2000 ","0","0","0",
"59 s","Art and Entertainment","2001 ","1","1","0",
"59 s","Art and Entertainment","2002 ","1","1","0",
"59 s","Art and Entertainment","2003 ","1","1","0",
"59 s","Art and Entertainment","2004 ","0","0","0",
"59 s","Art and Entertainment","2005 ","2","0","2",
"59 s","Art and Entertainment","2006 ","1","1","0",
"59 s","Art and Entertainment","2007 ","6","4","2",
"59 s","Art and Entertainment","2008 ","2","1","1",
"59 s","Art and Entertainment","2009 ","1","1","0",
"59 s","Art and Entertainment","2010 ","4","4","0",
"59 s","Art and Entertainment","2012 ","2","1","1",
"59 s","Art and Entertainment","2013 ","1","0","1",
"59 s","Art and Entertainment","2014 ","1","1","0",
"59 s","Art and Entertainment","2015 ","2","2","0",
"59 s","Art and Entertainment","2016 ","2","2","0",
"59 s","Art and Entertainment","2017 ","2","2","0",
"59 s","Unskilled Employment","2000 ","0","0","0",
"59 s","Unskilled Employment","2001 ","0","0","0",
"59 s","Unskilled Employment","2002 ","0","0","0",
"59 s","Unskilled Employment","2003 ","0","0","0",
"59 s","Unskilled Employment","2004 ","13","11","2",
"59 s","Unskilled Employment","2005 ","5","4","1",
"59 s","Unskilled Employment","2006 ","3","3","0",
"59 s","Unskilled Employment","2007 ","5","2","3",
"59 s","Unskilled Employment","2008 ","1","1","0",
"59 s","Unskilled Employment","2009 ","0","0","0",
"59 s","Unskilled Employment","2010 ","0","0","0",
"59 s","Unskilled Employment","2012 ","1","1","",
"59 s","Visiting and Joining Family","2000 ","109","65","44",
"59 s","Visiting and Joining Family","2001 ","128","75","53",
"59 s","Visiting and Joining Family","2002 ","101","55","46",
"59 s","Visiting and Joining Family","2003 ","82","38","44",
"59 s","Visiting and Joining Family","2004 ","143","78","65",
"59 s","Visiting and Joining Family","2005 ","440","230","210",
"59 s","Visiting and Joining Family","2006 ","704","395","309",
"59 s","Visiting and Joining Family","2007 ","148","80","68",
"59 s","Visiting and Joining Family","2008 ","26","14","12",
"59 s","Visiting and Joining Family","2009 ","19","6","13",
"59 s","Visiting and Joining Family","2010 ","23","12","11",
"59 s","Visiting and Joining Family","2011 ","39","10","29",
"59 s","Visiting and Joining Family","2012 ","58","17","41",
"59 s","Visiting and Joining Family","2013 ","129","39","90",
"59 s","Visiting and Joining Family","2014 ","272","97","175",
"59 s","Visiting and Joining Family","2015 ","331","124","207",
"59 s","Visiting and Joining Family","2016 ","406","160","246",
"59 s","Visiting and Joining Family","2017 ","420","151","269",
"59 s","Visiting and Joining Family","2018 ","375","144","231",
"59 s","Visiting and Joining Family","2019 ","439","187","252",
"59 s","Overseas Koreans","2000 ","22","12","10",
"59 s","Overseas Koreans","2001 ","27","12","15",
"59 s","Overseas Koreans","2002 ","35","19","16",
"59 s","Overseas Koreans","2003 ","29","12","17",
"59 s","Overseas Koreans","2004 ","37","12","25",
"59 s","Overseas Koreans","2005 ","29","10","19",
"59 s","Overseas Koreans","2006 ","54","19","35",
"59 s","Overseas Koreans","2007 ","42","17","25",
"59 s","Overseas Koreans","2008 ","69","22","47",
"59 s","Overseas Koreans","2009 ","82","35","47",
"59 s","Overseas Koreans","2010 ","269","149","120",
"59 s","Overseas Koreans","2011 ","350","187","163",
"59 s","Overseas Koreans","2012 ","335","155","180",
"59 s","Overseas Koreans","2013 ","350","151","199",
"59 s","Overseas Koreans","2014 ","483","222","261",
"59 s","Overseas Koreans","2015 ","504","219","285",
"59 s","Overseas Koreans","2016 ","630","273","357",
"59 s","Overseas Koreans","2017 ","645","275","370",
"59 s","Overseas Koreans","2018 ","611","264","347",
"59 s","Overseas Koreans","2019 ","651","246","405",
"59 s","Permanent Residence","2000 ","0","0","0",
"59 s","Permanent Residence","2001 ","0","0","0",
"59 s","Permanent Residence","2002 ","0","0","0",
"59 s","Permanent Residence","2003 ","5","1","4",
"59 s","Permanent Residence","2004 ","8","2","6",
"59 s","Permanent Residence","2005 ","14","6","8",
"59 s","Permanent Residence","2006 ","2","1","1",
"59 s","Permanent Residence","2007 ","5","1","4",
"59 s","Permanent Residence","2008 ","4","3","1",
"59 s","Permanent Residence","2009 ","7","3","4",
"59 s","Permanent Residence","2010 ","11","6","5",
"59 s","Permanent Residence","2011 ","21","9","12",
"59 s","Permanent Residence","2012 ","32","10","22",
"59 s","Permanent Residence","2013 ","82","36","46",
"59 s","Permanent Residence","2014 ","87","38","49",
"59 s","Permanent Residence","2015 ","107","42","65",
"59 s","Permanent Residence","2016 ","127","47","80",
"59 s","Permanent Residence","2017 ","140","46","94",
"59 s","Permanent Residence","2018 ","118","42","76",
"59 s","Permanent Residence","2019 ","167","54","113",
"59 s","Marriage Immigration","2011 ","2","1","1",
"59 s","Marriage Immigration","2012 ","42","14","28",
"59 s","Marriage Immigration","2013 ","37","14","23",
"59 s","Marriage Immigration","2014 ","40","19","21",
"59 s","Marriage Immigration","2015 ","35","12","23",
"59 s","Marriage Immigration","2016 ","24","12","12",
"59 s","Marriage Immigration","2017 ","43","18","25",
"59 s","Marriage Immigration","2018 ","37","18","19",
"59 s","Marriage Immigration","2019 ","61","13","48",
"60 s","Total","2000 ","1149","589","560",
"60 s","Total","2001 ","994","570","424",
"60 s","Total","2002 ","750","457","293",
"60 s","Total","2003 ","553","326","227",
"60 s","Total","2004 ","658","383","275",
"60 s","Total","2005 ","1929","972","957",
"60 s","Total","2006 ","2375","1155","1220",
"60 s","Total","2007 ","4120","2126","1994",
"60 s","Total","2008 ","3123","1648","1475",
"60 s","Total","2009 ","2014","1115","899",
"60 s","Total","2010 ","2489","1321","1168",
"60 s","Total","2011 ","2358","1232","1126",
"60 s","Total","2012 ","2269","1077","1192",
"60 s","Total","2013 ","4218","2056","2162",
"60 s","Total","2014 ","6182","3040","3142",
"60 s","Total","2015 ","6017","3049","2968",
"60 s","Total","2016 ","5227","2643","2584",
"60 s","Total","2017 ","5339","2635","2704",
"60 s","Total","2018 ","5436","2736","2700",
"60 s","Total","2019 ","4484","2201","2283",
"60 s","Sightseeing Pass","2000 ","104","62","42",
"60 s","Sightseeing Pass","2001 ","176","131","45",
"60 s","Sightseeing Pass","2002 ","197","135","62",
"60 s","Sightseeing Pass","2003 ","151","95","56",
"60 s","Sightseeing Pass","2004 ","151","98","53",
"60 s","Sightseeing Pass","2005 ","137","83","54",
"60 s","Sightseeing Pass","2006 ","100","53","47",
"60 s","Sightseeing Pass","2007 ","78","45","33",
"60 s","Sightseeing Pass","2008 ","90","49","41",
"60 s","Sightseeing Pass","2009 ","138","78","60",
"60 s","Sightseeing Pass","2010 ","132","62","70",
"60 s","Sightseeing Pass","2011 ","135","56","79",
"60 s","Sightseeing Pass","2012 ","113","44","69",
"60 s","Sightseeing Pass","2013 ","144","62","82",
"60 s","Sightseeing Pass","2014 ","143","72","71",
"60 s","Sightseeing Pass","2015 ","156","67","89",
"60 s","Sightseeing Pass","2016 ","171","84","87",
"60 s","Sightseeing Pass","2017 ","113","61","52",
"60 s","Sightseeing Pass","2018 ","143","68","75",
"60 s","Sightseeing Pass","2019 ","160","81","79",
"60 s","Short-term Business","2000 ","13","9","4",
"60 s","Short-term Business","2001 ","17","12","5",
"60 s","Short-term Business","2002 ","13","12","1",
"60 s","Short-term Business","2003 ","18","14","4",
"60 s","Short-term Business","2004 ","15","14","1",
"60 s","Short-term Business","2005 ","16","11","5",
"60 s","Short-term Business","2006 ","9","6","3",
"60 s","Short-term Business","2007 ","11","8","3",
"60 s","Short-term Business","2008 ","10","9","1",
"60 s","Short-term Business","2009 ","5","5","0",
"60 s","Short-term Business","2010 ","7","6","1",
"60 s","Short-term Business","2011 ","8","7","1",
"60 s","Short-term Visitors","2000 ","752","358","394",
"60 s","Short-term Visitors","2001 ","512","250","262",
"60 s","Short-term Visitors","2002 ","268","148","120",
"60 s","Short-term Visitors","2003 ","136","67","69",
"60 s","Short-term Visitors","2004 ","131","70","61",
"60 s","Short-term Visitors","2005 ","1257","546","711",
"60 s","Short-term Visitors","2006 ","1616","721","895",
"60 s","Short-term Visitors","2007 ","689","315","374",
"60 s","Short-term Visitors","2008 ","129","44","85",
"60 s","Short-term Visitors","2009 ","212","66","146",
"60 s","Short-term Visitors","2010 ","396","153","243",
"60 s","Short-term Visitors","2011 ","454","173","281",
"60 s","Short-term Visitors","2012 ","511","195","316",
"60 s","Short-term Visitors","2013 ","835","358","477",
"60 s","Short-term Visitors","2014 ","929","412","517",
"60 s","Short-term Visitors","2015 ","824","366","458",
"60 s","Short-term Visitors","2016 ","908","429","479",
"60 s","Short-term Visitors","2017 ","810","371","439",
"60 s","Short-term Visitors","2018 ","813","361","452",
"60 s","Short-term Visitors","2019 ","706","309","397",
"60 s","Short-term Employment","2000 ","1","0","1",
"60 s","Short-term Employment","2001 ","0","0","0",
"60 s","Short-term Employment","2002 ","1","1","0",
"60 s","Short-term Employment","2003 ","0","0","0",
"60 s","Short-term Employment","2004 ","0","0","0",
"60 s","Short-term Employment","2005 ","5","5","0",
"60 s","Short-term Employment","2006 ","1","0","1",
"60 s","Short-term Employment","2007 ","1","1","0",
"60 s","Short-term Employment","2008 ","1","1","0",
"60 s","Short-term Employment","2009 ","0","0","0",
"60 s","Short-term Employment","2010 ","0","0","0",
"60 s","Short-term Employment","2012 ","2","","2",
"60 s","Short-term Employment","2017 ","1","1","0",
"60 s","Short-term Employment","2019 ","2","2","0",
"60 s","Job Seeking","2000 ","0","0","0",
"60 s","Job Seeking","2001 ","0","0","0",
"60 s","Job Seeking","2002 ","0","0","0",
"60 s","Job Seeking","2003 ","0","0","0",
"60 s","Job Seeking","2004 ","0","0","0",
"60 s","Job Seeking","2005 ","0","0","0",
"60 s","Job Seeking","2006 ","0","0","0",
"60 s","Job Seeking","2007 ","0","0","0",
"60 s","Job Seeking","2008 ","0","0","0",
"60 s","Job Seeking","2009 ","0","0","0",
"60 s","Job Seeking","2010 ","0","0","0",
"60 s","study","2000 ","0","0","0",
"60 s","study","2001 ","0","0","0",
"60 s","study","2002 ","0","0","0",
"60 s","study","2003 ","0","0","0",
"60 s","study","2004 ","0","0","0",
"60 s","study","2005 ","0","0","0",
"60 s","study","2006 ","1","1","0",
"60 s","study","2007 ","0","0","0",
"60 s","study","2008 ","0","0","0",
"60 s","study","2009 ","0","0","0",
"60 s","study","2010 ","0","0","0",
"60 s","study","2011 ","1","1","",
"60 s","General Trainees","2000 ","2","2","0",
"60 s","General Trainees","2001 ","1","1","0",
"60 s","General Trainees","2002 ","0","0","0",
"60 s","General Trainees","2003 ","1","1","0",
"60 s","General Trainees","2004 ","1","1","0",
"60 s","General Trainees","2005 ","0","0","0",
"60 s","General Trainees","2006 ","1","0","1",
"60 s","General Trainees","2007 ","2","2","0",
"60 s","General Trainees","2008 ","1","1","0",
"60 s","General Trainees","2009 ","3","2","1",
"60 s","General Trainees","2010 ","3","0","3",
"60 s","General Trainees","2011 ","3","2","1",
"60 s","General Trainees","2013 ","1","1","0",
"60 s","General Trainees","2016 ","2","2","0",
"60 s","General Trainees","2019 ","2","0","2",
"60 s","Religious Activities","2000 ","5","0","5",
"60 s","Religious Activities","2001 ","6","4","2",
"60 s","Religious Activities","2002 ","6","5","1",
"60 s","Religious Activities","2003 ","2","0","2",
"60 s","Religious Activities","2004 ","2","0","2",
"60 s","Religious Activities","2005 ","7","3","4",
"60 s","Religious Activities","2006 ","3","3","0",
"60 s","Religious Activities","2007 ","1","1","0",
"60 s","Religious Activities","2008 ","1","1","0",
"60 s","Religious Activities","2009 ","3","0","3",
"60 s","Religious Activities","2010 ","3","2","1",
"60 s","Religious Activities","2011 ","5","4","1",
"60 s","Religious Activities","2013 ","4","2","2",
"60 s","Religious Activities","2014 ","2","0","2",
"60 s","Religious Activities","2015 ","4","3","1",
"60 s","Religious Activities","2016 ","4","2","2",
"60 s","Religious Activities","2017 ","1","1","0",
"60 s","Religious Activities","2018 ","3","2","1",
"60 s","Religious Activities","2019 ","1","0","1",
"60 s","Investors","2000 ","9","9","0",
"60 s","Investors","2001 ","6","6","0",
"60 s","Investors","2002 ","6","6","0",
"60 s","Investors","2003 ","12","12","0",
"60 s","Investors","2004 ","4","3","1",
"60 s","Investors","2005 ","11","11","0",
"60 s","Investors","2006 ","2","2","0",
"60 s","Investors","2007 ","3","3","0",
"60 s","Investors","2008 ","6","5","1",
"60 s","Investors","2009 ","6","6","0",
"60 s","Investors","2010 ","4","3","1",
"60 s","Investors","2011 ","3","2","1",
"60 s","Investors","2012 ","2","2","",
"60 s","Investors","2013 ","5","5","0",
"60 s","Investors","2014 ","5","3","2",
"60 s","Investors","2015 ","1","1","0",
"60 s","Investors","2016 ","4","4","0",
"60 s","Investors","2017 ","5","4","1",
"60 s","Investors","2018 ","6","6","0",
"60 s","Investors","2019 ","3","3","0",
"60 s","Trade and Business","2000 ","4","4","0",
"60 s","Trade and Business","2001 ","6","6","0",
"60 s","Trade and Business","2002 ","9","9","0",
"60 s","Trade and Business","2003 ","8","8","0",
"60 s","Trade and Business","2004 ","6","6","0",
"60 s","Trade and Business","2005 ","13","13","0",
"60 s","Trade and Business","2006 ","11","11","0",
"60 s","Trade and Business","2007 ","7","7","0",
"60 s","Trade and Business","2008 ","14","14","0",
"60 s","Trade and Business","2009 ","8","8","0",
"60 s","Trade and Business","2010 ","18","18","0",
"60 s","Trade and Business","2011 ","19","19","",
"60 s","Trade and Business","2012 ","21","21","",
"60 s","Trade and Business","2013 ","18","18","0",
"60 s","Trade and Business","2014 ","24","24","0",
"60 s","Trade and Business","2015 ","18","17","1",
"60 s","Trade and Business","2016 ","12","12","0",
"60 s","Trade and Business","2017 ","7","7","0",
"60 s","Trade and Business","2018 ","13","13","0",
"60 s","Trade and Business","2019 ","6","6","0",
"60 s","Research","2000 ","4","4","0",
"60 s","Research","2001 ","2","1","1",
"60 s","Research","2002 ","1","1","0",
"60 s","Research","2003 ","2","2","0",
"60 s","Research","2004 ","4","3","1",
"60 s","Research","2005 ","1","1","0",
"60 s","Research","2006 ","2","2","0",
"60 s","Research","2007 ","2","2","0",
"60 s","Research","2008 ","5","5","0",
"60 s","Research","2009 ","0","0","0",
"60 s","Research","2010 ","9","8","1",
"60 s","Research","2011 ","3","3","",
"60 s","Research","2012 ","2","2","",
"60 s","Research","2013 ","5","5","0",
"60 s","Research","2014 ","1","1","0",
"60 s","Research","2015 ","2","2","0",
"60 s","Research","2016 ","1","1","0",
"60 s","Research","2017 ","2","2","0",
"60 s","Research","2018 ","3","3","0",
"60 s","Research","2019 ","1","1","0",
"60 s","Art and Entertainment","2000 ","0","0","0",
"60 s","Art and Entertainment","2001 ","0","0","0",
"60 s","Art and Entertainment","2002 ","0","0","0",
"60 s","Art and Entertainment","2003 ","0","0","0",
"60 s","Art and Entertainment","2004 ","0","0","0",
"60 s","Art and Entertainment","2005 ","0","0","0",
"60 s","Art and Entertainment","2006 ","0","0","0",
"60 s","Art and Entertainment","2007 ","2","0","2",
"60 s","Art and Entertainment","2008 ","0","0","0",
"60 s","Art and Entertainment","2009 ","1","1","0",
"60 s","Art and Entertainment","2010 ","1","1","0",
"60 s","Art and Entertainment","2012 ","1","","1",
"60 s","Art and Entertainment","2013 ","1","0","1",
"60 s","Art and Entertainment","2014 ","5","2","3",
"60 s","Art and Entertainment","2016 ","2","2","0",
"60 s","Art and Entertainment","2017 ","2","2","0",
"60 s","Art and Entertainment","2018 ","1","1","0",
"60 s","Art and Entertainment","2019 ","1","0","1",
"60 s","Unskilled Employment","2000 ","0","0","0",
"60 s","Unskilled Employment","2001 ","0","0","0",
"60 s","Unskilled Employment","2002 ","0","0","0",
"60 s","Unskilled Employment","2003 ","1","1","0",
"60 s","Unskilled Employment","2004 ","7","6","1",
"60 s","Unskilled Employment","2005 ","1","1","0",
"60 s","Unskilled Employment","2006 ","0","0","0",
"60 s","Unskilled Employment","2007 ","1","1","0",
"60 s","Unskilled Employment","2008 ","1","0","1",
"60 s","Unskilled Employment","2009 ","0","0","0",
"60 s","Unskilled Employment","2010 ","0","0","0",
"60 s","Visiting and Joining Family","2000 ","135","68","67",
"60 s","Visiting and Joining Family","2001 ","134","78","56",
"60 s","Visiting and Joining Family","2002 ","78","38","40",
"60 s","Visiting and Joining Family","2003 ","84","47","37",
"60 s","Visiting and Joining Family","2004 ","169","84","85",
"60 s","Visiting and Joining Family","2005 ","296","186","110",
"60 s","Visiting and Joining Family","2006 ","469","278","191",
"60 s","Visiting and Joining Family","2007 ","140","86","54",
"60 s","Visiting and Joining Family","2008 ","18","10","8",
"60 s","Visiting and Joining Family","2009 ","12","4","8",
"60 s","Visiting and Joining Family","2010 ","21","12","9",
"60 s","Visiting and Joining Family","2011 ","38","11","27",
"60 s","Visiting and Joining Family","2012 ","50","19","31",
"60 s","Visiting and Joining Family","2013 ","102","33","69",
"60 s","Visiting and Joining Family","2014 ","206","71","135",
"60 s","Visiting and Joining Family","2015 ","281","124","157",
"60 s","Visiting and Joining Family","2016 ","377","154","223",
"60 s","Visiting and Joining Family","2017 ","377","158","219",
"60 s","Visiting and Joining Family","2018 ","371","155","216",
"60 s","Visiting and Joining Family","2019 ","362","147","215",
"60 s","Overseas Koreans","2000 ","14","9","5",
"60 s","Overseas Koreans","2001 ","37","17","20",
"60 s","Overseas Koreans","2002 ","51","24","27",
"60 s","Overseas Koreans","2003 ","41","16","25",
"60 s","Overseas Koreans","2004 ","35","14","21",
"60 s","Overseas Koreans","2005 ","46","25","21",
"60 s","Overseas Koreans","2006 ","42","14","28",
"60 s","Overseas Koreans","2007 ","72","28","44",
"60 s","Overseas Koreans","2008 ","77","33","44",
"60 s","Overseas Koreans","2009 ","71","25","46",
"60 s","Overseas Koreans","2010 ","259","135","124",
"60 s","Overseas Koreans","2011 ","343","191","152",
"60 s","Overseas Koreans","2012 ","432","216","216",
"60 s","Overseas Koreans","2013 ","1905","971","934",
"60 s","Overseas Koreans","2014 ","3288","1613","1675",
"60 s","Overseas Koreans","2015 ","3231","1663","1568",
"60 s","Overseas Koreans","2016 ","2534","1320","1214",
"60 s","Overseas Koreans","2017 ","2780","1415","1365",
"60 s","Overseas Koreans","2018 ","2848","1457","1391",
"60 s","Overseas Koreans","2019 ","2056","1039","1017",
"60 s","Permanent Residence","2000 ","0","0","0",
"60 s","Permanent Residence","2001 ","0","0","0",
"60 s","Permanent Residence","2002 ","1","0","1",
"60 s","Permanent Residence","2003 ","3","2","1",
"60 s","Permanent Residence","2004 ","5","1","4",
"60 s","Permanent Residence","2005 ","4","1","3",
"60 s","Permanent Residence","2006 ","1","1","0",
"60 s","Permanent Residence","2007 ","3","3","0",
"60 s","Permanent Residence","2008 ","4","2","2",
"60 s","Permanent Residence","2009 ","4","2","2",
"60 s","Permanent Residence","2010 ","12","6","6",
"60 s","Permanent Residence","2011 ","19","12","7",
"60 s","Permanent Residence","2012 ","36","15","21",
"60 s","Permanent Residence","2013 ","60","29","31",
"60 s","Permanent Residence","2014 ","99","43","56",
"60 s","Permanent Residence","2015 ","111","44","67",
"60 s","Permanent Residence","2016 ","100","42","58",
"60 s","Permanent Residence","2017 ","135","67","68",
"60 s","Permanent Residence","2018 ","129","52","77",
"60 s","Permanent Residence","2019 ","143","61","82",
"60 s","Marriage Immigration","2011 ","1","1","",
"60 s","Marriage Immigration","2012 ","42","21","21",
"60 s","Marriage Immigration","2013 ","39","18","21",
"60 s","Marriage Immigration","2014 ","29","12","17",
"60 s","Marriage Immigration","2015 ","32","16","16",
"60 s","Marriage Immigration","2016 ","27","13","14",
"60 s","Marriage Immigration","2017 ","28","8","20",
"60 s","Marriage Immigration","2018 ","35","20","15",
"60 s","Marriage Immigration","2019 ","36","20","16",
"61 s","Total","2000 ","1045","583","462",
"61 s","Total","2001 ","872","508","364",
"61 s","Total","2002 ","614","378","236",
"61 s","Total","2003 ","555","327","228",
"61 s","Total","2004 ","594","338","256",
"61 s","Total","2005 ","1786","894","892",
"61 s","Total","2006 ","1605","827","778",
"61 s","Total","2007 ","2458","1432","1026",
"61 s","Total","2008 ","2683","1408","1275",
"61 s","Total","2009 ","1571","837","734",
"61 s","Total","2010 ","2270","1173","1097",
"61 s","Total","2011 ","2305","1176","1129",
"61 s","Total","2012 ","1934","943","991",
"61 s","Total","2013 ","3138","1515","1623",
"61 s","Total","2014 ","4419","2163","2256",
"61 s","Total","2015 ","4090","2001","2089",
"61 s","Total","2016 ","4341","2091","2250",
"61 s","Total","2017 ","3948","1879","2069",
"61 s","Total","2018 ","4260","1986","2274",
"61 s","Total","2019 ","3867","1759","2108",
"61 s","Sightseeing Pass","2000 ","104","60","44",
"61 s","Sightseeing Pass","2001 ","164","129","35",
"61 s","Sightseeing Pass","2002 ","169","116","53",
"61 s","Sightseeing Pass","2003 ","159","108","51",
"61 s","Sightseeing Pass","2004 ","150","102","48",
"61 s","Sightseeing Pass","2005 ","119","71","48",
"61 s","Sightseeing Pass","2006 ","83","44","39",
"61 s","Sightseeing Pass","2007 ","55","41","14",
"61 s","Sightseeing Pass","2008 ","77","42","35",
"61 s","Sightseeing Pass","2009 ","132","67","65",
"61 s","Sightseeing Pass","2010 ","119","57","62",
"61 s","Sightseeing Pass","2011 ","161","71","90",
"61 s","Sightseeing Pass","2012 ","119","57","62",
"61 s","Sightseeing Pass","2013 ","126","59","67",
"61 s","Sightseeing Pass","2014 ","124","55","69",
"61 s","Sightseeing Pass","2015 ","144","73","71",
"61 s","Sightseeing Pass","2016 ","143","68","75",
"61 s","Sightseeing Pass","2017 ","131","63","68",
"61 s","Sightseeing Pass","2018 ","154","71","83",
"61 s","Sightseeing Pass","2019 ","151","95","56",
"61 s","Short-term Business","2000 ","10","7","3",
"61 s","Short-term Business","2001 ","18","13","5",
"61 s","Short-term Business","2002 ","9","7","2",
"61 s","Short-term Business","2003 ","15","11","4",
"61 s","Short-term Business","2004 ","7","6","1",
"61 s","Short-term Business","2005 ","16","15","1",
"61 s","Short-term Business","2006 ","9","9","0",
"61 s","Short-term Business","2007 ","6","6","0",
"61 s","Short-term Business","2008 ","7","6","1",
"61 s","Short-term Business","2009 ","2","1","1",
"61 s","Short-term Business","2010 ","4","3","1",
"61 s","Short-term Business","2011 ","5","4","1",
"61 s","Short-term Visitors","2000 ","654","346","308",
"61 s","Short-term Visitors","2001 ","429","208","221",
"61 s","Short-term Visitors","2002 ","195","105","90",
"61 s","Short-term Visitors","2003 ","152","71","81",
"61 s","Short-term Visitors","2004 ","136","60","76",
"61 s","Short-term Visitors","2005 ","1153","518","635",
"61 s","Short-term Visitors","2006 ","1026","459","567",
"61 s","Short-term Visitors","2007 ","468","247","221",
"61 s","Short-term Visitors","2008 ","109","30","79",
"61 s","Short-term Visitors","2009 ","181","46","135",
"61 s","Short-term Visitors","2010 ","260","85","175",
"61 s","Short-term Visitors","2011 ","370","150","220",
"61 s","Short-term Visitors","2012 ","426","164","262",
"61 s","Short-term Visitors","2013 ","619","238","381",
"61 s","Short-term Visitors","2014 ","434","167","267",
"61 s","Short-term Visitors","2015 ","480","218","262",
"61 s","Short-term Visitors","2016 ","594","275","319",
"61 s","Short-term Visitors","2017 ","476","236","240",
"61 s","Short-term Visitors","2018 ","471","182","289",
"61 s","Short-term Visitors","2019 ","480","180","300",
"61 s","Short-term Employment","2000 ","1","1","0",
"61 s","Short-term Employment","2001 ","0","0","0",
"61 s","Short-term Employment","2002 ","2","2","0",
"61 s","Short-term Employment","2003 ","0","0","0",
"61 s","Short-term Employment","2004 ","1","1","0",
"61 s","Short-term Employment","2005 ","2","2","0",
"61 s","Short-term Employment","2006 ","1","1","0",
"61 s","Short-term Employment","2007 ","0","0","0",
"61 s","Short-term Employment","2008 ","0","0","0",
"61 s","Short-term Employment","2009 ","0","0","0",
"61 s","Short-term Employment","2010 ","0","0","0",
"61 s","Short-term Employment","2019 ","1","1","0",
"61 s","Job Seeking","2000 ","0","0","0",
"61 s","Job Seeking","2001 ","0","0","0",
"61 s","Job Seeking","2002 ","0","0","0",
"61 s","Job Seeking","2003 ","0","0","0",
"61 s","Job Seeking","2004 ","0","0","0",
"61 s","Job Seeking","2005 ","0","0","0",
"61 s","Job Seeking","2006 ","0","0","0",
"61 s","Job Seeking","2007 ","0","0","0",
"61 s","Job Seeking","2008 ","0","0","0",
"61 s","Job Seeking","2009 ","0","0","0",
"61 s","Job Seeking","2010 ","0","0","0",
"61 s","Job Seeking","2014 ","1","1","0",
"61 s","Job Seeking","2019 ","1","1","0",
"61 s","study","2000 ","0","0","0",
"61 s","study","2001 ","1","1","0",
"61 s","study","2002 ","0","0","0",
"61 s","study","2003 ","1","1","0",
"61 s","study","2004 ","1","0","1",
"61 s","study","2005 ","0","0","0",
"61 s","study","2006 ","1","1","0",
"61 s","study","2007 ","1","1","0",
"61 s","study","2008 ","0","0","0",
"61 s","study","2009 ","1","0","1",
"61 s","study","2010 ","0","0","0",
"61 s","study","2016 ","1","1","0",
"61 s","study","2018 ","1","1","0",
"61 s","study","2019 ","1","0","1",
"61 s","General Trainees","2000 ","1","1","0",
"61 s","General Trainees","2001 ","1","1","0",
"61 s","General Trainees","2002 ","0","0","0",
"61 s","General Trainees","2003 ","1","1","0",
"61 s","General Trainees","2004 ","0","0","0",
"61 s","General Trainees","2005 ","1","0","1",
"61 s","General Trainees","2006 ","2","2","0",
"61 s","General Trainees","2007 ","1","1","0",
"61 s","General Trainees","2008 ","0","0","0",
"61 s","General Trainees","2009 ","0","0","0",
"61 s","General Trainees","2010 ","1","0","1",
"61 s","General Trainees","2013 ","2","1","1",
"61 s","General Trainees","2014 ","1","0","1",
"61 s","General Trainees","2015 ","1","0","1",
"61 s","General Trainees","2016 ","1","1","0",
"61 s","Religious Activities","2000 ","5","3","2",
"61 s","Religious Activities","2001 ","6","3","3",
"61 s","Religious Activities","2002 ","7","4","3",
"61 s","Religious Activities","2003 ","6","3","3",
"61 s","Religious Activities","2004 ","5","2","3",
"61 s","Religious Activities","2005 ","7","3","4",
"61 s","Religious Activities","2006 ","1","1","0",
"61 s","Religious Activities","2007 ","4","3","1",
"61 s","Religious Activities","2008 ","3","1","2",
"61 s","Religious Activities","2009 ","1","1","0",
"61 s","Religious Activities","2010 ","2","1","1",
"61 s","Religious Activities","2011 ","2","","2",
"61 s","Religious Activities","2012 ","3","2","1",
"61 s","Religious Activities","2013 ","3","3","0",
"61 s","Religious Activities","2014 ","2","1","1",
"61 s","Religious Activities","2015 ","2","0","2",
"61 s","Religious Activities","2016 ","3","2","1",
"61 s","Religious Activities","2017 ","4","1","3",
"61 s","Religious Activities","2018 ","1","0","1",
"61 s","Religious Activities","2019 ","3","2","1",
"61 s","Investors","2000 ","0","0","0",
"61 s","Investors","2001 ","3","3","0",
"61 s","Investors","2002 ","12","10","2",
"61 s","Investors","2003 ","11","10","1",
"61 s","Investors","2004 ","5","4","1",
"61 s","Investors","2005 ","8","7","1",
"61 s","Investors","2006 ","7","7","0",
"61 s","Investors","2007 ","3","2","1",
"61 s","Investors","2008 ","3","3","0",
"61 s","Investors","2009 ","3","3","0",
"61 s","Investors","2010 ","4","4","0",
"61 s","Investors","2011 ","3","3","",
"61 s","Investors","2012 ","7","6","1",
"61 s","Investors","2013 ","4","4","0",
"61 s","Investors","2014 ","3","3","0",
"61 s","Investors","2015 ","3","2","1",
"61 s","Investors","2016 ","2","2","0",
"61 s","Investors","2017 ","1","1","0",
"61 s","Investors","2018 ","7","7","0",
"61 s","Investors","2019 ","3","3","0",
"61 s","Trade and Business","2000 ","6","5","1",
"61 s","Trade and Business","2001 ","4","4","0",
"61 s","Trade and Business","2002 ","7","7","0",
"61 s","Trade and Business","2003 ","7","7","0",
"61 s","Trade and Business","2004 ","10","10","0",
"61 s","Trade and Business","2005 ","6","6","0",
"61 s","Trade and Business","2006 ","15","15","0",
"61 s","Trade and Business","2007 ","12","12","0",
"61 s","Trade and Business","2008 ","9","9","0",
"61 s","Trade and Business","2009 ","14","14","0",
"61 s","Trade and Business","2010 ","11","11","0",
"61 s","Trade and Business","2011 ","19","19","",
"61 s","Trade and Business","2012 ","16","16","",
"61 s","Trade and Business","2013 ","13","13","0",
"61 s","Trade and Business","2014 ","22","22","0",
"61 s","Trade and Business","2015 ","17","17","0",
"61 s","Trade and Business","2016 ","17","17","0",
"61 s","Trade and Business","2017 ","8","8","0",
"61 s","Trade and Business","2018 ","6","6","0",
"61 s","Trade and Business","2019 ","4","4","0",
"61 s","Research","2000 ","0","0","0",
"61 s","Research","2001 ","4","4","0",
"61 s","Research","2002 ","5","4","1",
"61 s","Research","2003 ","3","3","0",
"61 s","Research","2004 ","3","3","0",
"61 s","Research","2005 ","2","2","0",
"61 s","Research","2006 ","2","2","0",
"61 s","Research","2007 ","2","2","0",
"61 s","Research","2008 ","1","1","0",
"61 s","Research","2009 ","1","1","0",
"61 s","Research","2010 ","2","2","0",
"61 s","Research","2011 ","1","1","",
"61 s","Research","2012 ","6","5","1",
"61 s","Research","2013 ","1","1","0",
"61 s","Research","2014 ","2","2","0",
"61 s","Research","2016 ","1","1","0",
"61 s","Research","2017 ","1","1","0",
"61 s","Research","2018 ","3","3","0",
"61 s","Research","2019 ","1","1","0",
"61 s","Art and Entertainment","2000 ","1","1","0",
"61 s","Art and Entertainment","2001 ","0","0","0",
"61 s","Art and Entertainment","2002 ","1","0","1",
"61 s","Art and Entertainment","2003 ","0","0","0",
"61 s","Art and Entertainment","2004 ","0","0","0",
"61 s","Art and Entertainment","2005 ","0","0","0",
"61 s","Art and Entertainment","2006 ","0","0","0",
"61 s","Art and Entertainment","2007 ","1","1","0",
"61 s","Art and Entertainment","2008 ","1","0","1",
"61 s","Art and Entertainment","2009 ","1","0","1",
"61 s","Art and Entertainment","2010 ","1","1","0",
"61 s","Art and Entertainment","2011 ","1","1","",
"61 s","Art and Entertainment","2012 ","1","","1",
"61 s","Art and Entertainment","2014 ","2","1","1",
"61 s","Art and Entertainment","2015 ","1","0","1",
"61 s","Art and Entertainment","2016 ","1","1","0",
"61 s","Art and Entertainment","2017 ","1","1","0",
"61 s","Unskilled Employment","2000 ","0","0","0",
"61 s","Unskilled Employment","2001 ","0","0","0",
"61 s","Unskilled Employment","2002 ","0","0","0",
"61 s","Unskilled Employment","2003 ","2","2","0",
"61 s","Unskilled Employment","2004 ","9","5","4",
"61 s","Unskilled Employment","2005 ","2","1","1",
"61 s","Unskilled Employment","2006 ","1","0","1",
"61 s","Unskilled Employment","2007 ","2","2","0",
"61 s","Unskilled Employment","2008 ","0","0","0",
"61 s","Unskilled Employment","2009 ","0","0","0",
"61 s","Unskilled Employment","2010 ","0","0","0",
"61 s","Visiting and Joining Family","2000 ","146","91","55",
"61 s","Visiting and Joining Family","2001 ","128","70","58",
"61 s","Visiting and Joining Family","2002 ","81","52","29",
"61 s","Visiting and Joining Family","2003 ","96","55","41",
"61 s","Visiting and Joining Family","2004 ","139","78","61",
"61 s","Visiting and Joining Family","2005 ","280","170","110",
"61 s","Visiting and Joining Family","2006 ","322","214","108",
"61 s","Visiting and Joining Family","2007 ","97","62","35",
"61 s","Visiting and Joining Family","2008 ","37","19","18",
"61 s","Visiting and Joining Family","2009 ","17","7","10",
"61 s","Visiting and Joining Family","2010 ","16","10","6",
"61 s","Visiting and Joining Family","2011 ","37","14","23",
"61 s","Visiting and Joining Family","2012 ","49","16","33",
"61 s","Visiting and Joining Family","2013 ","97","40","57",
"61 s","Visiting and Joining Family","2014 ","148","55","93",
"61 s","Visiting and Joining Family","2015 ","248","92","156",
"61 s","Visiting and Joining Family","2016 ","284","130","154",
"61 s","Visiting and Joining Family","2017 ","332","148","184",
"61 s","Visiting and Joining Family","2018 ","290","131","159",
"61 s","Visiting and Joining Family","2019 ","321","144","177",
"61 s","Overseas Koreans","2000 ","23","13","10",
"61 s","Overseas Koreans","2001 ","24","13","11",
"61 s","Overseas Koreans","2002 ","28","13","15",
"61 s","Overseas Koreans","2003 ","29","14","15",
"61 s","Overseas Koreans","2004 ","23","8","15",
"61 s","Overseas Koreans","2005 ","47","15","32",
"61 s","Overseas Koreans","2006 ","35","9","26",
"61 s","Overseas Koreans","2007 ","54","18","36",
"61 s","Overseas Koreans","2008 ","80","29","51",
"61 s","Overseas Koreans","2009 ","65","23","42",
"61 s","Overseas Koreans","2010 ","125","56","69",
"61 s","Overseas Koreans","2011 ","254","119","135",
"61 s","Overseas Koreans","2012 ","355","175","180",
"61 s","Overseas Koreans","2013 ","1365","680","685",
"61 s","Overseas Koreans","2014 ","2843","1410","1433",
"61 s","Overseas Koreans","2015 ","2656","1332","1324",
"61 s","Overseas Koreans","2016 ","2490","1215","1275",
"61 s","Overseas Koreans","2017 ","2332","1086","1246",
"61 s","Overseas Koreans","2018 ","2754","1302","1452",
"61 s","Overseas Koreans","2019 ","2229","1010","1219",
"61 s","Permanent Residence","2000 ","0","0","0",
"61 s","Permanent Residence","2001 ","0","0","0",
"61 s","Permanent Residence","2002 ","0","0","0",
"61 s","Permanent Residence","2003 ","2","1","1",
"61 s","Permanent Residence","2004 ","5","2","3",
"61 s","Permanent Residence","2005 ","5","3","2",
"61 s","Permanent Residence","2006 ","7","1","6",
"61 s","Permanent Residence","2007 ","4","2","2",
"61 s","Permanent Residence","2008 ","7","2","5",
"61 s","Permanent Residence","2009 ","5","2","3",
"61 s","Permanent Residence","2010 ","10","5","5",
"61 s","Permanent Residence","2011 ","21","8","13",
"61 s","Permanent Residence","2012 ","38","14","24",
"61 s","Permanent Residence","2013 ","46","24","22",
"61 s","Permanent Residence","2014 ","62","28","34",
"61 s","Permanent Residence","2015 ","87","38","49",
"61 s","Permanent Residence","2016 ","108","44","64",
"61 s","Permanent Residence","2017 ","115","49","66",
"61 s","Permanent Residence","2018 ","149","57","92",
"61 s","Permanent Residence","2019 ","156","59","97",
"61 s","Marriage Immigration","2011 ","4","3","1",
"61 s","Marriage Immigration","2012 ","31","14","17",
"61 s","Marriage Immigration","2013 ","23","11","12",
"61 s","Marriage Immigration","2014 ","28","9","19",
"61 s","Marriage Immigration","2015 ","21","5","16",
"61 s","Marriage Immigration","2016 ","33","17","16",
"61 s","Marriage Immigration","2017 ","24","10","14",
"61 s","Marriage Immigration","2018 ","31","13","18",
"61 s","Marriage Immigration","2019 ","37","16","21",
"62 s","Total","2000 ","918","504","414",
"62 s","Total","2001 ","829","451","378",
"62 s","Total","2002 ","561","344","217",
"62 s","Total","2003 ","505","292","213",
"62 s","Total","2004 ","533","295","238",
"62 s","Total","2005 ","1595","811","784",
"62 s","Total","2006 ","1310","681","629",
"62 s","Total","2007 ","1733","1008","725",
"62 s","Total","2008 ","1994","1062","932",
"62 s","Total","2009 ","1460","782","678",
"62 s","Total","2010 ","1709","930","779",
"62 s","Total","2011 ","2156","1116","1040",
"62 s","Total","2012 ","2035","997","1038",
"62 s","Total","2013 ","2655","1318","1337",
"62 s","Total","2014 ","3833","1929","1904",
"62 s","Total","2015 ","3558","1663","1895",
"62 s","Total","2016 ","3752","1795","1957",
"62 s","Total","2017 ","3853","1858","1995",
"62 s","Total","2018 ","3679","1742","1937",
"62 s","Total","2019 ","3659","1682","1977",
"62 s","Sightseeing Pass","2000 ","88","44","44",
"62 s","Sightseeing Pass","2001 ","144","93","51",
"62 s","Sightseeing Pass","2002 ","152","117","35",
"62 s","Sightseeing Pass","2003 ","163","109","54",
"62 s","Sightseeing Pass","2004 ","129","73","56",
"62 s","Sightseeing Pass","2005 ","117","70","47",
"62 s","Sightseeing Pass","2006 ","92","46","46",
"62 s","Sightseeing Pass","2007 ","54","33","21",
"62 s","Sightseeing Pass","2008 ","60","33","27",
"62 s","Sightseeing Pass","2009 ","123","63","60",
"62 s","Sightseeing Pass","2010 ","132","63","69",
"62 s","Sightseeing Pass","2011 ","148","68","80",
"62 s","Sightseeing Pass","2012 ","142","63","79",
"62 s","Sightseeing Pass","2013 ","99","50","49",
"62 s","Sightseeing Pass","2014 ","99","44","55",
"62 s","Sightseeing Pass","2015 ","137","68","69",
"62 s","Sightseeing Pass","2016 ","128","58","70",
"62 s","Sightseeing Pass","2017 ","113","51","62",
"62 s","Sightseeing Pass","2018 ","164","84","80",
"62 s","Sightseeing Pass","2019 ","116","63","53",
"62 s","Short-term Business","2000 ","8","8","0",
"62 s","Short-term Business","2001 ","12","7","5",
"62 s","Short-term Business","2002 ","8","7","1",
"62 s","Short-term Business","2003 ","16","11","5",
"62 s","Short-term Business","2004 ","17","16","1",
"62 s","Short-term Business","2005 ","16","14","2",
"62 s","Short-term Business","2006 ","9","6","3",
"62 s","Short-term Business","2007 ","5","5","0",
"62 s","Short-term Business","2008 ","6","2","4",
"62 s","Short-term Business","2009 ","1","1","0",
"62 s","Short-term Business","2010 ","3","2","1",
"62 s","Short-term Business","2011 ","4","4","",
"62 s","Short-term Visitors","2000 ","558","292","266",
"62 s","Short-term Visitors","2001 ","375","166","209",
"62 s","Short-term Visitors","2002 ","181","83","98",
"62 s","Short-term Visitors","2003 ","132","71","61",
"62 s","Short-term Visitors","2004 ","142","71","71",
"62 s","Short-term Visitors","2005 ","1060","485","575",
"62 s","Short-term Visitors","2006 ","805","378","427",
"62 s","Short-term Visitors","2007 ","338","166","172",
"62 s","Short-term Visitors","2008 ","98","25","73",
"62 s","Short-term Visitors","2009 ","161","54","107",
"62 s","Short-term Visitors","2010 ","179","57","122",
"62 s","Short-term Visitors","2011 ","296","103","193",
"62 s","Short-term Visitors","2012 ","430","153","277",
"62 s","Short-term Visitors","2013 ","514","216","298",
"62 s","Short-term Visitors","2014 ","373","148","225",
"62 s","Short-term Visitors","2015 ","361","154","207",
"62 s","Short-term Visitors","2016 ","455","207","248",
"62 s","Short-term Visitors","2017 ","400","196","204",
"62 s","Short-term Visitors","2018 ","384","150","234",
"62 s","Short-term Visitors","2019 ","372","153","219",
"62 s","Short-term Employment","2000 ","2","2","0",
"62 s","Short-term Employment","2001 ","0","0","0",
"62 s","Short-term Employment","2002 ","0","0","0",
"62 s","Short-term Employment","2003 ","0","0","0",
"62 s","Short-term Employment","2004 ","0","0","0",
"62 s","Short-term Employment","2005 ","1","1","0",
"62 s","Short-term Employment","2006 ","0","0","0",
"62 s","Short-term Employment","2007 ","0","0","0",
"62 s","Short-term Employment","2008 ","0","0","0",
"62 s","Short-term Employment","2009 ","1","1","0",
"62 s","Short-term Employment","2010 ","0","0","0",
"62 s","Short-term Employment","2012 ","1","1","",
"62 s","Short-term Employment","2013 ","1","1","0",
"62 s","Job Seeking","2000 ","0","0","0",
"62 s","Job Seeking","2001 ","0","0","0",
"62 s","Job Seeking","2002 ","0","0","0",
"62 s","Job Seeking","2003 ","0","0","0",
"62 s","Job Seeking","2004 ","0","0","0",
"62 s","Job Seeking","2005 ","0","0","0",
"62 s","Job Seeking","2006 ","0","0","0",
"62 s","Job Seeking","2007 ","0","0","0",
"62 s","Job Seeking","2008 ","0","0","0",
"62 s","Job Seeking","2009 ","0","0","0",
"62 s","Job Seeking","2010 ","0","0","0",
"62 s","study","2000 ","0","0","0",
"62 s","study","2001 ","0","0","0",
"62 s","study","2002 ","0","0","0",
"62 s","study","2003 ","0","0","0",
"62 s","study","2004 ","0","0","0",
"62 s","study","2005 ","0","0","0",
"62 s","study","2006 ","0","0","0",
"62 s","study","2007 ","0","0","0",
"62 s","study","2008 ","1","0","1",
"62 s","study","2009 ","0","0","0",
"62 s","study","2010 ","0","0","0",
"62 s","study","2013 ","1","0","1",
"62 s","study","2016 ","1","1","0",
"62 s","study","2017 ","1","1","0",
"62 s","General Trainees","2000 ","1","1","0",
"62 s","General Trainees","2001 ","2","0","2",
"62 s","General Trainees","2002 ","0","0","0",
"62 s","General Trainees","2003 ","2","2","0",
"62 s","General Trainees","2004 ","0","0","0",
"62 s","General Trainees","2005 ","0","0","0",
"62 s","General Trainees","2006 ","1","1","0",
"62 s","General Trainees","2007 ","0","0","0",
"62 s","General Trainees","2008 ","0","0","0",
"62 s","General Trainees","2009 ","1","1","0",
"62 s","General Trainees","2010 ","1","1","0",
"62 s","General Trainees","2015 ","1","0","1",
"62 s","General Trainees","2016 ","1","1","0",
"62 s","General Trainees","2018 ","1","1","0",
"62 s","Religious Activities","2000 ","10","6","4",
"62 s","Religious Activities","2001 ","6","3","3",
"62 s","Religious Activities","2002 ","2","0","2",
"62 s","Religious Activities","2003 ","3","2","1",
"62 s","Religious Activities","2004 ","3","1","2",
"62 s","Religious Activities","2005 ","5","3","2",
"62 s","Religious Activities","2006 ","4","2","2",
"62 s","Religious Activities","2007 ","2","1","1",
"62 s","Religious Activities","2008 ","3","2","1",
"62 s","Religious Activities","2009 ","2","1","1",
"62 s","Religious Activities","2010 ","5","5","0",
"62 s","Religious Activities","2012 ","2","","2",
"62 s","Religious Activities","2014 ","3","2","1",
"62 s","Religious Activities","2015 ","4","3","1",
"62 s","Religious Activities","2016 ","4","2","2",
"62 s","Religious Activities","2017 ","7","3","4",
"62 s","Religious Activities","2018 ","2","1","1",
"62 s","Religious Activities","2019 ","1","1","0",
"62 s","Investors","2000 ","3","3","0",
"62 s","Investors","2001 ","2","2","0",
"62 s","Investors","2002 ","10","9","1",
"62 s","Investors","2003 ","7","7","0",
"62 s","Investors","2004 ","5","4","1",
"62 s","Investors","2005 ","10","9","1",
"62 s","Investors","2006 ","1","1","0",
"62 s","Investors","2007 ","2","2","0",
"62 s","Investors","2008 ","0","0","0",
"62 s","Investors","2009 ","5","5","0",
"62 s","Investors","2010 ","1","1","0",
"62 s","Investors","2011 ","5","5","",
"62 s","Investors","2012 ","3","3","",
"62 s","Investors","2013 ","4","3","1",
"62 s","Investors","2014 ","2","2","0",
"62 s","Investors","2015 ","1","1","0",
"62 s","Investors","2016 ","1","1","0",
"62 s","Investors","2017 ","1","1","0",
"62 s","Investors","2018 ","1","1","0",
"62 s","Investors","2019 ","1","1","0",
"62 s","Trade and Business","2000 ","5","4","1",
"62 s","Trade and Business","2001 ","1","1","0",
"62 s","Trade and Business","2002 ","8","8","0",
"62 s","Trade and Business","2003 ","4","4","0",
"62 s","Trade and Business","2004 ","7","7","0",
"62 s","Trade and Business","2005 ","5","5","0",
"62 s","Trade and Business","2006 ","5","5","0",
"62 s","Trade and Business","2007 ","12","12","0",
"62 s","Trade and Business","2008 ","9","9","0",
"62 s","Trade and Business","2009 ","6","6","0",
"62 s","Trade and Business","2010 ","12","12","0",
"62 s","Trade and Business","2011 ","11","11","",
"62 s","Trade and Business","2012 ","18","18","",
"62 s","Trade and Business","2013 ","16","15","1",
"62 s","Trade and Business","2014 ","16","16","0",
"62 s","Trade and Business","2015 ","9","9","0",
"62 s","Trade and Business","2016 ","7","7","0",
"62 s","Trade and Business","2017 ","6","6","0",
"62 s","Trade and Business","2018 ","13","13","0",
"62 s","Trade and Business","2019 ","11","11","0",
"62 s","Research","2000 ","4","4","0",
"62 s","Research","2001 ","2","2","0",
"62 s","Research","2002 ","2","2","0",
"62 s","Research","2003 ","2","1","1",
"62 s","Research","2004 ","4","4","0",
"62 s","Research","2005 ","3","3","0",
"62 s","Research","2006 ","1","1","0",
"62 s","Research","2007 ","2","2","0",
"62 s","Research","2008 ","3","3","0",
"62 s","Research","2009 ","1","1","0",
"62 s","Research","2010 ","2","2","0",
"62 s","Research","2012 ","1","1","",
"62 s","Research","2013 ","1","1","0",
"62 s","Research","2015 ","4","4","0",
"62 s","Research","2017 ","3","2","1",
"62 s","Research","2018 ","1","1","0",
"62 s","Research","2019 ","2","2","0",
"62 s","Art and Entertainment","2000 ","0","0","0",
"62 s","Art and Entertainment","2001 ","2","2","0",
"62 s","Art and Entertainment","2002 ","0","0","0",
"62 s","Art and Entertainment","2003 ","0","0","0",
"62 s","Art and Entertainment","2004 ","0","0","0",
"62 s","Art and Entertainment","2005 ","0","0","0",
"62 s","Art and Entertainment","2006 ","0","0","0",
"62 s","Art and Entertainment","2007 ","0","0","0",
"62 s","Art and Entertainment","2008 ","0","0","0",
"62 s","Art and Entertainment","2009 ","0","0","0",
"62 s","Art and Entertainment","2010 ","0","0","0",
"62 s","Art and Entertainment","2012 ","3","2","1",
"62 s","Art and Entertainment","2013 ","1","1","0",
"62 s","Art and Entertainment","2014 ","1","0","1",
"62 s","Art and Entertainment","2015 ","1","1","0",
"62 s","Art and Entertainment","2017 ","1","1","0",
"62 s","Unskilled Employment","2000 ","0","0","0",
"62 s","Unskilled Employment","2001 ","0","0","0",
"62 s","Unskilled Employment","2002 ","0","0","0",
"62 s","Unskilled Employment","2003 ","0","0","0",
"62 s","Unskilled Employment","2004 ","6","3","3",
"62 s","Unskilled Employment","2005 ","1","1","0",
"62 s","Unskilled Employment","2006 ","1","1","0",
"62 s","Unskilled Employment","2007 ","2","1","1",
"62 s","Unskilled Employment","2008 ","1","1","0",
"62 s","Unskilled Employment","2009 ","0","0","0",
"62 s","Unskilled Employment","2010 ","0","0","0",
"62 s","Visiting and Joining Family","2000 ","152","88","64",
"62 s","Visiting and Joining Family","2001 ","154","97","57",
"62 s","Visiting and Joining Family","2002 ","74","44","30",
"62 s","Visiting and Joining Family","2003 ","77","32","45",
"62 s","Visiting and Joining Family","2004 ","104","53","51",
"62 s","Visiting and Joining Family","2005 ","223","138","85",
"62 s","Visiting and Joining Family","2006 ","248","162","86",
"62 s","Visiting and Joining Family","2007 ","104","68","36",
"62 s","Visiting and Joining Family","2008 ","25","15","10",
"62 s","Visiting and Joining Family","2009 ","26","14","12",
"62 s","Visiting and Joining Family","2010 ","18","9","9",
"62 s","Visiting and Joining Family","2011 ","72","29","43",
"62 s","Visiting and Joining Family","2012 ","111","42","69",
"62 s","Visiting and Joining Family","2013 ","95","39","56",
"62 s","Visiting and Joining Family","2014 ","139","56","83",
"62 s","Visiting and Joining Family","2015 ","193","77","116",
"62 s","Visiting and Joining Family","2016 ","248","123","125",
"62 s","Visiting and Joining Family","2017 ","293","142","151",
"62 s","Visiting and Joining Family","2018 ","254","117","137",
"62 s","Visiting and Joining Family","2019 ","279","126","153",
"62 s","Overseas Koreans","2000 ","16","10","6",
"62 s","Overseas Koreans","2001 ","28","15","13",
"62 s","Overseas Koreans","2002 ","31","17","14",
"62 s","Overseas Koreans","2003 ","29","14","15",
"62 s","Overseas Koreans","2004 ","26","9","17",
"62 s","Overseas Koreans","2005 ","40","17","23",
"62 s","Overseas Koreans","2006 ","48","25","23",
"62 s","Overseas Koreans","2007 ","45","18","27",
"62 s","Overseas Koreans","2008 ","59","21","38",
"62 s","Overseas Koreans","2009 ","97","34","63",
"62 s","Overseas Koreans","2010 ","112","53","59",
"62 s","Overseas Koreans","2011 ","141","64","77",
"62 s","Overseas Koreans","2012 ","357","174","183",
"62 s","Overseas Koreans","2013 ","1207","605","602",
"62 s","Overseas Koreans","2014 ","2532","1298","1234",
"62 s","Overseas Koreans","2015 ","2491","1167","1324",
"62 s","Overseas Koreans","2016 ","2550","1209","1341",
"62 s","Overseas Koreans","2017 ","2545","1200","1345",
"62 s","Overseas Koreans","2018 ","2533","1230","1303",
"62 s","Overseas Koreans","2019 ","2530","1144","1386",
"62 s","Permanent Residence","2000 ","0","0","0",
"62 s","Permanent Residence","2001 ","0","0","0",
"62 s","Permanent Residence","2002 ","1","0","1",
"62 s","Permanent Residence","2003 ","1","0","1",
"62 s","Permanent Residence","2004 ","6","1","5",
"62 s","Permanent Residence","2005 ","7","5","2",
"62 s","Permanent Residence","2006 ","7","1","6",
"62 s","Permanent Residence","2007 ","7","1","6",
"62 s","Permanent Residence","2008 ","4","2","2",
"62 s","Permanent Residence","2009 ","6","2","4",
"62 s","Permanent Residence","2010 ","9","3","6",
"62 s","Permanent Residence","2011 ","16","8","8",
"62 s","Permanent Residence","2012 ","36","20","16",
"62 s","Permanent Residence","2013 ","55","29","26",
"62 s","Permanent Residence","2014 ","68","32","36",
"62 s","Permanent Residence","2015 ","71","35","36",
"62 s","Permanent Residence","2016 ","89","39","50",
"62 s","Permanent Residence","2017 ","111","46","65",
"62 s","Permanent Residence","2018 ","115","44","71",
"62 s","Permanent Residence","2019 ","133","56","77",
"62 s","Marriage Immigration","2011 ","3","2","1",
"62 s","Marriage Immigration","2012 ","28","8","20",
"62 s","Marriage Immigration","2013 ","21","10","11",
"62 s","Marriage Immigration","2014 ","33","21","12",
"62 s","Marriage Immigration","2015 ","20","9","11",
"62 s","Marriage Immigration","2016 ","17","7","10",
"62 s","Marriage Immigration","2017 ","34","14","20",
"62 s","Marriage Immigration","2018 ","26","9","17",
"62 s","Marriage Immigration","2019 ","28","15","13",
"63 s","Total","2000 ","826","452","374",
"63 s","Total","2001 ","720","418","302",
"63 s","Total","2002 ","512","313","199",
"63 s","Total","2003 ","429","237","192",
"63 s","Total","2004 ","483","262","221",
"63 s","Total","2005 ","1555","772","783",
"63 s","Total","2006 ","1232","652","580",
"63 s","Total","2007 ","1429","784","645",
"63 s","Total","2008 ","1612","862","750",
"63 s","Total","2009 ","1067","562","505",
"63 s","Total","2010 ","1529","754","775",
"63 s","Total","2011 ","1808","936","872",
"63 s","Total","2012 ","1888","892","996",
"63 s","Total","2013 ","2412","1218","1194",
"63 s","Total","2014 ","3314","1646","1668",
"63 s","Total","2015 ","3045","1456","1589",
"63 s","Total","2016 ","3276","1576","1700",
"63 s","Total","2017 ","3329","1577","1752",
"63 s","Total","2018 ","3421","1620","1801",
"63 s","Total","2019 ","3077","1437","1640",
"63 s","Sightseeing Pass","2000 ","73","33","40",
"63 s","Sightseeing Pass","2001 ","139","96","43",
"63 s","Sightseeing Pass","2002 ","104","70","34",
"63 s","Sightseeing Pass","2003 ","123","83","40",
"63 s","Sightseeing Pass","2004 ","125","82","43",
"63 s","Sightseeing Pass","2005 ","143","75","68",
"63 s","Sightseeing Pass","2006 ","94","58","36",
"63 s","Sightseeing Pass","2007 ","59","32","27",
"63 s","Sightseeing Pass","2008 ","58","36","22",
"63 s","Sightseeing Pass","2009 ","83","43","40",
"63 s","Sightseeing Pass","2010 ","135","61","74",
"63 s","Sightseeing Pass","2011 ","125","58","67",
"63 s","Sightseeing Pass","2012 ","130","65","65",
"63 s","Sightseeing Pass","2013 ","133","67","66",
"63 s","Sightseeing Pass","2014 ","89","46","43",
"63 s","Sightseeing Pass","2015 ","101","56","45",
"63 s","Sightseeing Pass","2016 ","125","56","69",
"63 s","Sightseeing Pass","2017 ","91","39","52",
"63 s","Sightseeing Pass","2018 ","129","68","61",
"63 s","Sightseeing Pass","2019 ","131","61","70",
"63 s","Short-term Business","2000 ","13","8","5",
"63 s","Short-term Business","2001 ","11","8","3",
"63 s","Short-term Business","2002 ","12","11","1",
"63 s","Short-term Business","2003 ","5","5","0",
"63 s","Short-term Business","2004 ","3","2","1",
"63 s","Short-term Business","2005 ","9","8","1",
"63 s","Short-term Business","2006 ","4","3","1",
"63 s","Short-term Business","2007 ","1","1","0",
"63 s","Short-term Business","2008 ","3","3","0",
"63 s","Short-term Business","2009 ","2","2","0",
"63 s","Short-term Business","2010 ","7","7","0",
"63 s","Short-term Business","2011 ","3","3","",
"63 s","Short-term Visitors","2000 ","465","236","229",
"63 s","Short-term Visitors","2001 ","314","158","156",
"63 s","Short-term Visitors","2002 ","185","92","93",
"63 s","Short-term Visitors","2003 ","129","58","71",
"63 s","Short-term Visitors","2004 ","118","52","66",
"63 s","Short-term Visitors","2005 ","989","454","535",
"63 s","Short-term Visitors","2006 ","749","371","378",
"63 s","Short-term Visitors","2007 ","332","154","178",
"63 s","Short-term Visitors","2008 ","93","31","62",
"63 s","Short-term Visitors","2009 ","157","41","116",
"63 s","Short-term Visitors","2010 ","198","54","144",
"63 s","Short-term Visitors","2011 ","260","98","162",
"63 s","Short-term Visitors","2012 ","231","87","144",
"63 s","Short-term Visitors","2013 ","394","161","233",
"63 s","Short-term Visitors","2014 ","344","135","209",
"63 s","Short-term Visitors","2015 ","309","136","173",
"63 s","Short-term Visitors","2016 ","357","160","197",
"63 s","Short-term Visitors","2017 ","291","127","164",
"63 s","Short-term Visitors","2018 ","294","126","168",
"63 s","Short-term Visitors","2019 ","273","127","146",
"63 s","Short-term Employment","2000 ","0","0","0",
"63 s","Short-term Employment","2001 ","0","0","0",
"63 s","Short-term Employment","2002 ","0","0","0",
"63 s","Short-term Employment","2003 ","1","1","0",
"63 s","Short-term Employment","2004 ","0","0","0",
"63 s","Short-term Employment","2005 ","1","1","0",
"63 s","Short-term Employment","2006 ","2","2","0",
"63 s","Short-term Employment","2007 ","0","0","0",
"63 s","Short-term Employment","2008 ","0","0","0",
"63 s","Short-term Employment","2009 ","0","0","0",
"63 s","Short-term Employment","2010 ","0","0","0",
"63 s","Job Seeking","2000 ","0","0","0",
"63 s","Job Seeking","2001 ","0","0","0",
"63 s","Job Seeking","2002 ","0","0","0",
"63 s","Job Seeking","2003 ","0","0","0",
"63 s","Job Seeking","2004 ","0","0","0",
"63 s","Job Seeking","2005 ","0","0","0",
"63 s","Job Seeking","2006 ","0","0","0",
"63 s","Job Seeking","2007 ","0","0","0",
"63 s","Job Seeking","2008 ","0","0","0",
"63 s","Job Seeking","2009 ","0","0","0",
"63 s","Job Seeking","2010 ","0","0","0",
"63 s","study","2000 ","0","0","0",
"63 s","study","2001 ","0","0","0",
"63 s","study","2002 ","0","0","0",
"63 s","study","2003 ","0","0","0",
"63 s","study","2004 ","0","0","0",
"63 s","study","2005 ","1","1","0",
"63 s","study","2006 ","0","0","0",
"63 s","study","2007 ","0","0","0",
"63 s","study","2008 ","0","0","0",
"63 s","study","2009 ","0","0","0",
"63 s","study","2010 ","0","0","0",
"63 s","study","2012 ","1","1","",
"63 s","study","2015 ","1","0","1",
"63 s","General Trainees","2000 ","0","0","0",
"63 s","General Trainees","2001 ","1","1","0",
"63 s","General Trainees","2002 ","1","1","0",
"63 s","General Trainees","2003 ","0","0","0",
"63 s","General Trainees","2004 ","0","0","0",
"63 s","General Trainees","2005 ","2","1","1",
"63 s","General Trainees","2006 ","0","0","0",
"63 s","General Trainees","2007 ","0","0","0",
"63 s","General Trainees","2008 ","2","0","2",
"63 s","General Trainees","2009 ","0","0","0",
"63 s","General Trainees","2010 ","0","0","0",
"63 s","General Trainees","2011 ","2","2","",
"63 s","General Trainees","2013 ","3","2","1",
"63 s","General Trainees","2014 ","2","0","2",
"63 s","General Trainees","2015 ","1","1","0",
"63 s","General Trainees","2017 ","1","0","1",
"63 s","Religious Activities","2000 ","2","0","2",
"63 s","Religious Activities","2001 ","1","0","1",
"63 s","Religious Activities","2002 ","4","1","3",
"63 s","Religious Activities","2003 ","5","4","1",
"63 s","Religious Activities","2004 ","3","3","0",
"63 s","Religious Activities","2005 ","3","2","1",
"63 s","Religious Activities","2006 ","3","3","0",
"63 s","Religious Activities","2007 ","2","0","2",
"63 s","Religious Activities","2008 ","1","1","0",
"63 s","Religious Activities","2009 ","2","1","1",
"63 s","Religious Activities","2010 ","1","0","1",
"63 s","Religious Activities","2011 ","8","2","6",
"63 s","Religious Activities","2012 ","2","","2",
"63 s","Religious Activities","2013 ","3","0","3",
"63 s","Religious Activities","2014 ","2","1","1",
"63 s","Religious Activities","2015 ","5","2","3",
"63 s","Religious Activities","2016 ","3","1","2",
"63 s","Religious Activities","2017 ","4","1","3",
"63 s","Religious Activities","2018 ","1","0","1",
"63 s","Religious Activities","2019 ","4","2","2",
"63 s","Investors","2000 ","2","2","0",
"63 s","Investors","2001 ","4","3","1",
"63 s","Investors","2002 ","9","9","0",
"63 s","Investors","2003 ","4","4","0",
"63 s","Investors","2004 ","4","3","1",
"63 s","Investors","2005 ","4","4","0",
"63 s","Investors","2006 ","1","1","0",
"63 s","Investors","2007 ","4","4","0",
"63 s","Investors","2008 ","2","2","0",
"63 s","Investors","2009 ","2","2","0",
"63 s","Investors","2010 ","2","2","0",
"63 s","Investors","2011 ","4","4","",
"63 s","Investors","2012 ","2","2","",
"63 s","Investors","2013 ","2","2","0",
"63 s","Investors","2014 ","2","2","0",
"63 s","Investors","2015 ","1","1","0",
"63 s","Investors","2016 ","6","6","0",
"63 s","Investors","2017 ","1","1","0",
"63 s","Investors","2019 ","1","1","0",
"63 s","Trade and Business","2000 ","5","5","0",
"63 s","Trade and Business","2001 ","1","1","0",
"63 s","Trade and Business","2002 ","4","4","0",
"63 s","Trade and Business","2003 ","2","2","0",
"63 s","Trade and Business","2004 ","3","3","0",
"63 s","Trade and Business","2005 ","4","4","0",
"63 s","Trade and Business","2006 ","7","7","0",
"63 s","Trade and Business","2007 ","5","5","0",
"63 s","Trade and Business","2008 ","10","10","0",
"63 s","Trade and Business","2009 ","11","11","0",
"63 s","Trade and Business","2010 ","10","10","0",
"63 s","Trade and Business","2011 ","16","16","",
"63 s","Trade and Business","2012 ","11","11","",
"63 s","Trade and Business","2013 ","19","18","1",
"63 s","Trade and Business","2014 ","15","15","0",
"63 s","Trade and Business","2015 ","9","9","0",
"63 s","Trade and Business","2016 ","13","13","0",
"63 s","Trade and Business","2017 ","9","9","0",
"63 s","Trade and Business","2018 ","10","10","0",
"63 s","Trade and Business","2019 ","8","7","1",
"63 s","Research","2000 ","3","3","0",
"63 s","Research","2001 ","2","2","0",
"63 s","Research","2002 ","3","3","0",
"63 s","Research","2003 ","3","3","0",
"63 s","Research","2004 ","3","3","0",
"63 s","Research","2005 ","5","5","0",
"63 s","Research","2006 ","1","1","0",
"63 s","Research","2007 ","0","0","0",
"63 s","Research","2008 ","1","1","0",
"63 s","Research","2009 ","1","1","0",
"63 s","Research","2010 ","2","2","0",
"63 s","Research","2012 ","1","1","",
"63 s","Research","2013 ","3","3","0",
"63 s","Research","2014 ","2","2","0",
"63 s","Research","2016 ","2","2","0",
"63 s","Research","2017 ","1","1","0",
"63 s","Research","2018 ","4","4","0",
"63 s","Art and Entertainment","2000 ","2","2","0",
"63 s","Art and Entertainment","2001 ","0","0","0",
"63 s","Art and Entertainment","2002 ","1","1","0",
"63 s","Art and Entertainment","2003 ","0","0","0",
"63 s","Art and Entertainment","2004 ","0","0","0",
"63 s","Art and Entertainment","2005 ","0","0","0",
"63 s","Art and Entertainment","2006 ","0","0","0",
"63 s","Art and Entertainment","2007 ","0","0","0",
"63 s","Art and Entertainment","2008 ","1","1","0",
"63 s","Art and Entertainment","2009 ","1","1","0",
"63 s","Art and Entertainment","2010 ","0","0","0",
"63 s","Art and Entertainment","2012 ","1","1","",
"63 s","Art and Entertainment","2013 ","2","2","0",
"63 s","Art and Entertainment","2014 ","1","1","0",
"63 s","Art and Entertainment","2016 ","1","0","1",
"63 s","Art and Entertainment","2017 ","3","3","0",
"63 s","Art and Entertainment","2018 ","1","1","0",
"63 s","Unskilled Employment","2000 ","0","0","0",
"63 s","Unskilled Employment","2001 ","0","0","0",
"63 s","Unskilled Employment","2002 ","0","0","0",
"63 s","Unskilled Employment","2003 ","0","0","0",
"63 s","Unskilled Employment","2004 ","3","0","3",
"63 s","Unskilled Employment","2005 ","1","1","0",
"63 s","Unskilled Employment","2006 ","0","0","0",
"63 s","Unskilled Employment","2007 ","2","2","0",
"63 s","Unskilled Employment","2008 ","0","0","0",
"63 s","Unskilled Employment","2009 ","0","0","0",
"63 s","Unskilled Employment","2010 ","0","0","0",
"63 s","Visiting and Joining Family","2000 ","157","99","58",
"63 s","Visiting and Joining Family","2001 ","135","87","48",
"63 s","Visiting and Joining Family","2002 ","84","51","33",
"63 s","Visiting and Joining Family","2003 ","74","41","33",
"63 s","Visiting and Joining Family","2004 ","107","51","56",
"63 s","Visiting and Joining Family","2005 ","222","120","102",
"63 s","Visiting and Joining Family","2006 ","239","140","99",
"63 s","Visiting and Joining Family","2007 ","89","59","30",
"63 s","Visiting and Joining Family","2008 ","43","19","24",
"63 s","Visiting and Joining Family","2009 ","20","9","11",
"63 s","Visiting and Joining Family","2010 ","17","7","10",
"63 s","Visiting and Joining Family","2011 ","45","23","22",
"63 s","Visiting and Joining Family","2012 ","235","97","138",
"63 s","Visiting and Joining Family","2013 ","132","46","86",
"63 s","Visiting and Joining Family","2014 ","120","50","70",
"63 s","Visiting and Joining Family","2015 ","148","50","98",
"63 s","Visiting and Joining Family","2016 ","217","109","108",
"63 s","Visiting and Joining Family","2017 ","252","133","119",
"63 s","Visiting and Joining Family","2018 ","189","93","96",
"63 s","Visiting and Joining Family","2019 ","225","99","126",
"63 s","Overseas Koreans","2000 ","20","9","11",
"63 s","Overseas Koreans","2001 ","29","12","17",
"63 s","Overseas Koreans","2002 ","31","16","15",
"63 s","Overseas Koreans","2003 ","25","9","16",
"63 s","Overseas Koreans","2004 ","44","22","22",
"63 s","Overseas Koreans","2005 ","52","24","28",
"63 s","Overseas Koreans","2006 ","58","26","32",
"63 s","Overseas Koreans","2007 ","32","11","21",
"63 s","Overseas Koreans","2008 ","50","15","35",
"63 s","Overseas Koreans","2009 ","65","25","40",
"63 s","Overseas Koreans","2010 ","123","63","60",
"63 s","Overseas Koreans","2011 ","219","101","118",
"63 s","Overseas Koreans","2012 ","426","212","214",
"63 s","Overseas Koreans","2013 ","1204","647","557",
"63 s","Overseas Koreans","2014 ","2186","1099","1087",
"63 s","Overseas Koreans","2015 ","2162","1036","1126",
"63 s","Overseas Koreans","2016 ","2311","1115","1196",
"63 s","Overseas Koreans","2017 ","2445","1152","1293",
"63 s","Overseas Koreans","2018 ","2567","1208","1359",
"63 s","Overseas Koreans","2019 ","2236","1055","1181",
"63 s","Permanent Residence","2000 ","0","0","0",
"63 s","Permanent Residence","2001 ","0","0","0",
"63 s","Permanent Residence","2002 ","1","0","1",
"63 s","Permanent Residence","2003 ","4","1","3",
"63 s","Permanent Residence","2004 ","8","6","2",
"63 s","Permanent Residence","2005 ","10","4","6",
"63 s","Permanent Residence","2006 ","3","1","2",
"63 s","Permanent Residence","2007 ","8","2","6",
"63 s","Permanent Residence","2008 ","8","4","4",
"63 s","Permanent Residence","2009 ","6","4","2",
"63 s","Permanent Residence","2010 ","10","5","5",
"63 s","Permanent Residence","2011 ","14","5","9",
"63 s","Permanent Residence","2012 ","26","15","11",
"63 s","Permanent Residence","2013 ","46","25","21",
"63 s","Permanent Residence","2014 ","60","29","31",
"63 s","Permanent Residence","2015 ","64","31","33",
"63 s","Permanent Residence","2016 ","74","36","38",
"63 s","Permanent Residence","2017 ","98","48","50",
"63 s","Permanent Residence","2018 ","111","52","59",
"63 s","Permanent Residence","2019 ","98","40","58",
"63 s","Marriage Immigration","2012 ","25","7","18",
"63 s","Marriage Immigration","2013 ","17","7","10",
"63 s","Marriage Immigration","2014 ","23","9","14",
"63 s","Marriage Immigration","2015 ","12","6","6",
"63 s","Marriage Immigration","2016 ","17","8","9",
"63 s","Marriage Immigration","2017 ","17","7","10",
"63 s","Marriage Immigration","2018 ","23","10","13",
"63 s","Marriage Immigration","2019 ","21","7","14",
"64 s","Total","2000 ","699","383","316",
"64 s","Total","2001 ","624","364","260",
"64 s","Total","2002 ","470","283","187",
"64 s","Total","2003 ","414","244","170",
"64 s","Total","2004 ","401","243","158",
"64 s","Total","2005 ","1355","662","693",
"64 s","Total","2006 ","1094","555","539",
"64 s","Total","2007 ","1265","624","641",
"64 s","Total","2008 ","1389","767","622",
"64 s","Total","2009 ","847","458","389",
"64 s","Total","2010 ","1210","646","564",
"64 s","Total","2011 ","1520","783","737",
"64 s","Total","2012 ","1619","809","810",
"64 s","Total","2013 ","2006","1056","950",
"64 s","Total","2014 ","2744","1347","1397",
"64 s","Total","2015 ","2588","1273","1315",
"64 s","Total","2016 ","2773","1324","1449",
"64 s","Total","2017 ","2748","1283","1465",
"64 s","Total","2018 ","3062","1433","1629",
"64 s","Total","2019 ","3003","1378","1625",
"64 s","Sightseeing Pass","2000 ","78","44","34",
"64 s","Sightseeing Pass","2001 ","114","76","38",
"64 s","Sightseeing Pass","2002 ","111","75","36",
"64 s","Sightseeing Pass","2003 ","114","79","35",
"64 s","Sightseeing Pass","2004 ","105","67","38",
"64 s","Sightseeing Pass","2005 ","106","63","43",
"64 s","Sightseeing Pass","2006 ","92","54","38",
"64 s","Sightseeing Pass","2007 ","56","33","23",
"64 s","Sightseeing Pass","2008 ","67","32","35",
"64 s","Sightseeing Pass","2009 ","65","33","32",
"64 s","Sightseeing Pass","2010 ","87","39","48",
"64 s","Sightseeing Pass","2011 ","124","54","70",
"64 s","Sightseeing Pass","2012 ","128","56","72",
"64 s","Sightseeing Pass","2013 ","114","54","60",
"64 s","Sightseeing Pass","2014 ","95","40","55",
"64 s","Sightseeing Pass","2015 ","69","34","35",
"64 s","Sightseeing Pass","2016 ","117","46","71",
"64 s","Sightseeing Pass","2017 ","82","38","44",
"64 s","Sightseeing Pass","2018 ","94","46","48",
"64 s","Sightseeing Pass","2019 ","110","57","53",
"64 s","Short-term Business","2000 ","6","4","2",
"64 s","Short-term Business","2001 ","12","9","3",
"64 s","Short-term Business","2002 ","9","9","0",
"64 s","Short-term Business","2003 ","5","5","0",
"64 s","Short-term Business","2004 ","6","4","2",
"64 s","Short-term Business","2005 ","10","7","3",
"64 s","Short-term Business","2006 ","13","9","4",
"64 s","Short-term Business","2007 ","9","9","0",
"64 s","Short-term Business","2008 ","2","2","0",
"64 s","Short-term Business","2009 ","3","3","0",
"64 s","Short-term Business","2010 ","3","3","0",
"64 s","Short-term Business","2011 ","4","4","",
"64 s","Short-term Visitors","2000 ","373","192","181",
"64 s","Short-term Visitors","2001 ","268","130","138",
"64 s","Short-term Visitors","2002 ","185","94","91",
"64 s","Short-term Visitors","2003 ","110","55","55",
"64 s","Short-term Visitors","2004 ","101","55","46",
"64 s","Short-term Visitors","2005 ","954","432","522",
"64 s","Short-term Visitors","2006 ","663","307","356",
"64 s","Short-term Visitors","2007 ","298","119","179",
"64 s","Short-term Visitors","2008 ","95","37","58",
"64 s","Short-term Visitors","2009 ","201","79","122",
"64 s","Short-term Visitors","2010 ","196","70","126",
"64 s","Short-term Visitors","2011 ","223","92","131",
"64 s","Short-term Visitors","2012 ","192","85","107",
"64 s","Short-term Visitors","2013 ","251","120","131",
"64 s","Short-term Visitors","2014 ","296","115","181",
"64 s","Short-term Visitors","2015 ","237","94","143",
"64 s","Short-term Visitors","2016 ","307","138","169",
"64 s","Short-term Visitors","2017 ","225","100","125",
"64 s","Short-term Visitors","2018 ","243","88","155",
"64 s","Short-term Visitors","2019 ","248","91","157",
"64 s","Short-term Employment","2000 ","0","0","0",
"64 s","Short-term Employment","2001 ","0","0","0",
"64 s","Short-term Employment","2002 ","0","0","0",
"64 s","Short-term Employment","2003 ","1","0","1",
"64 s","Short-term Employment","2004 ","0","0","0",
"64 s","Short-term Employment","2005 ","0","0","0",
"64 s","Short-term Employment","2006 ","0","0","0",
"64 s","Short-term Employment","2007 ","1","1","0",
"64 s","Short-term Employment","2008 ","0","0","0",
"64 s","Short-term Employment","2009 ","0","0","0",
"64 s","Short-term Employment","2010 ","0","0","0",
"64 s","Short-term Employment","2016 ","1","1","0",
"64 s","Job Seeking","2000 ","0","0","0",
"64 s","Job Seeking","2001 ","0","0","0",
"64 s","Job Seeking","2002 ","0","0","0",
"64 s","Job Seeking","2003 ","0","0","0",
"64 s","Job Seeking","2004 ","0","0","0",
"64 s","Job Seeking","2005 ","0","0","0",
"64 s","Job Seeking","2006 ","0","0","0",
"64 s","Job Seeking","2007 ","0","0","0",
"64 s","Job Seeking","2008 ","0","0","0",
"64 s","Job Seeking","2009 ","0","0","0",
"64 s","Job Seeking","2010 ","0","0","0",
"64 s","study","2000 ","0","0","0",
"64 s","study","2001 ","0","0","0",
"64 s","study","2002 ","0","0","0",
"64 s","study","2003 ","0","0","0",
"64 s","study","2004 ","0","0","0",
"64 s","study","2005 ","0","0","0",
"64 s","study","2006 ","0","0","0",
"64 s","study","2007 ","0","0","0",
"64 s","study","2008 ","1","1","0",
"64 s","study","2009 ","0","0","0",
"64 s","study","2010 ","1","1","0",
"64 s","study","2016 ","1","0","1",
"64 s","General Trainees","2000 ","0","0","0",
"64 s","General Trainees","2001 ","0","0","0",
"64 s","General Trainees","2002 ","0","0","0",
"64 s","General Trainees","2003 ","0","0","0",
"64 s","General Trainees","2004 ","1","1","0",
"64 s","General Trainees","2005 ","1","1","0",
"64 s","General Trainees","2006 ","0","0","0",
"64 s","General Trainees","2007 ","0","0","0",
"64 s","General Trainees","2008 ","0","0","0",
"64 s","General Trainees","2009 ","1","0","1",
"64 s","General Trainees","2010 ","0","0","0",
"64 s","General Trainees","2014 ","2","1","1",
"64 s","General Trainees","2015 ","1","0","1",
"64 s","Religious Activities","2000 ","5","1","4",
"64 s","Religious Activities","2001 ","3","3","0",
"64 s","Religious Activities","2002 ","4","3","1",
"64 s","Religious Activities","2003 ","4","2","2",
"64 s","Religious Activities","2004 ","0","0","0",
"64 s","Religious Activities","2005 ","5","4","1",
"64 s","Religious Activities","2006 ","2","1","1",
"64 s","Religious Activities","2007 ","4","2","2",
"64 s","Religious Activities","2008 ","2","0","2",
"64 s","Religious Activities","2009 ","1","0","1",
"64 s","Religious Activities","2010 ","4","4","0",
"64 s","Religious Activities","2011 ","5","1","4",
"64 s","Religious Activities","2012 ","4","2","2",
"64 s","Religious Activities","2015 ","5","3","2",
"64 s","Religious Activities","2016 ","2","0","2",
"64 s","Religious Activities","2017 ","2","2","0",
"64 s","Religious Activities","2018 ","6","3","3",
"64 s","Religious Activities","2019 ","1","0","1",
"64 s","Investors","2000 ","1","1","0",
"64 s","Investors","2001 ","2","2","0",
"64 s","Investors","2002 ","5","5","0",
"64 s","Investors","2003 ","2","2","0",
"64 s","Investors","2004 ","2","2","0",
"64 s","Investors","2005 ","4","4","0",
"64 s","Investors","2006 ","4","4","0",
"64 s","Investors","2007 ","2","2","0",
"64 s","Investors","2008 ","0","0","0",
"64 s","Investors","2009 ","1","1","0",
"64 s","Investors","2010 ","2","2","0",
"64 s","Investors","2011 ","1","1","",
"64 s","Investors","2012 ","3","3","",
"64 s","Investors","2013 ","1","1","0",
"64 s","Investors","2014 ","4","4","0",
"64 s","Investors","2015 ","3","3","0",
"64 s","Investors","2016 ","3","3","0",
"64 s","Investors","2017 ","2","2","0",
"64 s","Investors","2018 ","1","1","0",
"64 s","Investors","2019 ","1","0","1",
"64 s","Trade and Business","2000 ","3","3","0",
"64 s","Trade and Business","2001 ","2","2","0",
"64 s","Trade and Business","2002 ","4","4","0",
"64 s","Trade and Business","2003 ","5","5","0",
"64 s","Trade and Business","2004 ","4","4","0",
"64 s","Trade and Business","2005 ","3","3","0",
"64 s","Trade and Business","2006 ","4","4","0",
"64 s","Trade and Business","2007 ","2","2","0",
"64 s","Trade and Business","2008 ","1","1","0",
"64 s","Trade and Business","2009 ","10","10","0",
"64 s","Trade and Business","2010 ","9","9","0",
"64 s","Trade and Business","2011 ","7","7","",
"64 s","Trade and Business","2012 ","15","15","",
"64 s","Trade and Business","2013 ","18","18","0",
"64 s","Trade and Business","2014 ","12","12","0",
"64 s","Trade and Business","2015 ","11","10","1",
"64 s","Trade and Business","2016 ","10","10","0",
"64 s","Trade and Business","2017 ","5","5","0",
"64 s","Trade and Business","2018 ","5","5","0",
"64 s","Trade and Business","2019 ","3","2","1",
"64 s","Research","2000 ","5","5","0",
"64 s","Research","2001 ","4","3","1",
"64 s","Research","2002 ","2","2","0",
"64 s","Research","2003 ","1","1","0",
"64 s","Research","2004 ","1","0","1",
"64 s","Research","2005 ","0","0","0",
"64 s","Research","2006 ","1","1","0",
"64 s","Research","2007 ","0","0","0",
"64 s","Research","2008 ","0","0","0",
"64 s","Research","2009 ","0","0","0",
"64 s","Research","2010 ","2","2","0",
"64 s","Research","2011 ","1","1","",
"64 s","Research","2012 ","1","1","",
"64 s","Research","2014 ","2","2","0",
"64 s","Research","2016 ","1","1","0",
"64 s","Research","2018 ","2","2","0",
"64 s","Art and Entertainment","2000 ","0","0","0",
"64 s","Art and Entertainment","2001 ","1","1","0",
"64 s","Art and Entertainment","2002 ","1","1","0",
"64 s","Art and Entertainment","2003 ","0","0","0",
"64 s","Art and Entertainment","2004 ","0","0","0",
"64 s","Art and Entertainment","2005 ","0","0","0",
"64 s","Art and Entertainment","2006 ","0","0","0",
"64 s","Art and Entertainment","2007 ","1","1","0",
"64 s","Art and Entertainment","2008 ","1","1","0",
"64 s","Art and Entertainment","2009 ","1","1","0",
"64 s","Art and Entertainment","2010 ","0","0","0",
"64 s","Art and Entertainment","2012 ","1","1","",
"64 s","Art and Entertainment","2014 ","2","1","1",
"64 s","Art and Entertainment","2016 ","1","1","0",
"64 s","Art and Entertainment","2018 ","1","1","0",
"64 s","Art and Entertainment","2019 ","1","1","0",
"64 s","Unskilled Employment","2000 ","0","0","0",
"64 s","Unskilled Employment","2001 ","0","0","0",
"64 s","Unskilled Employment","2002 ","0","0","0",
"64 s","Unskilled Employment","2003 ","0","0","0",
"64 s","Unskilled Employment","2004 ","3","2","1",
"64 s","Unskilled Employment","2005 ","0","0","0",
"64 s","Unskilled Employment","2006 ","0","0","0",
"64 s","Unskilled Employment","2007 ","3","1","2",
"64 s","Unskilled Employment","2008 ","0","0","0",
"64 s","Unskilled Employment","2009 ","0","0","0",
"64 s","Unskilled Employment","2010 ","0","0","0",
"64 s","Visiting and Joining Family","2000 ","153","94","59",
"64 s","Visiting and Joining Family","2001 ","137","87","50",
"64 s","Visiting and Joining Family","2002 ","56","35","21",
"64 s","Visiting and Joining Family","2003 ","68","34","34",
"64 s","Visiting and Joining Family","2004 ","79","41","38",
"64 s","Visiting and Joining Family","2005 ","145","80","65",
"64 s","Visiting and Joining Family","2006 ","202","116","86",
"64 s","Visiting and Joining Family","2007 ","82","43","39",
"64 s","Visiting and Joining Family","2008 ","37","28","9",
"64 s","Visiting and Joining Family","2009 ","11","4","7",
"64 s","Visiting and Joining Family","2010 ","18","8","10",
"64 s","Visiting and Joining Family","2011 ","49","25","24",
"64 s","Visiting and Joining Family","2012 ","211","76","135",
"64 s","Visiting and Joining Family","2013 ","255","99","156",
"64 s","Visiting and Joining Family","2014 ","106","44","62",
"64 s","Visiting and Joining Family","2015 ","133","68","65",
"64 s","Visiting and Joining Family","2016 ","170","69","101",
"64 s","Visiting and Joining Family","2017 ","189","80","109",
"64 s","Visiting and Joining Family","2018 ","182","90","92",
"64 s","Visiting and Joining Family","2019 ","181","96","85",
"64 s","Overseas Koreans","2000 ","21","12","9",
"64 s","Overseas Koreans","2001 ","22","11","11",
"64 s","Overseas Koreans","2002 ","21","11","10",
"64 s","Overseas Koreans","2003 ","39","21","18",
"64 s","Overseas Koreans","2004 ","32","17","15",
"64 s","Overseas Koreans","2005 ","30","16","14",
"64 s","Overseas Koreans","2006 ","49","25","24",
"64 s","Overseas Koreans","2007 ","52","22","30",
"64 s","Overseas Koreans","2008 ","54","25","29",
"64 s","Overseas Koreans","2009 ","62","32","30",
"64 s","Overseas Koreans","2010 ","98","43","55",
"64 s","Overseas Koreans","2011 ","228","102","126",
"64 s","Overseas Koreans","2012 ","485","230","255",
"64 s","Overseas Koreans","2013 ","1065","598","467",
"64 s","Overseas Koreans","2014 ","1850","926","924",
"64 s","Overseas Koreans","2015 ","1875","922","953",
"64 s","Overseas Koreans","2016 ","1958","952","1006",
"64 s","Overseas Koreans","2017 ","2099","990","1109",
"64 s","Overseas Koreans","2018 ","2350","1119","1231",
"64 s","Overseas Koreans","2019 ","2265","1037","1228",
"64 s","Permanent Residence","2000 ","0","0","0",
"64 s","Permanent Residence","2001 ","0","0","0",
"64 s","Permanent Residence","2002 ","0","0","0",
"64 s","Permanent Residence","2003 ","7","3","4",
"64 s","Permanent Residence","2004 ","3","1","2",
"64 s","Permanent Residence","2005 ","10","3","7",
"64 s","Permanent Residence","2006 ","2","1","1",
"64 s","Permanent Residence","2007 ","8","4","4",
"64 s","Permanent Residence","2008 ","6","0","6",
"64 s","Permanent Residence","2009 ","5","2","3",
"64 s","Permanent Residence","2010 ","9","4","5",
"64 s","Permanent Residence","2011 ","10","4","6",
"64 s","Permanent Residence","2012 ","14","6","8",
"64 s","Permanent Residence","2013 ","38","21","17",
"64 s","Permanent Residence","2014 ","53","25","28",
"64 s","Permanent Residence","2015 ","59","29","30",
"64 s","Permanent Residence","2016 ","68","31","37",
"64 s","Permanent Residence","2017 ","63","31","32",
"64 s","Permanent Residence","2018 ","97","46","51",
"64 s","Permanent Residence","2019 ","108","51","57",
"64 s","Marriage Immigration","2011 ","1","1","",
"64 s","Marriage Immigration","2012 ","20","11","9",
"64 s","Marriage Immigration","2013 ","19","11","8",
"64 s","Marriage Immigration","2014 ","23","12","11",
"64 s","Marriage Immigration","2015 ","17","7","10",
"64 s","Marriage Immigration","2016 ","19","10","9",
"64 s","Marriage Immigration","2017 ","13","4","9",
"64 s","Marriage Immigration","2018 ","17","7","10",
"64 s","Marriage Immigration","2019 ","23","16","7",
"65 s","Total","2000 ","577","318","259",
"65 s","Total","2001 ","547","306","241",
"65 s","Total","2002 ","589","342","247",
"65 s","Total","2003 ","1061","548","513",
"65 s","Total","2004 ","1082","519","563",
"65 s","Total","2005 ","1327","650","677",
"65 s","Total","2006 ","920","470","450",
"65 s","Total","2007 ","1093","545","548",
"65 s","Total","2008 ","1181","598","583",
"65 s","Total","2009 ","815","441","374",
"65 s","Total","2010 ","934","495","439",
"65 s","Total","2011 ","1134","594","540",
"65 s","Total","2012 ","1434","702","732",
"65 s","Total","2013 ","1556","774","782",
"65 s","Total","2014 ","2129","1075","1054",
"65 s","Total","2015 ","2428","1132","1296",
"65 s","Total","2016 ","2451","1154","1297",
"65 s","Total","2017 ","2463","1152","1311",
"65 s","Total","2018 ","2774","1312","1462",
"65 s","Total","2019 ","2901","1330","1571",
"65 s","Sightseeing Pass","2000 ","69","45","24",
"65 s","Sightseeing Pass","2001 ","87","60","27",
"65 s","Sightseeing Pass","2002 ","105","77","28",
"65 s","Sightseeing Pass","2003 ","93","59","34",
"65 s","Sightseeing Pass","2004 ","91","57","34",
"65 s","Sightseeing Pass","2005 ","109","63","46",
"65 s","Sightseeing Pass","2006 ","80","42","38",
"65 s","Sightseeing Pass","2007 ","47","19","28",
"65 s","Sightseeing Pass","2008 ","56","24","32",
"65 s","Sightseeing Pass","2009 ","80","36","44",
"65 s","Sightseeing Pass","2010 ","84","41","43",
"65 s","Sightseeing Pass","2011 ","95","38","57",
"65 s","Sightseeing Pass","2012 ","119","62","57",
"65 s","Sightseeing Pass","2013 ","121","57","64",
"65 s","Sightseeing Pass","2014 ","84","42","42",
"65 s","Sightseeing Pass","2015 ","88","37","51",
"65 s","Sightseeing Pass","2016 ","86","42","44",
"65 s","Sightseeing Pass","2017 ","77","43","34",
"65 s","Sightseeing Pass","2018 ","109","49","60",
"65 s","Sightseeing Pass","2019 ","105","48","57",
"65 s","Short-term Business","2000 ","8","8","0",
"65 s","Short-term Business","2001 ","3","3","0",
"65 s","Short-term Business","2002 ","5","5","0",
"65 s","Short-term Business","2003 ","12","10","2",
"65 s","Short-term Business","2004 ","4","1","3",
"65 s","Short-term Business","2005 ","10","7","3",
"65 s","Short-term Business","2006 ","5","3","2",
"65 s","Short-term Business","2007 ","4","4","0",
"65 s","Short-term Business","2008 ","4","3","1",
"65 s","Short-term Business","2009 ","1","1","0",
"65 s","Short-term Business","2010 ","2","2","0",
"65 s","Short-term Business","2011 ","4","4","",
"65 s","Short-term Visitors","2000 ","324","152","172",
"65 s","Short-term Visitors","2001 ","237","115","122",
"65 s","Short-term Visitors","2002 ","304","145","159",
"65 s","Short-term Visitors","2003 ","808","395","413",
"65 s","Short-term Visitors","2004 ","801","354","447",
"65 s","Short-term Visitors","2005 ","941","426","515",
"65 s","Short-term Visitors","2006 ","576","267","309",
"65 s","Short-term Visitors","2007 ","294","118","176",
"65 s","Short-term Visitors","2008 ","85","31","54",
"65 s","Short-term Visitors","2009 ","185","80","105",
"65 s","Short-term Visitors","2010 ","189","80","109",
"65 s","Short-term Visitors","2011 ","187","67","120",
"65 s","Short-term Visitors","2012 ","167","61","106",
"65 s","Short-term Visitors","2013 ","165","74","91",
"65 s","Short-term Visitors","2014 ","214","90","124",
"65 s","Short-term Visitors","2015 ","248","92","156",
"65 s","Short-term Visitors","2016 ","227","95","132",
"65 s","Short-term Visitors","2017 ","167","74","93",
"65 s","Short-term Visitors","2018 ","189","72","117",
"65 s","Short-term Visitors","2019 ","212","92","120",
"65 s","Short-term Employment","2000 ","0","0","0",
"65 s","Short-term Employment","2001 ","1","1","0",
"65 s","Short-term Employment","2002 ","0","0","0",
"65 s","Short-term Employment","2003 ","0","0","0",
"65 s","Short-term Employment","2004 ","0","0","0",
"65 s","Short-term Employment","2005 ","1","1","0",
"65 s","Short-term Employment","2006 ","0","0","0",
"65 s","Short-term Employment","2007 ","0","0","0",
"65 s","Short-term Employment","2008 ","0","0","0",
"65 s","Short-term Employment","2009 ","0","0","0",
"65 s","Short-term Employment","2010 ","1","1","0",
"65 s","Job Seeking","2000 ","0","0","0",
"65 s","Job Seeking","2001 ","0","0","0",
"65 s","Job Seeking","2002 ","0","0","0",
"65 s","Job Seeking","2003 ","0","0","0",
"65 s","Job Seeking","2004 ","0","0","0",
"65 s","Job Seeking","2005 ","0","0","0",
"65 s","Job Seeking","2006 ","0","0","0",
"65 s","Job Seeking","2007 ","0","0","0",
"65 s","Job Seeking","2008 ","0","0","0",
"65 s","Job Seeking","2009 ","0","0","0",
"65 s","Job Seeking","2010 ","0","0","0",
"65 s","study","2000 ","0","0","0",
"65 s","study","2001 ","0","0","0",
"65 s","study","2002 ","0","0","0",
"65 s","study","2003 ","0","0","0",
"65 s","study","2004 ","0","0","0",
"65 s","study","2005 ","0","0","0",
"65 s","study","2006 ","0","0","0",
"65 s","study","2007 ","0","0","0",
"65 s","study","2008 ","0","0","0",
"65 s","study","2009 ","0","0","0",
"65 s","study","2010 ","0","0","0",
"65 s","General Trainees","2000 ","0","0","0",
"65 s","General Trainees","2001 ","0","0","0",
"65 s","General Trainees","2002 ","0","0","0",
"65 s","General Trainees","2003 ","1","1","0",
"65 s","General Trainees","2004 ","0","0","0",
"65 s","General Trainees","2005 ","0","0","0",
"65 s","General Trainees","2006 ","0","0","0",
"65 s","General Trainees","2007 ","0","0","0",
"65 s","General Trainees","2008 ","0","0","0",
"65 s","General Trainees","2009 ","1","1","0",
"65 s","General Trainees","2010 ","0","0","0",
"65 s","General Trainees","2011 ","1","1","",
"65 s","General Trainees","2013 ","2","1","1",
"65 s","General Trainees","2015 ","1","0","1",
"65 s","General Trainees","2018 ","1","0","1",
"65 s","General Trainees","2019 ","1","1","0",
"65 s","Religious Activities","2000 ","4","4","0",
"65 s","Religious Activities","2001 ","5","2","3",
"65 s","Religious Activities","2002 ","5","4","1",
"65 s","Religious Activities","2003 ","3","3","0",
"65 s","Religious Activities","2004 ","1","0","1",
"65 s","Religious Activities","2005 ","5","2","3",
"65 s","Religious Activities","2006 ","0","0","0",
"65 s","Religious Activities","2007 ","2","1","1",
"65 s","Religious Activities","2008 ","8","6","2",
"65 s","Religious Activities","2009 ","6","2","4",
"65 s","Religious Activities","2010 ","4","1","3",
"65 s","Religious Activities","2012 ","1","1","",
"65 s","Religious Activities","2013 ","3","1","2",
"65 s","Religious Activities","2014 ","2","1","1",
"65 s","Religious Activities","2015 ","3","1","2",
"65 s","Religious Activities","2016 ","3","2","1",
"65 s","Religious Activities","2017 ","1","1","0",
"65 s","Religious Activities","2018 ","2","2","0",
"65 s","Religious Activities","2019 ","2","1","1",
"65 s","Investors","2000 ","3","2","1",
"65 s","Investors","2001 ","0","0","0",
"65 s","Investors","2002 ","4","4","0",
"65 s","Investors","2003 ","3","3","0",
"65 s","Investors","2004 ","3","3","0",
"65 s","Investors","2005 ","4","4","0",
"65 s","Investors","2006 ","1","1","0",
"65 s","Investors","2007 ","2","1","1",
"65 s","Investors","2008 ","0","0","0",
"65 s","Investors","2009 ","2","2","0",
"65 s","Investors","2010 ","1","1","0",
"65 s","Investors","2014 ","3","3","0",
"65 s","Investors","2015 ","3","2","1",
"65 s","Investors","2016 ","1","1","0",
"65 s","Investors","2018 ","2","2","0",
"65 s","Investors","2019 ","2","2","0",
"65 s","Trade and Business","2000 ","0","0","0",
"65 s","Trade and Business","2001 ","3","3","0",
"65 s","Trade and Business","2002 ","5","5","0",
"65 s","Trade and Business","2003 ","3","3","0",
"65 s","Trade and Business","2004 ","2","2","0",
"65 s","Trade and Business","2005 ","3","3","0",
"65 s","Trade and Business","2006 ","1","1","0",
"65 s","Trade and Business","2007 ","3","3","0",
"65 s","Trade and Business","2008 ","2","2","0",
"65 s","Trade and Business","2009 ","4","4","0",
"65 s","Trade and Business","2010 ","6","6","0",
"65 s","Trade and Business","2011 ","8","7","1",
"65 s","Trade and Business","2012 ","9","9","",
"65 s","Trade and Business","2013 ","11","11","0",
"65 s","Trade and Business","2014 ","11","11","0",
"65 s","Trade and Business","2015 ","5","5","0",
"65 s","Trade and Business","2016 ","2","2","0",
"65 s","Trade and Business","2017 ","3","3","0",
"65 s","Trade and Business","2018 ","2","2","0",
"65 s","Trade and Business","2019 ","5","5","0",
"65 s","Research","2000 ","3","3","0",
"65 s","Research","2001 ","0","0","0",
"65 s","Research","2002 ","6","6","0",
"65 s","Research","2003 ","2","2","0",
"65 s","Research","2004 ","0","0","0",
"65 s","Research","2005 ","0","0","0",
"65 s","Research","2006 ","0","0","0",
"65 s","Research","2007 ","2","2","0",
"65 s","Research","2008 ","0","0","0",
"65 s","Research","2009 ","0","0","0",
"65 s","Research","2010 ","0","0","0",
"65 s","Research","2011 ","1","1","",
"65 s","Research","2013 ","2","2","0",
"65 s","Research","2014 ","1","1","0",
"65 s","Research","2015 ","2","1","1",
"65 s","Research","2018 ","1","1","0",
"65 s","Art and Entertainment","2000 ","0","0","0",
"65 s","Art and Entertainment","2001 ","1","1","0",
"65 s","Art and Entertainment","2002 ","0","0","0",
"65 s","Art and Entertainment","2003 ","0","0","0",
"65 s","Art and Entertainment","2004 ","0","0","0",
"65 s","Art and Entertainment","2005 ","0","0","0",
"65 s","Art and Entertainment","2006 ","0","0","0",
"65 s","Art and Entertainment","2007 ","0","0","0",
"65 s","Art and Entertainment","2008 ","0","0","0",
"65 s","Art and Entertainment","2009 ","0","0","0",
"65 s","Art and Entertainment","2010 ","0","0","0",
"65 s","Art and Entertainment","2018 ","1","0","1",
"65 s","Unskilled Employment","2000 ","0","0","0",
"65 s","Unskilled Employment","2001 ","0","0","0",
"65 s","Unskilled Employment","2002 ","0","0","0",
"65 s","Unskilled Employment","2003 ","0","0","0",
"65 s","Unskilled Employment","2004 ","6","5","1",
"65 s","Unskilled Employment","2005 ","0","0","0",
"65 s","Unskilled Employment","2006 ","0","0","0",
"65 s","Unskilled Employment","2007 ","0","0","0",
"65 s","Unskilled Employment","2008 ","0","0","0",
"65 s","Unskilled Employment","2009 ","0","0","0",
"65 s","Unskilled Employment","2010 ","0","0","0",
"65 s","Visiting and Joining Family","2000 ","115","76","39",
"65 s","Visiting and Joining Family","2001 ","139","83","56",
"65 s","Visiting and Joining Family","2002 ","73","46","27",
"65 s","Visiting and Joining Family","2003 ","50","30","20",
"65 s","Visiting and Joining Family","2004 ","66","37","29",
"65 s","Visiting and Joining Family","2005 ","138","83","55",
"65 s","Visiting and Joining Family","2006 ","155","99","56",
"65 s","Visiting and Joining Family","2007 ","81","51","30",
"65 s","Visiting and Joining Family","2008 ","41","15","26",
"65 s","Visiting and Joining Family","2009 ","23","11","12",
"65 s","Visiting and Joining Family","2010 ","13","6","7",
"65 s","Visiting and Joining Family","2011 ","54","18","36",
"65 s","Visiting and Joining Family","2012 ","202","85","117",
"65 s","Visiting and Joining Family","2013 ","195","72","123",
"65 s","Visiting and Joining Family","2014 ","100","44","56",
"65 s","Visiting and Joining Family","2015 ","112","45","67",
"65 s","Visiting and Joining Family","2016 ","138","58","80",
"65 s","Visiting and Joining Family","2017 ","136","63","73",
"65 s","Visiting and Joining Family","2018 ","131","65","66",
"65 s","Visiting and Joining Family","2019 ","142","64","78",
"65 s","Overseas Koreans","2000 ","12","8","4",
"65 s","Overseas Koreans","2001 ","15","8","7",
"65 s","Overseas Koreans","2002 ","32","17","15",
"65 s","Overseas Koreans","2003 ","26","10","16",
"65 s","Overseas Koreans","2004 ","45","25","20",
"65 s","Overseas Koreans","2005 ","35","20","15",
"65 s","Overseas Koreans","2006 ","46","22","24",
"65 s","Overseas Koreans","2007 ","49","19","30",
"65 s","Overseas Koreans","2008 ","63","31","32",
"65 s","Overseas Koreans","2009 ","52","31","21",
"65 s","Overseas Koreans","2010 ","83","38","45",
"65 s","Overseas Koreans","2011 ","190","93","97",
"65 s","Overseas Koreans","2012 ","480","232","248",
"65 s","Overseas Koreans","2013 ","859","454","405",
"65 s","Overseas Koreans","2014 ","1534","790","744",
"65 s","Overseas Koreans","2015 ","1752","835","917",
"65 s","Overseas Koreans","2016 ","1798","856","942",
"65 s","Overseas Koreans","2017 ","1932","897","1035",
"65 s","Overseas Koreans","2018 ","2188","1052","1136",
"65 s","Overseas Koreans","2019 ","2259","1033","1226",
"65 s","Permanent Residence","2000 ","0","0","0",
"65 s","Permanent Residence","2001 ","0","0","0",
"65 s","Permanent Residence","2002 ","0","0","0",
"65 s","Permanent Residence","2003 ","3","1","2",
"65 s","Permanent Residence","2004 ","7","6","1",
"65 s","Permanent Residence","2005 ","9","3","6",
"65 s","Permanent Residence","2006 ","6","2","4",
"65 s","Permanent Residence","2007 ","5","1","4",
"65 s","Permanent Residence","2008 ","6","2","4",
"65 s","Permanent Residence","2009 ","6","2","4",
"65 s","Permanent Residence","2010 ","8","3","5",
"65 s","Permanent Residence","2011 ","13","9","4",
"65 s","Permanent Residence","2012 ","19","12","7",
"65 s","Permanent Residence","2013 ","36","15","21",
"65 s","Permanent Residence","2014 ","54","32","22",
"65 s","Permanent Residence","2015 ","77","38","39",
"65 s","Permanent Residence","2016 ","69","35","34",
"65 s","Permanent Residence","2017 ","75","36","39",
"65 s","Permanent Residence","2018 ","80","42","38",
"65 s","Permanent Residence","2019 ","99","52","47",
"65 s","Marriage Immigration","2012 ","18","8","10",
"65 s","Marriage Immigration","2013 ","11","6","5",
"65 s","Marriage Immigration","2014 ","21","10","11",
"65 s","Marriage Immigration","2015 ","26","17","9",
"65 s","Marriage Immigration","2016 ","19","8","11",
"65 s","Marriage Immigration","2017 ","12","9","3",
"65 s","Marriage Immigration","2018 ","17","9","8",
"65 s","Marriage Immigration","2019 ","18","8","10",
"66 s","Total","2000 ","536","284","252",
"66 s","Total","2001 ","443","255","188",
"66 s","Total","2002 ","511","291","220",
"66 s","Total","2003 ","872","451","421",
"66 s","Total","2004 ","766","368","398",
"66 s","Total","2005 ","1021","523","498",
"66 s","Total","2006 ","805","391","414",
"66 s","Total","2007 ","929","481","448",
"66 s","Total","2008 ","1083","573","510",
"66 s","Total","2009 ","704","372","332",
"66 s","Total","2010 ","763","399","364",
"66 s","Total","2011 ","830","432","398",
"66 s","Total","2012 ","1077","540","537",
"66 s","Total","2013 ","1403","689","714",
"66 s","Total","2014 ","1585","776","809",
"66 s","Total","2015 ","1952","891","1061",
"66 s","Total","2016 ","2348","1114","1234",
"66 s","Total","2017 ","2218","1036","1182",
"66 s","Total","2018 ","2445","1082","1363",
"66 s","Total","2019 ","2377","1076","1301",
"66 s","Sightseeing Pass","2000 ","66","32","34",
"66 s","Sightseeing Pass","2001 ","102","65","37",
"66 s","Sightseeing Pass","2002 ","82","57","25",
"66 s","Sightseeing Pass","2003 ","89","55","34",
"66 s","Sightseeing Pass","2004 ","93","53","40",
"66 s","Sightseeing Pass","2005 ","94","61","33",
"66 s","Sightseeing Pass","2006 ","71","38","33",
"66 s","Sightseeing Pass","2007 ","42","25","17",
"66 s","Sightseeing Pass","2008 ","63","40","23",
"66 s","Sightseeing Pass","2009 ","56","29","27",
"66 s","Sightseeing Pass","2010 ","109","54","55",
"66 s","Sightseeing Pass","2011 ","94","48","46",
"66 s","Sightseeing Pass","2012 ","91","42","49",
"66 s","Sightseeing Pass","2013 ","132","65","67",
"66 s","Sightseeing Pass","2014 ","93","34","59",
"66 s","Sightseeing Pass","2015 ","98","45","53",
"66 s","Sightseeing Pass","2016 ","114","45","69",
"66 s","Sightseeing Pass","2017 ","74","33","41",
"66 s","Sightseeing Pass","2018 ","103","57","46",
"66 s","Sightseeing Pass","2019 ","111","54","57",
"66 s","Short-term Business","2000 ","2","2","0",
"66 s","Short-term Business","2001 ","7","6","1",
"66 s","Short-term Business","2002 ","8","4","4",
"66 s","Short-term Business","2003 ","6","3","3",
"66 s","Short-term Business","2004 ","7","7","0",
"66 s","Short-term Business","2005 ","5","4","1",
"66 s","Short-term Business","2006 ","4","3","1",
"66 s","Short-term Business","2007 ","4","3","1",
"66 s","Short-term Business","2008 ","1","1","0",
"66 s","Short-term Business","2009 ","2","2","0",
"66 s","Short-term Business","2010 ","1","1","0",
"66 s","Short-term Business","2011 ","1","1","",
"66 s","Short-term Visitors","2000 ","290","148","142",
"66 s","Short-term Visitors","2001 ","154","72","82",
"66 s","Short-term Visitors","2002 ","270","135","135",
"66 s","Short-term Visitors","2003 ","631","313","318",
"66 s","Short-term Visitors","2004 ","513","233","280",
"66 s","Short-term Visitors","2005 ","676","309","367",
"66 s","Short-term Visitors","2006 ","507","221","286",
"66 s","Short-term Visitors","2007 ","271","122","149",
"66 s","Short-term Visitors","2008 ","90","28","62",
"66 s","Short-term Visitors","2009 ","170","74","96",
"66 s","Short-term Visitors","2010 ","131","44","87",
"66 s","Short-term Visitors","2011 ","146","60","86",
"66 s","Short-term Visitors","2012 ","103","34","69",
"66 s","Short-term Visitors","2013 ","149","56","93",
"66 s","Short-term Visitors","2014 ","155","64","91",
"66 s","Short-term Visitors","2015 ","150","52","98",
"66 s","Short-term Visitors","2016 ","219","96","123",
"66 s","Short-term Visitors","2017 ","135","56","79",
"66 s","Short-term Visitors","2018 ","171","60","111",
"66 s","Short-term Visitors","2019 ","168","56","112",
"66 s","Short-term Employment","2000 ","0","0","0",
"66 s","Short-term Employment","2001 ","1","1","0",
"66 s","Short-term Employment","2002 ","0","0","0",
"66 s","Short-term Employment","2003 ","1","1","0",
"66 s","Short-term Employment","2004 ","1","0","1",
"66 s","Short-term Employment","2005 ","2","1","1",
"66 s","Short-term Employment","2006 ","0","0","0",
"66 s","Short-term Employment","2007 ","2","2","0",
"66 s","Short-term Employment","2008 ","0","0","0",
"66 s","Short-term Employment","2009 ","0","0","0",
"66 s","Short-term Employment","2010 ","0","0","0",
"66 s","Short-term Employment","2014 ","1","1","0",
"66 s","Job Seeking","2000 ","0","0","0",
"66 s","Job Seeking","2001 ","0","0","0",
"66 s","Job Seeking","2002 ","0","0","0",
"66 s","Job Seeking","2003 ","0","0","0",
"66 s","Job Seeking","2004 ","0","0","0",
"66 s","Job Seeking","2005 ","0","0","0",
"66 s","Job Seeking","2006 ","0","0","0",
"66 s","Job Seeking","2007 ","0","0","0",
"66 s","Job Seeking","2008 ","0","0","0",
"66 s","Job Seeking","2009 ","0","0","0",
"66 s","Job Seeking","2010 ","0","0","0",
"66 s","study","2000 ","0","0","0",
"66 s","study","2001 ","0","0","0",
"66 s","study","2002 ","0","0","0",
"66 s","study","2003 ","0","0","0",
"66 s","study","2004 ","0","0","0",
"66 s","study","2005 ","0","0","0",
"66 s","study","2006 ","0","0","0",
"66 s","study","2007 ","0","0","0",
"66 s","study","2008 ","0","0","0",
"66 s","study","2009 ","0","0","0",
"66 s","study","2010 ","0","0","0",
"66 s","study","2016 ","1","0","1",
"66 s","General Trainees","2000 ","1","0","1",
"66 s","General Trainees","2001 ","0","0","0",
"66 s","General Trainees","2002 ","0","0","0",
"66 s","General Trainees","2003 ","0","0","0",
"66 s","General Trainees","2004 ","0","0","0",
"66 s","General Trainees","2005 ","0","0","0",
"66 s","General Trainees","2006 ","0","0","0",
"66 s","General Trainees","2007 ","0","0","0",
"66 s","General Trainees","2008 ","0","0","0",
"66 s","General Trainees","2009 ","1","1","0",
"66 s","General Trainees","2010 ","1","1","0",
"66 s","General Trainees","2016 ","1","0","1",
"66 s","General Trainees","2019 ","1","1","0",
"66 s","Religious Activities","2000 ","3","1","2",
"66 s","Religious Activities","2001 ","2","2","0",
"66 s","Religious Activities","2002 ","3","1","2",
"66 s","Religious Activities","2003 ","4","3","1",
"66 s","Religious Activities","2004 ","3","1","2",
"66 s","Religious Activities","2005 ","4","3","1",
"66 s","Religious Activities","2006 ","1","1","0",
"66 s","Religious Activities","2007 ","4","3","1",
"66 s","Religious Activities","2008 ","5","2","3",
"66 s","Religious Activities","2009 ","3","2","1",
"66 s","Religious Activities","2010 ","2","1","1",
"66 s","Religious Activities","2011 ","3","1","2",
"66 s","Religious Activities","2012 ","1","1","",
"66 s","Religious Activities","2013 ","4","2","2",
"66 s","Religious Activities","2014 ","5","1","4",
"66 s","Religious Activities","2015 ","1","0","1",
"66 s","Religious Activities","2016 ","3","2","1",
"66 s","Religious Activities","2017 ","6","4","2",
"66 s","Religious Activities","2018 ","2","1","1",
"66 s","Religious Activities","2019 ","1","1","0",
"66 s","Investors","2000 ","1","1","0",
"66 s","Investors","2001 ","1","1","0",
"66 s","Investors","2002 ","0","0","0",
"66 s","Investors","2003 ","2","2","0",
"66 s","Investors","2004 ","0","0","0",
"66 s","Investors","2005 ","2","2","0",
"66 s","Investors","2006 ","3","2","1",
"66 s","Investors","2007 ","1","1","0",
"66 s","Investors","2008 ","1","1","0",
"66 s","Investors","2009 ","3","3","0",
"66 s","Investors","2010 ","0","0","0",
"66 s","Investors","2013 ","2","2","0",
"66 s","Investors","2016 ","1","0","1",
"66 s","Investors","2017 ","1","1","0",
"66 s","Investors","2018 ","1","1","0",
"66 s","Investors","2019 ","1","1","0",
"66 s","Trade and Business","2000 ","1","1","0",
"66 s","Trade and Business","2001 ","0","0","0",
"66 s","Trade and Business","2002 ","3","3","0",
"66 s","Trade and Business","2003 ","1","1","0",
"66 s","Trade and Business","2004 ","1","1","0",
"66 s","Trade and Business","2005 ","3","3","0",
"66 s","Trade and Business","2006 ","1","1","0",
"66 s","Trade and Business","2007 ","8","8","0",
"66 s","Trade and Business","2008 ","2","2","0",
"66 s","Trade and Business","2009 ","4","4","0",
"66 s","Trade and Business","2010 ","1","1","0",
"66 s","Trade and Business","2011 ","5","5","",
"66 s","Trade and Business","2012 ","8","7","1",
"66 s","Trade and Business","2013 ","7","7","0",
"66 s","Trade and Business","2014 ","11","11","0",
"66 s","Trade and Business","2015 ","5","5","0",
"66 s","Trade and Business","2016 ","7","7","0",
"66 s","Trade and Business","2017 ","5","5","0",
"66 s","Trade and Business","2018 ","6","5","1",
"66 s","Trade and Business","2019 ","5","5","0",
"66 s","Research","2000 ","1","1","0",
"66 s","Research","2001 ","1","1","0",
"66 s","Research","2002 ","0","0","0",
"66 s","Research","2003 ","3","3","0",
"66 s","Research","2004 ","2","2","0",
"66 s","Research","2005 ","0","0","0",
"66 s","Research","2006 ","2","2","0",
"66 s","Research","2007 ","2","2","0",
"66 s","Research","2008 ","2","2","0",
"66 s","Research","2009 ","0","0","0",
"66 s","Research","2010 ","1","1","0",
"66 s","Research","2011 ","2","2","",
"66 s","Research","2012 ","2","2","",
"66 s","Research","2014 ","1","1","0",
"66 s","Research","2018 ","1","1","0",
"66 s","Art and Entertainment","2000 ","1","1","0",
"66 s","Art and Entertainment","2001 ","0","0","0",
"66 s","Art and Entertainment","2002 ","1","1","0",
"66 s","Art and Entertainment","2003 ","0","0","0",
"66 s","Art and Entertainment","2004 ","0","0","0",
"66 s","Art and Entertainment","2005 ","1","1","0",
"66 s","Art and Entertainment","2006 ","0","0","0",
"66 s","Art and Entertainment","2007 ","0","0","0",
"66 s","Art and Entertainment","2008 ","0","0","0",
"66 s","Art and Entertainment","2009 ","0","0","0",
"66 s","Art and Entertainment","2010 ","0","0","0",
"66 s","Unskilled Employment","2000 ","0","0","0",
"66 s","Unskilled Employment","2001 ","0","0","0",
"66 s","Unskilled Employment","2002 ","0","0","0",
"66 s","Unskilled Employment","2003 ","0","0","0",
"66 s","Unskilled Employment","2004 ","6","4","2",
"66 s","Unskilled Employment","2005 ","1","0","1",
"66 s","Unskilled Employment","2006 ","0","0","0",
"66 s","Unskilled Employment","2007 ","0","0","0",
"66 s","Unskilled Employment","2008 ","0","0","0",
"66 s","Unskilled Employment","2009 ","0","0","0",
"66 s","Unskilled Employment","2010 ","0","0","0",
"66 s","Visiting and Joining Family","2000 ","111","65","46",
"66 s","Visiting and Joining Family","2001 ","120","75","45",
"66 s","Visiting and Joining Family","2002 ","65","37","28",
"66 s","Visiting and Joining Family","2003 ","47","23","24",
"66 s","Visiting and Joining Family","2004 ","52","29","23",
"66 s","Visiting and Joining Family","2005 ","121","72","49",
"66 s","Visiting and Joining Family","2006 ","128","75","53",
"66 s","Visiting and Joining Family","2007 ","86","45","41",
"66 s","Visiting and Joining Family","2008 ","55","31","24",
"66 s","Visiting and Joining Family","2009 ","15","7","8",
"66 s","Visiting and Joining Family","2010 ","8","6","2",
"66 s","Visiting and Joining Family","2011 ","42","16","26",
"66 s","Visiting and Joining Family","2012 ","221","90","131",
"66 s","Visiting and Joining Family","2013 ","216","76","140",
"66 s","Visiting and Joining Family","2014 ","69","36","33",
"66 s","Visiting and Joining Family","2015 ","89","40","49",
"66 s","Visiting and Joining Family","2016 ","93","47","46",
"66 s","Visiting and Joining Family","2017 ","136","75","61",
"66 s","Visiting and Joining Family","2018 ","110","50","60",
"66 s","Visiting and Joining Family","2019 ","112","53","59",
"66 s","Overseas Koreans","2000 ","11","6","5",
"66 s","Overseas Koreans","2001 ","9","4","5",
"66 s","Overseas Koreans","2002 ","17","11","6",
"66 s","Overseas Koreans","2003 ","36","19","17",
"66 s","Overseas Koreans","2004 ","30","10","20",
"66 s","Overseas Koreans","2005 ","40","24","16",
"66 s","Overseas Koreans","2006 ","29","11","18",
"66 s","Overseas Koreans","2007 ","40","15","25",
"66 s","Overseas Koreans","2008 ","55","23","32",
"66 s","Overseas Koreans","2009 ","69","31","38",
"66 s","Overseas Koreans","2010 ","81","40","41",
"66 s","Overseas Koreans","2011 ","143","75","68",
"66 s","Overseas Koreans","2012 ","351","202","149",
"66 s","Overseas Koreans","2013 ","734","390","344",
"66 s","Overseas Koreans","2014 ","1112","552","560",
"66 s","Overseas Koreans","2015 ","1482","673","809",
"66 s","Overseas Koreans","2016 ","1747","819","928",
"66 s","Overseas Koreans","2017 ","1739","789","950",
"66 s","Overseas Koreans","2018 ","1933","848","1085",
"66 s","Overseas Koreans","2019 ","1847","832","1015",
"66 s","Permanent Residence","2000 ","0","0","0",
"66 s","Permanent Residence","2001 ","0","0","0",
"66 s","Permanent Residence","2002 ","0","0","0",
"66 s","Permanent Residence","2003 ","3","2","1",
"66 s","Permanent Residence","2004 ","9","6","3",
"66 s","Permanent Residence","2005 ","5","2","3",
"66 s","Permanent Residence","2006 ","4","4","0",
"66 s","Permanent Residence","2007 ","5","2","3",
"66 s","Permanent Residence","2008 ","5","2","3",
"66 s","Permanent Residence","2009 ","6","4","2",
"66 s","Permanent Residence","2010 ","6","2","4",
"66 s","Permanent Residence","2011 ","17","10","7",
"66 s","Permanent Residence","2012 ","23","13","10",
"66 s","Permanent Residence","2013 ","19","9","10",
"66 s","Permanent Residence","2014 ","42","17","25",
"66 s","Permanent Residence","2015 ","45","28","17",
"66 s","Permanent Residence","2016 ","50","27","23",
"66 s","Permanent Residence","2017 ","58","36","22",
"66 s","Permanent Residence","2018 ","61","29","32",
"66 s","Permanent Residence","2019 ","66","37","29",
"66 s","Marriage Immigration","2012 ","9","6","3",
"66 s","Marriage Immigration","2013 ","17","11","6",
"66 s","Marriage Immigration","2014 ","10","4","6",
"66 s","Marriage Immigration","2015 ","13","9","4",
"66 s","Marriage Immigration","2016 ","20","18","2",
"66 s","Marriage Immigration","2017 ","18","10","8",
"66 s","Marriage Immigration","2018 ","12","8","4",
"66 s","Marriage Immigration","2019 ","19","11","8",
"67 s","Total","2000 ","406","205","201",
"67 s","Total","2001 ","373","226","147",
"67 s","Total","2002 ","395","228","167",
"67 s","Total","2003 ","630","350","280",
"67 s","Total","2004 ","565","293","272",
"67 s","Total","2005 ","750","368","382",
"67 s","Total","2006 ","712","364","348",
"67 s","Total","2007 ","810","415","395",
"67 s","Total","2008 ","900","448","452",
"67 s","Total","2009 ","608","312","296",
"67 s","Total","2010 ","652","337","315",
"67 s","Total","2011 ","758","393","365",
"67 s","Total","2012 ","886","458","428",
"67 s","Total","2013 ","1050","503","547",
"67 s","Total","2014 ","1302","644","658",
"67 s","Total","2015 ","1461","669","792",
"67 s","Total","2016 ","1884","898","986",
"67 s","Total","2017 ","1996","905","1091",
"67 s","Total","2018 ","2045","926","1119",
"67 s","Total","2019 ","1999","905","1094",
"67 s","Sightseeing Pass","2000 ","56","28","28",
"67 s","Sightseeing Pass","2001 ","78","47","31",
"67 s","Sightseeing Pass","2002 ","82","65","17",
"67 s","Sightseeing Pass","2003 ","69","46","23",
"67 s","Sightseeing Pass","2004 ","75","46","29",
"67 s","Sightseeing Pass","2005 ","68","37","31",
"67 s","Sightseeing Pass","2006 ","65","50","15",
"67 s","Sightseeing Pass","2007 ","44","26","18",
"67 s","Sightseeing Pass","2008 ","47","25","22",
"67 s","Sightseeing Pass","2009 ","74","39","35",
"67 s","Sightseeing Pass","2010 ","94","47","47",
"67 s","Sightseeing Pass","2011 ","92","45","47",
"67 s","Sightseeing Pass","2012 ","106","43","63",
"67 s","Sightseeing Pass","2013 ","78","37","41",
"67 s","Sightseeing Pass","2014 ","97","43","54",
"67 s","Sightseeing Pass","2015 ","107","54","53",
"67 s","Sightseeing Pass","2016 ","111","49","62",
"67 s","Sightseeing Pass","2017 ","84","35","49",
"67 s","Sightseeing Pass","2018 ","84","40","44",
"67 s","Sightseeing Pass","2019 ","85","34","51",
"67 s","Short-term Business","2000 ","7","6","1",
"67 s","Short-term Business","2001 ","4","4","0",
"67 s","Short-term Business","2002 ","7","7","0",
"67 s","Short-term Business","2003 ","7","4","3",
"67 s","Short-term Business","2004 ","5","3","2",
"67 s","Short-term Business","2005 ","4","2","2",
"67 s","Short-term Business","2006 ","1","0","1",
"67 s","Short-term Business","2007 ","5","5","0",
"67 s","Short-term Business","2008 ","1","1","0",
"67 s","Short-term Business","2009 ","3","2","1",
"67 s","Short-term Business","2010 ","2","2","0",
"67 s","Short-term Business","2011 ","1","1","",
"67 s","Short-term Visitors","2000 ","202","90","112",
"67 s","Short-term Visitors","2001 ","139","79","60",
"67 s","Short-term Visitors","2002 ","201","99","102",
"67 s","Short-term Visitors","2003 ","440","229","211",
"67 s","Short-term Visitors","2004 ","362","171","191",
"67 s","Short-term Visitors","2005 ","479","225","254",
"67 s","Short-term Visitors","2006 ","401","167","234",
"67 s","Short-term Visitors","2007 ","304","137","167",
"67 s","Short-term Visitors","2008 ","93","33","60",
"67 s","Short-term Visitors","2009 ","148","56","92",
"67 s","Short-term Visitors","2010 ","132","46","86",
"67 s","Short-term Visitors","2011 ","124","59","65",
"67 s","Short-term Visitors","2012 ","137","60","77",
"67 s","Short-term Visitors","2013 ","123","39","84",
"67 s","Short-term Visitors","2014 ","130","51","79",
"67 s","Short-term Visitors","2015 ","116","56","60",
"67 s","Short-term Visitors","2016 ","155","58","97",
"67 s","Short-term Visitors","2017 ","134","48","86",
"67 s","Short-term Visitors","2018 ","109","45","64",
"67 s","Short-term Visitors","2019 ","110","41","69",
"67 s","Short-term Employment","2000 ","0","0","0",
"67 s","Short-term Employment","2001 ","0","0","0",
"67 s","Short-term Employment","2002 ","0","0","0",
"67 s","Short-term Employment","2003 ","0","0","0",
"67 s","Short-term Employment","2004 ","0","0","0",
"67 s","Short-term Employment","2005 ","0","0","0",
"67 s","Short-term Employment","2006 ","1","1","0",
"67 s","Short-term Employment","2007 ","0","0","0",
"67 s","Short-term Employment","2008 ","0","0","0",
"67 s","Short-term Employment","2009 ","0","0","0",
"67 s","Short-term Employment","2010 ","0","0","0",
"67 s","Job Seeking","2000 ","0","0","0",
"67 s","Job Seeking","2001 ","0","0","0",
"67 s","Job Seeking","2002 ","0","0","0",
"67 s","Job Seeking","2003 ","0","0","0",
"67 s","Job Seeking","2004 ","0","0","0",
"67 s","Job Seeking","2005 ","0","0","0",
"67 s","Job Seeking","2006 ","0","0","0",
"67 s","Job Seeking","2007 ","0","0","0",
"67 s","Job Seeking","2008 ","0","0","0",
"67 s","Job Seeking","2009 ","0","0","0",
"67 s","Job Seeking","2010 ","0","0","0",
"67 s","study","2000 ","0","0","0",
"67 s","study","2001 ","0","0","0",
"67 s","study","2002 ","0","0","0",
"67 s","study","2003 ","0","0","0",
"67 s","study","2004 ","0","0","0",
"67 s","study","2005 ","0","0","0",
"67 s","study","2006 ","0","0","0",
"67 s","study","2007 ","0","0","0",
"67 s","study","2008 ","0","0","0",
"67 s","study","2009 ","0","0","0",
"67 s","study","2010 ","0","0","0",
"67 s","study","2011 ","1","","1",
"67 s","study","2015 ","1","0","1",
"67 s","General Trainees","2000 ","1","1","0",
"67 s","General Trainees","2001 ","0","0","0",
"67 s","General Trainees","2002 ","0","0","0",
"67 s","General Trainees","2003 ","0","0","0",
"67 s","General Trainees","2004 ","0","0","0",
"67 s","General Trainees","2005 ","0","0","0",
"67 s","General Trainees","2006 ","0","0","0",
"67 s","General Trainees","2007 ","0","0","0",
"67 s","General Trainees","2008 ","1","0","1",
"67 s","General Trainees","2009 ","0","0","0",
"67 s","General Trainees","2010 ","0","0","0",
"67 s","Religious Activities","2000 ","3","3","0",
"67 s","Religious Activities","2001 ","7","5","2",
"67 s","Religious Activities","2002 ","1","1","0",
"67 s","Religious Activities","2003 ","1","1","0",
"67 s","Religious Activities","2004 ","5","3","2",
"67 s","Religious Activities","2005 ","1","1","0",
"67 s","Religious Activities","2006 ","3","1","2",
"67 s","Religious Activities","2007 ","4","4","0",
"67 s","Religious Activities","2008 ","2","2","0",
"67 s","Religious Activities","2009 ","2","2","0",
"67 s","Religious Activities","2010 ","1","1","0",
"67 s","Religious Activities","2011 ","3","3","",
"67 s","Religious Activities","2012 ","3","1","2",
"67 s","Religious Activities","2013 ","4","1","3",
"67 s","Religious Activities","2014 ","4","1","3",
"67 s","Religious Activities","2015 ","2","1","1",
"67 s","Religious Activities","2016 ","1","1","0",
"67 s","Religious Activities","2017 ","2","1","1",
"67 s","Religious Activities","2018 ","6","2","4",
"67 s","Religious Activities","2019 ","2","2","0",
"67 s","Investors","2000 ","2","2","0",
"67 s","Investors","2001 ","1","1","0",
"67 s","Investors","2002 ","1","1","0",
"67 s","Investors","2003 ","1","1","0",
"67 s","Investors","2004 ","0","0","0",
"67 s","Investors","2005 ","2","2","0",
"67 s","Investors","2006 ","4","4","0",
"67 s","Investors","2007 ","1","1","0",
"67 s","Investors","2008 ","0","0","0",
"67 s","Investors","2009 ","2","2","0",
"67 s","Investors","2010 ","3","3","0",
"67 s","Investors","2013 ","1","1","0",
"67 s","Investors","2017 ","1","1","0",
"67 s","Investors","2018 ","1","1","0",
"67 s","Investors","2019 ","2","2","0",
"67 s","Trade and Business","2000 ","0","0","0",
"67 s","Trade and Business","2001 ","1","1","0",
"67 s","Trade and Business","2002 ","0","0","0",
"67 s","Trade and Business","2003 ","0","0","0",
"67 s","Trade and Business","2004 ","5","5","0",
"67 s","Trade and Business","2005 ","0","0","0",
"67 s","Trade and Business","2006 ","2","2","0",
"67 s","Trade and Business","2007 ","1","1","0",
"67 s","Trade and Business","2008 ","6","6","0",
"67 s","Trade and Business","2009 ","3","3","0",
"67 s","Trade and Business","2010 ","3","3","0",
"67 s","Trade and Business","2011 ","1","1","",
"67 s","Trade and Business","2012 ","6","6","",
"67 s","Trade and Business","2013 ","4","4","0",
"67 s","Trade and Business","2014 ","5","5","0",
"67 s","Trade and Business","2015 ","6","6","0",
"67 s","Trade and Business","2016 ","2","2","0",
"67 s","Trade and Business","2017 ","4","4","0",
"67 s","Trade and Business","2018 ","2","2","0",
"67 s","Trade and Business","2019 ","1","1","0",
"67 s","Research","2000 ","1","1","0",
"67 s","Research","2001 ","1","1","0",
"67 s","Research","2002 ","0","0","0",
"67 s","Research","2003 ","2","1","1",
"67 s","Research","2004 ","0","0","0",
"67 s","Research","2005 ","1","1","0",
"67 s","Research","2006 ","1","1","0",
"67 s","Research","2007 ","0","0","0",
"67 s","Research","2008 ","0","0","0",
"67 s","Research","2009 ","0","0","0",
"67 s","Research","2010 ","0","0","0",
"67 s","Research","2013 ","1","1","0",
"67 s","Research","2016 ","1","1","0",
"67 s","Research","2017 ","1","1","0",
"67 s","Research","2019 ","1","1","0",
"67 s","Art and Entertainment","2000 ","1","1","0",
"67 s","Art and Entertainment","2001 ","0","0","0",
"67 s","Art and Entertainment","2002 ","0","0","0",
"67 s","Art and Entertainment","2003 ","0","0","0",
"67 s","Art and Entertainment","2004 ","1","0","1",
"67 s","Art and Entertainment","2005 ","0","0","0",
"67 s","Art and Entertainment","2006 ","0","0","0",
"67 s","Art and Entertainment","2007 ","0","0","0",
"67 s","Art and Entertainment","2008 ","1","1","0",
"67 s","Art and Entertainment","2009 ","0","0","0",
"67 s","Art and Entertainment","2010 ","0","0","0",
"67 s","Unskilled Employment","2000 ","0","0","0",
"67 s","Unskilled Employment","2001 ","0","0","0",
"67 s","Unskilled Employment","2002 ","0","0","0",
"67 s","Unskilled Employment","2003 ","0","0","0",
"67 s","Unskilled Employment","2004 ","1","1","0",
"67 s","Unskilled Employment","2005 ","0","0","0",
"67 s","Unskilled Employment","2006 ","0","0","0",
"67 s","Unskilled Employment","2007 ","0","0","0",
"67 s","Unskilled Employment","2008 ","0","0","0",
"67 s","Unskilled Employment","2009 ","0","0","0",
"67 s","Unskilled Employment","2010 ","0","0","0",
"67 s","Visiting and Joining Family","2000 ","79","46","33",
"67 s","Visiting and Joining Family","2001 ","96","57","39",
"67 s","Visiting and Joining Family","2002 ","42","26","16",
"67 s","Visiting and Joining Family","2003 ","39","23","16",
"67 s","Visiting and Joining Family","2004 ","37","18","19",
"67 s","Visiting and Joining Family","2005 ","102","57","45",
"67 s","Visiting and Joining Family","2006 ","144","83","61",
"67 s","Visiting and Joining Family","2007 ","81","36","45",
"67 s","Visiting and Joining Family","2008 ","56","31","25",
"67 s","Visiting and Joining Family","2009 ","17","4","13",
"67 s","Visiting and Joining Family","2010 ","12","9","3",
"67 s","Visiting and Joining Family","2011 ","44","21","23",
"67 s","Visiting and Joining Family","2012 ","142","51","91",
"67 s","Visiting and Joining Family","2013 ","184","60","124",
"67 s","Visiting and Joining Family","2014 ","58","25","33",
"67 s","Visiting and Joining Family","2015 ","50","16","34",
"67 s","Visiting and Joining Family","2016 ","79","41","38",
"67 s","Visiting and Joining Family","2017 ","123","62","61",
"67 s","Visiting and Joining Family","2018 ","109","66","43",
"67 s","Visiting and Joining Family","2019 ","85","46","39",
"67 s","Overseas Koreans","2000 ","6","5","1",
"67 s","Overseas Koreans","2001 ","13","7","6",
"67 s","Overseas Koreans","2002 ","18","6","12",
"67 s","Overseas Koreans","2003 ","25","14","11",
"67 s","Overseas Koreans","2004 ","31","18","13",
"67 s","Overseas Koreans","2005 ","34","14","20",
"67 s","Overseas Koreans","2006 ","36","24","12",
"67 s","Overseas Koreans","2007 ","31","15","16",
"67 s","Overseas Koreans","2008 ","47","19","28",
"67 s","Overseas Koreans","2009 ","54","28","26",
"67 s","Overseas Koreans","2010 ","79","40","39",
"67 s","Overseas Koreans","2011 ","146","69","77",
"67 s","Overseas Koreans","2012 ","254","157","97",
"67 s","Overseas Koreans","2013 ","507","275","232",
"67 s","Overseas Koreans","2014 ","909","464","445",
"67 s","Overseas Koreans","2015 ","1094","501","593",
"67 s","Overseas Koreans","2016 ","1412","673","739",
"67 s","Overseas Koreans","2017 ","1543","699","844",
"67 s","Overseas Koreans","2018 ","1614","702","912",
"67 s","Overseas Koreans","2019 ","1586","712","874",
"67 s","Permanent Residence","2000 ","0","0","0",
"67 s","Permanent Residence","2001 ","0","0","0",
"67 s","Permanent Residence","2002 ","0","0","0",
"67 s","Permanent Residence","2003 ","2","1","1",
"67 s","Permanent Residence","2004 ","2","2","0",
"67 s","Permanent Residence","2005 ","7","3","4",
"67 s","Permanent Residence","2006 ","4","1","3",
"67 s","Permanent Residence","2007 ","6","3","3",
"67 s","Permanent Residence","2008 ","5","2","3",
"67 s","Permanent Residence","2009 ","7","2","5",
"67 s","Permanent Residence","2010 ","9","5","4",
"67 s","Permanent Residence","2011 ","10","3","7",
"67 s","Permanent Residence","2012 ","20","8","12",
"67 s","Permanent Residence","2013 ","26","15","11",
"67 s","Permanent Residence","2014 ","28","17","11",
"67 s","Permanent Residence","2015 ","33","10","23",
"67 s","Permanent Residence","2016 ","52","32","20",
"67 s","Permanent Residence","2017 ","54","27","27",
"67 s","Permanent Residence","2018 ","71","37","34",
"67 s","Permanent Residence","2019 ","61","31","30",
"67 s","Marriage Immigration","2011 ","2","1","1",
"67 s","Marriage Immigration","2012 ","15","12","3",
"67 s","Marriage Immigration","2013 ","11","7","4",
"67 s","Marriage Immigration","2014 ","17","13","4",
"67 s","Marriage Immigration","2015 ","8","6","2",
"67 s","Marriage Immigration","2016 ","21","13","8",
"67 s","Marriage Immigration","2017 ","19","12","7",
"67 s","Marriage Immigration","2018 ","12","10","2",
"67 s","Marriage Immigration","2019 ","17","8","9",
"68 s","Total","2000 ","331","176","155",
"68 s","Total","2001 ","315","167","148",
"68 s","Total","2002 ","354","184","170",
"68 s","Total","2003 ","505","263","242",
"68 s","Total","2004 ","459","243","216",
"68 s","Total","2005 ","571","309","262",
"68 s","Total","2006 ","544","244","300",
"68 s","Total","2007 ","716","350","366",
"68 s","Total","2008 ","748","337","411",
"68 s","Total","2009 ","456","212","244",
"68 s","Total","2010 ","553","276","277",
"68 s","Total","2011 ","695","336","359",
"68 s","Total","2012 ","804","412","392",
"68 s","Total","2013 ","800","411","389",
"68 s","Total","2014 ","1039","527","512",
"68 s","Total","2015 ","1362","603","759",
"68 s","Total","2016 ","1394","620","774",
"68 s","Total","2017 ","1585","706","879",
"68 s","Total","2018 ","1753","793","960",
"68 s","Total","2019 ","1709","785","924",
"68 s","Sightseeing Pass","2000 ","57","28","29",
"68 s","Sightseeing Pass","2001 ","83","41","42",
"68 s","Sightseeing Pass","2002 ","75","44","31",
"68 s","Sightseeing Pass","2003 ","77","52","25",
"68 s","Sightseeing Pass","2004 ","56","31","25",
"68 s","Sightseeing Pass","2005 ","57","35","22",
"68 s","Sightseeing Pass","2006 ","61","27","34",
"68 s","Sightseeing Pass","2007 ","45","27","18",
"68 s","Sightseeing Pass","2008 ","46","21","25",
"68 s","Sightseeing Pass","2009 ","47","21","26",
"68 s","Sightseeing Pass","2010 ","77","37","40",
"68 s","Sightseeing Pass","2011 ","91","52","39",
"68 s","Sightseeing Pass","2012 ","118","51","67",
"68 s","Sightseeing Pass","2013 ","87","46","41",
"68 s","Sightseeing Pass","2014 ","69","33","36",
"68 s","Sightseeing Pass","2015 ","105","56","49",
"68 s","Sightseeing Pass","2016 ","104","50","54",
"68 s","Sightseeing Pass","2017 ","69","32","37",
"68 s","Sightseeing Pass","2018 ","82","40","42",
"68 s","Sightseeing Pass","2019 ","57","25","32",
"68 s","Short-term Business","2000 ","2","1","1",
"68 s","Short-term Business","2001 ","6","4","2",
"68 s","Short-term Business","2002 ","4","3","1",
"68 s","Short-term Business","2003 ","3","3","0",
"68 s","Short-term Business","2004 ","5","4","1",
"68 s","Short-term Business","2005 ","4","3","1",
"68 s","Short-term Business","2006 ","5","2","3",
"68 s","Short-term Business","2007 ","2","2","0",
"68 s","Short-term Business","2008 ","0","0","0",
"68 s","Short-term Business","2009 ","0","0","0",
"68 s","Short-term Business","2010 ","1","1","0",
"68 s","Short-term Business","2011 ","1","","1",
"68 s","Short-term Visitors","2000 ","138","60","78",
"68 s","Short-term Visitors","2001 ","87","44","43",
"68 s","Short-term Visitors","2002 ","185","82","103",
"68 s","Short-term Visitors","2003 ","315","143","172",
"68 s","Short-term Visitors","2004 ","276","134","142",
"68 s","Short-term Visitors","2005 ","361","183","178",
"68 s","Short-term Visitors","2006 ","304","122","182",
"68 s","Short-term Visitors","2007 ","284","123","161",
"68 s","Short-term Visitors","2008 ","96","36","60",
"68 s","Short-term Visitors","2009 ","111","46","65",
"68 s","Short-term Visitors","2010 ","120","39","81",
"68 s","Short-term Visitors","2011 ","154","57","97",
"68 s","Short-term Visitors","2012 ","88","46","42",
"68 s","Short-term Visitors","2013 ","98","40","58",
"68 s","Short-term Visitors","2014 ","113","50","63",
"68 s","Short-term Visitors","2015 ","104","33","71",
"68 s","Short-term Visitors","2016 ","113","50","63",
"68 s","Short-term Visitors","2017 ","87","36","51",
"68 s","Short-term Visitors","2018 ","104","46","58",
"68 s","Short-term Visitors","2019 ","107","45","62",
"68 s","Short-term Employment","2000 ","0","0","0",
"68 s","Short-term Employment","2001 ","1","0","1",
"68 s","Short-term Employment","2002 ","0","0","0",
"68 s","Short-term Employment","2003 ","0","0","0",
"68 s","Short-term Employment","2004 ","0","0","0",
"68 s","Short-term Employment","2005 ","0","0","0",
"68 s","Short-term Employment","2006 ","0","0","0",
"68 s","Short-term Employment","2007 ","0","0","0",
"68 s","Short-term Employment","2008 ","0","0","0",
"68 s","Short-term Employment","2009 ","0","0","0",
"68 s","Short-term Employment","2010 ","0","0","0",
"68 s","Short-term Employment","2019 ","1","1","0",
"68 s","Job Seeking","2000 ","0","0","0",
"68 s","Job Seeking","2001 ","0","0","0",
"68 s","Job Seeking","2002 ","0","0","0",
"68 s","Job Seeking","2003 ","0","0","0",
"68 s","Job Seeking","2004 ","0","0","0",
"68 s","Job Seeking","2005 ","0","0","0",
"68 s","Job Seeking","2006 ","0","0","0",
"68 s","Job Seeking","2007 ","0","0","0",
"68 s","Job Seeking","2008 ","0","0","0",
"68 s","Job Seeking","2009 ","0","0","0",
"68 s","Job Seeking","2010 ","0","0","0",
"68 s","study","2000 ","0","0","0",
"68 s","study","2001 ","0","0","0",
"68 s","study","2002 ","0","0","0",
"68 s","study","2003 ","0","0","0",
"68 s","study","2004 ","0","0","0",
"68 s","study","2005 ","0","0","0",
"68 s","study","2006 ","0","0","0",
"68 s","study","2007 ","0","0","0",
"68 s","study","2008 ","0","0","0",
"68 s","study","2009 ","0","0","0",
"68 s","study","2010 ","1","0","1",
"68 s","study","2016 ","1","1","0",
"68 s","study","2019 ","1","0","1",
"68 s","General Trainees","2000 ","0","0","0",
"68 s","General Trainees","2001 ","0","0","0",
"68 s","General Trainees","2002 ","0","0","0",
"68 s","General Trainees","2003 ","0","0","0",
"68 s","General Trainees","2004 ","0","0","0",
"68 s","General Trainees","2005 ","1","0","1",
"68 s","General Trainees","2006 ","1","1","0",
"68 s","General Trainees","2007 ","0","0","0",
"68 s","General Trainees","2008 ","0","0","0",
"68 s","General Trainees","2009 ","0","0","0",
"68 s","General Trainees","2010 ","1","1","0",
"68 s","General Trainees","2018 ","1","1","0",
"68 s","Religious Activities","2000 ","2","0","2",
"68 s","Religious Activities","2001 ","6","3","3",
"68 s","Religious Activities","2002 ","3","3","0",
"68 s","Religious Activities","2003 ","3","2","1",
"68 s","Religious Activities","2004 ","4","2","2",
"68 s","Religious Activities","2005 ","4","4","0",
"68 s","Religious Activities","2006 ","0","0","0",
"68 s","Religious Activities","2007 ","2","2","0",
"68 s","Religious Activities","2008 ","4","1","3",
"68 s","Religious Activities","2009 ","4","2","2",
"68 s","Religious Activities","2010 ","4","3","1",
"68 s","Religious Activities","2011 ","2","1","1",
"68 s","Religious Activities","2012 ","3","3","",
"68 s","Religious Activities","2015 ","1","1","0",
"68 s","Religious Activities","2016 ","2","0","2",
"68 s","Investors","2000 ","0","0","0",
"68 s","Investors","2001 ","4","4","0",
"68 s","Investors","2002 ","0","0","0",
"68 s","Investors","2003 ","2","2","0",
"68 s","Investors","2004 ","1","1","0",
"68 s","Investors","2005 ","2","2","0",
"68 s","Investors","2006 ","0","0","0",
"68 s","Investors","2007 ","2","2","0",
"68 s","Investors","2008 ","1","1","0",
"68 s","Investors","2009 ","0","0","0",
"68 s","Investors","2010 ","1","1","0",
"68 s","Investors","2011 ","1","1","",
"68 s","Investors","2016 ","1","1","0",
"68 s","Investors","2018 ","1","1","0",
"68 s","Trade and Business","2000 ","1","1","0",
"68 s","Trade and Business","2001 ","0","0","0",
"68 s","Trade and Business","2002 ","2","2","0",
"68 s","Trade and Business","2003 ","0","0","0",
"68 s","Trade and Business","2004 ","1","1","0",
"68 s","Trade and Business","2005 ","1","1","0",
"68 s","Trade and Business","2006 ","0","0","0",
"68 s","Trade and Business","2007 ","1","1","0",
"68 s","Trade and Business","2008 ","2","2","0",
"68 s","Trade and Business","2009 ","3","3","0",
"68 s","Trade and Business","2010 ","2","2","0",
"68 s","Trade and Business","2011 ","4","4","",
"68 s","Trade and Business","2012 ","4","4","",
"68 s","Trade and Business","2013 ","6","6","0",
"68 s","Trade and Business","2014 ","5","5","0",
"68 s","Trade and Business","2015 ","5","5","0",
"68 s","Trade and Business","2016 ","5","5","0",
"68 s","Trade and Business","2017 ","3","3","0",
"68 s","Trade and Business","2018 ","3","3","0",
"68 s","Trade and Business","2019 ","3","3","0",
"68 s","Research","2000 ","1","1","0",
"68 s","Research","2001 ","1","1","0",
"68 s","Research","2002 ","0","0","0",
"68 s","Research","2003 ","1","1","0",
"68 s","Research","2004 ","1","0","1",
"68 s","Research","2005 ","1","1","0",
"68 s","Research","2006 ","1","0","1",
"68 s","Research","2007 ","0","0","0",
"68 s","Research","2008 ","0","0","0",
"68 s","Research","2009 ","0","0","0",
"68 s","Research","2010 ","1","1","0",
"68 s","Research","2012 ","1","1","",
"68 s","Research","2014 ","2","2","0",
"68 s","Research","2016 ","1","1","0",
"68 s","Research","2018 ","2","1","1",
"68 s","Art and Entertainment","2000 ","0","0","0",
"68 s","Art and Entertainment","2001 ","0","0","0",
"68 s","Art and Entertainment","2002 ","0","0","0",
"68 s","Art and Entertainment","2003 ","0","0","0",
"68 s","Art and Entertainment","2004 ","0","0","0",
"68 s","Art and Entertainment","2005 ","0","0","0",
"68 s","Art and Entertainment","2006 ","0","0","0",
"68 s","Art and Entertainment","2007 ","0","0","0",
"68 s","Art and Entertainment","2008 ","0","0","0",
"68 s","Art and Entertainment","2009 ","0","0","0",
"68 s","Art and Entertainment","2010 ","0","0","0",
"68 s","Art and Entertainment","2014 ","1","1","0",
"68 s","Unskilled Employment","2000 ","0","0","0",
"68 s","Unskilled Employment","2001 ","0","0","0",
"68 s","Unskilled Employment","2002 ","0","0","0",
"68 s","Unskilled Employment","2003 ","0","0","0",
"68 s","Unskilled Employment","2004 ","2","2","0",
"68 s","Unskilled Employment","2005 ","0","0","0",
"68 s","Unskilled Employment","2006 ","0","0","0",
"68 s","Unskilled Employment","2007 ","0","0","0",
"68 s","Unskilled Employment","2008 ","0","0","0",
"68 s","Unskilled Employment","2009 ","0","0","0",
"68 s","Unskilled Employment","2010 ","0","0","0",
"68 s","Visiting and Joining Family","2000 ","74","45","29",
"68 s","Visiting and Joining Family","2001 ","81","48","33",
"68 s","Visiting and Joining Family","2002 ","43","25","18",
"68 s","Visiting and Joining Family","2003 ","41","24","17",
"68 s","Visiting and Joining Family","2004 ","47","26","21",
"68 s","Visiting and Joining Family","2005 ","65","35","30",
"68 s","Visiting and Joining Family","2006 ","110","57","53",
"68 s","Visiting and Joining Family","2007 ","74","43","31",
"68 s","Visiting and Joining Family","2008 ","67","29","38",
"68 s","Visiting and Joining Family","2009 ","25","11","14",
"68 s","Visiting and Joining Family","2010 ","12","5","7",
"68 s","Visiting and Joining Family","2011 ","42","17","25",
"68 s","Visiting and Joining Family","2012 ","171","67","104",
"68 s","Visiting and Joining Family","2013 ","159","55","104",
"68 s","Visiting and Joining Family","2014 ","46","22","24",
"68 s","Visiting and Joining Family","2015 ","46","26","20",
"68 s","Visiting and Joining Family","2016 ","51","23","28",
"68 s","Visiting and Joining Family","2017 ","75","38","37",
"68 s","Visiting and Joining Family","2018 ","83","46","37",
"68 s","Visiting and Joining Family","2019 ","76","48","28",
"68 s","Overseas Koreans","2000 ","11","9","2",
"68 s","Overseas Koreans","2001 ","14","7","7",
"68 s","Overseas Koreans","2002 ","7","5","2",
"68 s","Overseas Koreans","2003 ","23","13","10",
"68 s","Overseas Koreans","2004 ","23","14","9",
"68 s","Overseas Koreans","2005 ","26","14","12",
"68 s","Overseas Koreans","2006 ","29","18","11",
"68 s","Overseas Koreans","2007 ","39","20","19",
"68 s","Overseas Koreans","2008 ","46","20","26",
"68 s","Overseas Koreans","2009 ","59","28","31",
"68 s","Overseas Koreans","2010 ","57","28","29",
"68 s","Overseas Koreans","2011 ","120","62","58",
"68 s","Overseas Koreans","2012 ","214","121","93",
"68 s","Overseas Koreans","2013 ","353","202","151",
"68 s","Overseas Koreans","2014 ","709","362","347",
"68 s","Overseas Koreans","2015 ","1032","439","593",
"68 s","Overseas Koreans","2016 ","1037","449","588",
"68 s","Overseas Koreans","2017 ","1258","550","708",
"68 s","Overseas Koreans","2018 ","1368","591","777",
"68 s","Overseas Koreans","2019 ","1391","619","772",
"68 s","Permanent Residence","2000 ","0","0","0",
"68 s","Permanent Residence","2001 ","0","0","0",
"68 s","Permanent Residence","2002 ","0","0","0",
"68 s","Permanent Residence","2003 ","1","0","1",
"68 s","Permanent Residence","2004 ","5","2","3",
"68 s","Permanent Residence","2005 ","6","5","1",
"68 s","Permanent Residence","2006 ","6","3","3",
"68 s","Permanent Residence","2007 ","3","2","1",
"68 s","Permanent Residence","2008 ","9","4","5",
"68 s","Permanent Residence","2009 ","4","1","3",
"68 s","Permanent Residence","2010 ","3","2","1",
"68 s","Permanent Residence","2011 ","10","5","5",
"68 s","Permanent Residence","2012 ","16","11","5",
"68 s","Permanent Residence","2013 ","22","13","9",
"68 s","Permanent Residence","2014 ","34","20","14",
"68 s","Permanent Residence","2015 ","39","26","13",
"68 s","Permanent Residence","2016 ","34","15","19",
"68 s","Permanent Residence","2017 ","50","21","29",
"68 s","Permanent Residence","2018 ","53","32","21",
"68 s","Permanent Residence","2019 ","44","25","19",
"68 s","Marriage Immigration","2011 ","2","2","",
"68 s","Marriage Immigration","2012 ","10","3","7",
"68 s","Marriage Immigration","2013 ","14","11","3",
"68 s","Marriage Immigration","2014 ","9","6","3",
"68 s","Marriage Immigration","2015 ","8","5","3",
"68 s","Marriage Immigration","2016 ","7","5","2",
"68 s","Marriage Immigration","2017 ","13","11","2",
"68 s","Marriage Immigration","2018 ","22","15","7",
"68 s","Marriage Immigration","2019 ","10","9","1",
"69 s","Total","2000 ","326","175","151",
"69 s","Total","2001 ","263","158","105",
"69 s","Total","2002 ","297","164","133",
"69 s","Total","2003 ","331","179","152",
"69 s","Total","2004 ","359","178","181",
"69 s","Total","2005 ","557","267","290",
"69 s","Total","2006 ","516","235","281",
"69 s","Total","2007 ","592","270","322",
"69 s","Total","2008 ","655","313","342",
"69 s","Total","2009 ","400","195","205",
"69 s","Total","2010 ","449","220","229",
"69 s","Total","2011 ","601","306","295",
"69 s","Total","2012 ","732","334","398",
"69 s","Total","2013 ","665","314","351",
"69 s","Total","2014 ","821","389","432",
"69 s","Total","2015 ","1029","484","545",
"69 s","Total","2016 ","1348","581","767",
"69 s","Total","2017 ","1226","544","682",
"69 s","Total","2018 ","1412","606","806",
"69 s","Total","2019 ","1544","665","879",
"69 s","Sightseeing Pass","2000 ","61","34","27",
"69 s","Sightseeing Pass","2001 ","70","46","24",
"69 s","Sightseeing Pass","2002 ","69","47","22",
"69 s","Sightseeing Pass","2003 ","60","37","23",
"69 s","Sightseeing Pass","2004 ","61","37","24",
"69 s","Sightseeing Pass","2005 ","73","41","32",
"69 s","Sightseeing Pass","2006 ","51","23","28",
"69 s","Sightseeing Pass","2007 ","39","21","18",
"69 s","Sightseeing Pass","2008 ","40","25","15",
"69 s","Sightseeing Pass","2009 ","53","28","25",
"69 s","Sightseeing Pass","2010 ","67","38","29",
"69 s","Sightseeing Pass","2011 ","81","48","33",
"69 s","Sightseeing Pass","2012 ","124","62","62",
"69 s","Sightseeing Pass","2013 ","82","34","48",
"69 s","Sightseeing Pass","2014 ","69","35","34",
"69 s","Sightseeing Pass","2015 ","63","33","30",
"69 s","Sightseeing Pass","2016 ","104","44","60",
"69 s","Sightseeing Pass","2017 ","74","45","29",
"69 s","Sightseeing Pass","2018 ","66","25","41",
"69 s","Sightseeing Pass","2019 ","68","35","33",
"69 s","Short-term Business","2000 ","1","1","0",
"69 s","Short-term Business","2001 ","4","4","0",
"69 s","Short-term Business","2002 ","3","3","0",
"69 s","Short-term Business","2003 ","2","2","0",
"69 s","Short-term Business","2004 ","5","3","2",
"69 s","Short-term Business","2005 ","1","1","0",
"69 s","Short-term Business","2006 ","1","1","0",
"69 s","Short-term Business","2007 ","1","1","0",
"69 s","Short-term Business","2008 ","0","0","0",
"69 s","Short-term Business","2009 ","0","0","0",
"69 s","Short-term Business","2010 ","0","0","0",
"69 s","Short-term Visitors","2000 ","156","83","73",
"69 s","Short-term Visitors","2001 ","76","37","39",
"69 s","Short-term Visitors","2002 ","129","59","70",
"69 s","Short-term Visitors","2003 ","203","100","103",
"69 s","Short-term Visitors","2004 ","201","83","118",
"69 s","Short-term Visitors","2005 ","311","128","183",
"69 s","Short-term Visitors","2006 ","288","114","174",
"69 s","Short-term Visitors","2007 ","237","97","140",
"69 s","Short-term Visitors","2008 ","87","42","45",
"69 s","Short-term Visitors","2009 ","97","40","57",
"69 s","Short-term Visitors","2010 ","91","31","60",
"69 s","Short-term Visitors","2011 ","141","45","96",
"69 s","Short-term Visitors","2012 ","73","26","47",
"69 s","Short-term Visitors","2013 ","65","29","36",
"69 s","Short-term Visitors","2014 ","73","27","46",
"69 s","Short-term Visitors","2015 ","85","37","48",
"69 s","Short-term Visitors","2016 ","92","35","57",
"69 s","Short-term Visitors","2017 ","69","22","47",
"69 s","Short-term Visitors","2018 ","74","30","44",
"69 s","Short-term Visitors","2019 ","73","29","44",
"69 s","Short-term Employment","2000 ","0","0","0",
"69 s","Short-term Employment","2001 ","0","0","0",
"69 s","Short-term Employment","2002 ","0","0","0",
"69 s","Short-term Employment","2003 ","0","0","0",
"69 s","Short-term Employment","2004 ","0","0","0",
"69 s","Short-term Employment","2005 ","1","1","0",
"69 s","Short-term Employment","2006 ","1","1","0",
"69 s","Short-term Employment","2007 ","0","0","0",
"69 s","Short-term Employment","2008 ","0","0","0",
"69 s","Short-term Employment","2009 ","0","0","0",
"69 s","Short-term Employment","2010 ","0","0","0",
"69 s","Short-term Employment","2019 ","1","1","0",
"69 s","Job Seeking","2000 ","0","0","0",
"69 s","Job Seeking","2001 ","0","0","0",
"69 s","Job Seeking","2002 ","0","0","0",
"69 s","Job Seeking","2003 ","0","0","0",
"69 s","Job Seeking","2004 ","0","0","0",
"69 s","Job Seeking","2005 ","0","0","0",
"69 s","Job Seeking","2006 ","0","0","0",
"69 s","Job Seeking","2007 ","0","0","0",
"69 s","Job Seeking","2008 ","0","0","0",
"69 s","Job Seeking","2009 ","0","0","0",
"69 s","Job Seeking","2010 ","0","0","0",
"69 s","study","2000 ","0","0","0",
"69 s","study","2001 ","0","0","0",
"69 s","study","2002 ","0","0","0",
"69 s","study","2003 ","0","0","0",
"69 s","study","2004 ","0","0","0",
"69 s","study","2005 ","1","0","1",
"69 s","study","2006 ","0","0","0",
"69 s","study","2007 ","0","0","0",
"69 s","study","2008 ","0","0","0",
"69 s","study","2009 ","0","0","0",
"69 s","study","2010 ","0","0","0",
"69 s","study","2016 ","1","1","0",
"69 s","General Trainees","2000 ","0","0","0",
"69 s","General Trainees","2001 ","0","0","0",
"69 s","General Trainees","2002 ","0","0","0",
"69 s","General Trainees","2003 ","0","0","0",
"69 s","General Trainees","2004 ","0","0","0",
"69 s","General Trainees","2005 ","0","0","0",
"69 s","General Trainees","2006 ","0","0","0",
"69 s","General Trainees","2007 ","0","0","0",
"69 s","General Trainees","2008 ","0","0","0",
"69 s","General Trainees","2009 ","0","0","0",
"69 s","General Trainees","2010 ","2","0","2",
"69 s","General Trainees","2016 ","1","1","0",
"69 s","General Trainees","2019 ","1","0","1",
"69 s","Religious Activities","2000 ","4","1","3",
"69 s","Religious Activities","2001 ","6","2","4",
"69 s","Religious Activities","2002 ","1","1","0",
"69 s","Religious Activities","2003 ","3","2","1",
"69 s","Religious Activities","2004 ","2","1","1",
"69 s","Religious Activities","2005 ","4","3","1",
"69 s","Religious Activities","2006 ","3","2","1",
"69 s","Religious Activities","2007 ","1","1","0",
"69 s","Religious Activities","2008 ","3","3","0",
"69 s","Religious Activities","2009 ","2","2","0",
"69 s","Religious Activities","2010 ","2","2","0",
"69 s","Religious Activities","2011 ","6","5","1",
"69 s","Religious Activities","2013 ","4","4","0",
"69 s","Religious Activities","2014 ","2","2","0",
"69 s","Religious Activities","2015 ","1","1","0",
"69 s","Religious Activities","2016 ","1","1","0",
"69 s","Religious Activities","2017 ","5","2","3",
"69 s","Religious Activities","2018 ","4","4","0",
"69 s","Religious Activities","2019 ","1","0","1",
"69 s","Investors","2000 ","0","0","0",
"69 s","Investors","2001 ","1","1","0",
"69 s","Investors","2002 ","0","0","0",
"69 s","Investors","2003 ","0","0","0",
"69 s","Investors","2004 ","3","3","0",
"69 s","Investors","2005 ","4","4","0",
"69 s","Investors","2006 ","0","0","0",
"69 s","Investors","2007 ","0","0","0",
"69 s","Investors","2008 ","0","0","0",
"69 s","Investors","2009 ","0","0","0",
"69 s","Investors","2010 ","0","0","0",
"69 s","Investors","2012 ","1","1","",
"69 s","Trade and Business","2000 ","0","0","0",
"69 s","Trade and Business","2001 ","0","0","0",
"69 s","Trade and Business","2002 ","0","0","0",
"69 s","Trade and Business","2003 ","2","2","0",
"69 s","Trade and Business","2004 ","0","0","0",
"69 s","Trade and Business","2005 ","2","2","0",
"69 s","Trade and Business","2006 ","1","1","0",
"69 s","Trade and Business","2007 ","0","0","0",
"69 s","Trade and Business","2008 ","1","1","0",
"69 s","Trade and Business","2009 ","0","0","0",
"69 s","Trade and Business","2010 ","0","0","0",
"69 s","Trade and Business","2011 ","2","2","",
"69 s","Trade and Business","2012 ","1","1","",
"69 s","Trade and Business","2013 ","6","6","0",
"69 s","Trade and Business","2014 ","2","2","0",
"69 s","Trade and Business","2015 ","2","2","0",
"69 s","Trade and Business","2016 ","1","1","0",
"69 s","Trade and Business","2018 ","2","2","0",
"69 s","Trade and Business","2019 ","1","1","0",
"69 s","Research","2000 ","0","0","0",
"69 s","Research","2001 ","0","0","0",
"69 s","Research","2002 ","0","0","0",
"69 s","Research","2003 ","1","1","0",
"69 s","Research","2004 ","1","1","0",
"69 s","Research","2005 ","1","1","0",
"69 s","Research","2006 ","0","0","0",
"69 s","Research","2007 ","0","0","0",
"69 s","Research","2008 ","1","1","0",
"69 s","Research","2009 ","0","0","0",
"69 s","Research","2010 ","0","0","0",
"69 s","Research","2013 ","1","1","0",
"69 s","Art and Entertainment","2000 ","0","0","0",
"69 s","Art and Entertainment","2001 ","0","0","0",
"69 s","Art and Entertainment","2002 ","0","0","0",
"69 s","Art and Entertainment","2003 ","0","0","0",
"69 s","Art and Entertainment","2004 ","0","0","0",
"69 s","Art and Entertainment","2005 ","0","0","0",
"69 s","Art and Entertainment","2006 ","0","0","0",
"69 s","Art and Entertainment","2007 ","0","0","0",
"69 s","Art and Entertainment","2008 ","0","0","0",
"69 s","Art and Entertainment","2009 ","0","0","0",
"69 s","Art and Entertainment","2010 ","1","1","0",
"69 s","Art and Entertainment","2019 ","1","1","0",
"69 s","Unskilled Employment","2000 ","0","0","0",
"69 s","Unskilled Employment","2001 ","0","0","0",
"69 s","Unskilled Employment","2002 ","0","0","0",
"69 s","Unskilled Employment","2003 ","0","0","0",
"69 s","Unskilled Employment","2004 ","0","0","0",
"69 s","Unskilled Employment","2005 ","1","1","0",
"69 s","Unskilled Employment","2006 ","0","0","0",
"69 s","Unskilled Employment","2007 ","1","1","0",
"69 s","Unskilled Employment","2008 ","0","0","0",
"69 s","Unskilled Employment","2009 ","0","0","0",
"69 s","Unskilled Employment","2010 ","0","0","0",
"69 s","Visiting and Joining Family","2000 ","59","30","29",
"69 s","Visiting and Joining Family","2001 ","75","51","24",
"69 s","Visiting and Joining Family","2002 ","43","30","13",
"69 s","Visiting and Joining Family","2003 ","22","13","9",
"69 s","Visiting and Joining Family","2004 ","36","24","12",
"69 s","Visiting and Joining Family","2005 ","89","55","34",
"69 s","Visiting and Joining Family","2006 ","109","63","46",
"69 s","Visiting and Joining Family","2007 ","84","33","51",
"69 s","Visiting and Joining Family","2008 ","58","24","34",
"69 s","Visiting and Joining Family","2009 ","22","10","12",
"69 s","Visiting and Joining Family","2010 ","8","3","5",
"69 s","Visiting and Joining Family","2011 ","44","15","29",
"69 s","Visiting and Joining Family","2012 ","178","65","113",
"69 s","Visiting and Joining Family","2013 ","134","47","87",
"69 s","Visiting and Joining Family","2014 ","40","18","22",
"69 s","Visiting and Joining Family","2015 ","34","19","15",
"69 s","Visiting and Joining Family","2016 ","53","24","29",
"69 s","Visiting and Joining Family","2017 ","49","22","27",
"69 s","Visiting and Joining Family","2018 ","55","24","31",
"69 s","Visiting and Joining Family","2019 ","56","29","27",
"69 s","Overseas Koreans","2000 ","4","2","2",
"69 s","Overseas Koreans","2001 ","10","5","5",
"69 s","Overseas Koreans","2002 ","18","4","14",
"69 s","Overseas Koreans","2003 ","15","12","3",
"69 s","Overseas Koreans","2004 ","23","12","11",
"69 s","Overseas Koreans","2005 ","25","11","14",
"69 s","Overseas Koreans","2006 ","28","12","16",
"69 s","Overseas Koreans","2007 ","37","20","17",
"69 s","Overseas Koreans","2008 ","52","27","25",
"69 s","Overseas Koreans","2009 ","53","27","26",
"69 s","Overseas Koreans","2010 ","57","31","26",
"69 s","Overseas Koreans","2011 ","94","54","40",
"69 s","Overseas Koreans","2012 ","175","86","89",
"69 s","Overseas Koreans","2013 ","303","156","147",
"69 s","Overseas Koreans","2014 ","570","267","303",
"69 s","Overseas Koreans","2015 ","793","361","432",
"69 s","Overseas Koreans","2016 ","1031","439","592",
"69 s","Overseas Koreans","2017 ","964","416","548",
"69 s","Overseas Koreans","2018 ","1137","485","652",
"69 s","Overseas Koreans","2019 ","1236","510","726",
"69 s","Permanent Residence","2000 ","0","0","0",
"69 s","Permanent Residence","2001 ","0","0","0",
"69 s","Permanent Residence","2002 ","0","0","0",
"69 s","Permanent Residence","2003 ","4","1","3",
"69 s","Permanent Residence","2004 ","6","3","3",
"69 s","Permanent Residence","2005 ","7","2","5",
"69 s","Permanent Residence","2006 ","2","1","1",
"69 s","Permanent Residence","2007 ","7","3","4",
"69 s","Permanent Residence","2008 ","7","4","3",
"69 s","Permanent Residence","2009 ","2","1","1",
"69 s","Permanent Residence","2010 ","5","3","2",
"69 s","Permanent Residence","2011 ","7","1","6",
"69 s","Permanent Residence","2012 ","11","7","4",
"69 s","Permanent Residence","2013 ","13","9","4",
"69 s","Permanent Residence","2014 ","21","11","10",
"69 s","Permanent Residence","2015 ","22","11","11",
"69 s","Permanent Residence","2016 ","27","14","13",
"69 s","Permanent Residence","2017 ","32","16","16",
"69 s","Permanent Residence","2018 ","47","21","26",
"69 s","Permanent Residence","2019 ","57","30","27",
"69 s","Marriage Immigration","2012 ","6","3","3",
"69 s","Marriage Immigration","2013 ","5","3","2",
"69 s","Marriage Immigration","2014 ","12","8","4",
"69 s","Marriage Immigration","2015 ","4","3","1",
"69 s","Marriage Immigration","2016 ","6","4","2",
"69 s","Marriage Immigration","2017 ","15","14","1",
"69 s","Marriage Immigration","2018 ","6","6","0",
"69 s","Marriage Immigration","2019 ","19","17","2",
"70 s","Total","2000 ","252","136","116",
"70 s","Total","2001 ","209","123","86",
"70 s","Total","2002 ","220","112","108",
"70 s","Total","2003 ","263","119","144",
"70 s","Total","2004 ","333","161","172",
"70 s","Total","2005 ","437","199","238",
"70 s","Total","2006 ","395","172","223",
"70 s","Total","2007 ","467","209","258",
"70 s","Total","2008 ","547","233","314",
"70 s","Total","2009 ","413","229","184",
"70 s","Total","2010 ","404","185","219",
"70 s","Total","2011 ","556","262","294",
"70 s","Total","2012 ","632","278","354",
"70 s","Total","2013 ","633","272","361",
"70 s","Total","2014 ","793","336","457",
"70 s","Total","2015 ","816","327","489",
"70 s","Total","2016 ","986","444","542",
"70 s","Total","2017 ","1132","496","636",
"70 s","Total","2018 ","1128","462","666",
"70 s","Total","2019 ","1229","509","720",
"70 s","Sightseeing Pass","2000 ","49","33","16",
"70 s","Sightseeing Pass","2001 ","62","40","22",
"70 s","Sightseeing Pass","2002 ","51","35","16",
"70 s","Sightseeing Pass","2003 ","47","24","23",
"70 s","Sightseeing Pass","2004 ","62","32","30",
"70 s","Sightseeing Pass","2005 ","52","29","23",
"70 s","Sightseeing Pass","2006 ","41","25","16",
"70 s","Sightseeing Pass","2007 ","29","16","13",
"70 s","Sightseeing Pass","2008 ","36","18","18",
"70 s","Sightseeing Pass","2009 ","61","32","29",
"70 s","Sightseeing Pass","2010 ","56","24","32",
"70 s","Sightseeing Pass","2011 ","85","39","46",
"70 s","Sightseeing Pass","2012 ","91","43","48",
"70 s","Sightseeing Pass","2013 ","64","31","33",
"70 s","Sightseeing Pass","2014 ","61","31","30",
"70 s","Sightseeing Pass","2015 ","63","23","40",
"70 s","Sightseeing Pass","2016 ","77","39","38",
"70 s","Sightseeing Pass","2017 ","66","37","29",
"70 s","Sightseeing Pass","2018 ","74","28","46",
"70 s","Sightseeing Pass","2019 ","61","28","33",
"70 s","Short-term Business","2000 ","3","2","1",
"70 s","Short-term Business","2001 ","2","2","0",
"70 s","Short-term Business","2002 ","2","1","1",
"70 s","Short-term Business","2003 ","4","4","0",
"70 s","Short-term Business","2004 ","2","1","1",
"70 s","Short-term Business","2005 ","4","3","1",
"70 s","Short-term Business","2006 ","5","3","2",
"70 s","Short-term Business","2007 ","3","1","2",
"70 s","Short-term Business","2008 ","3","2","1",
"70 s","Short-term Business","2009 ","1","1","0",
"70 s","Short-term Business","2010 ","0","0","0",
"70 s","Short-term Business","2011 ","1","1","",
"70 s","Short-term Visitors","2000 ","112","49","63",
"70 s","Short-term Visitors","2001 ","61","33","28",
"70 s","Short-term Visitors","2002 ","87","34","53",
"70 s","Short-term Visitors","2003 ","135","64","71",
"70 s","Short-term Visitors","2004 ","181","79","102",
"70 s","Short-term Visitors","2005 ","254","96","158",
"70 s","Short-term Visitors","2006 ","210","72","138",
"70 s","Short-term Visitors","2007 ","180","70","110",
"70 s","Short-term Visitors","2008 ","82","23","59",
"70 s","Short-term Visitors","2009 ","86","43","43",
"70 s","Short-term Visitors","2010 ","113","37","76",
"70 s","Short-term Visitors","2011 ","139","47","92",
"70 s","Short-term Visitors","2012 ","54","20","34",
"70 s","Short-term Visitors","2013 ","67","29","38",
"70 s","Short-term Visitors","2014 ","65","26","39",
"70 s","Short-term Visitors","2015 ","49","20","29",
"70 s","Short-term Visitors","2016 ","66","30","36",
"70 s","Short-term Visitors","2017 ","57","28","29",
"70 s","Short-term Visitors","2018 ","75","29","46",
"70 s","Short-term Visitors","2019 ","68","16","52",
"70 s","Short-term Employment","2000 ","1","0","1",
"70 s","Short-term Employment","2001 ","1","1","0",
"70 s","Short-term Employment","2002 ","0","0","0",
"70 s","Short-term Employment","2003 ","0","0","0",
"70 s","Short-term Employment","2004 ","0","0","0",
"70 s","Short-term Employment","2005 ","0","0","0",
"70 s","Short-term Employment","2006 ","0","0","0",
"70 s","Short-term Employment","2007 ","0","0","0",
"70 s","Short-term Employment","2008 ","0","0","0",
"70 s","Short-term Employment","2009 ","0","0","0",
"70 s","Short-term Employment","2010 ","0","0","0",
"70 s","Job Seeking","2000 ","0","0","0",
"70 s","Job Seeking","2001 ","0","0","0",
"70 s","Job Seeking","2002 ","0","0","0",
"70 s","Job Seeking","2003 ","0","0","0",
"70 s","Job Seeking","2004 ","0","0","0",
"70 s","Job Seeking","2005 ","0","0","0",
"70 s","Job Seeking","2006 ","0","0","0",
"70 s","Job Seeking","2007 ","0","0","0",
"70 s","Job Seeking","2008 ","0","0","0",
"70 s","Job Seeking","2009 ","0","0","0",
"70 s","Job Seeking","2010 ","0","0","0",
"70 s","study","2000 ","0","0","0",
"70 s","study","2001 ","0","0","0",
"70 s","study","2002 ","0","0","0",
"70 s","study","2003 ","0","0","0",
"70 s","study","2004 ","0","0","0",
"70 s","study","2005 ","0","0","0",
"70 s","study","2006 ","0","0","0",
"70 s","study","2007 ","0","0","0",
"70 s","study","2008 ","0","0","0",
"70 s","study","2009 ","0","0","0",
"70 s","study","2010 ","0","0","0",
"70 s","General Trainees","2000 ","0","0","0",
"70 s","General Trainees","2001 ","0","0","0",
"70 s","General Trainees","2002 ","0","0","0",
"70 s","General Trainees","2003 ","0","0","0",
"70 s","General Trainees","2004 ","0","0","0",
"70 s","General Trainees","2005 ","0","0","0",
"70 s","General Trainees","2006 ","1","1","0",
"70 s","General Trainees","2007 ","0","0","0",
"70 s","General Trainees","2008 ","0","0","0",
"70 s","General Trainees","2009 ","0","0","0",
"70 s","General Trainees","2010 ","0","0","0",
"70 s","General Trainees","2016 ","1","0","1",
"70 s","Religious Activities","2000 ","2","2","0",
"70 s","Religious Activities","2001 ","2","1","1",
"70 s","Religious Activities","2002 ","2","1","1",
"70 s","Religious Activities","2003 ","2","1","1",
"70 s","Religious Activities","2004 ","4","3","1",
"70 s","Religious Activities","2005 ","1","1","0",
"70 s","Religious Activities","2006 ","2","2","0",
"70 s","Religious Activities","2007 ","4","3","1",
"70 s","Religious Activities","2008 ","1","0","1",
"70 s","Religious Activities","2009 ","1","1","0",
"70 s","Religious Activities","2010 ","1","1","0",
"70 s","Religious Activities","2011 ","3","3","",
"70 s","Religious Activities","2012 ","1","1","",
"70 s","Religious Activities","2013 ","2","1","1",
"70 s","Religious Activities","2014 ","5","2","3",
"70 s","Religious Activities","2016 ","2","2","0",
"70 s","Religious Activities","2017 ","2","1","1",
"70 s","Religious Activities","2018 ","2","0","2",
"70 s","Religious Activities","2019 ","2","0","2",
"70 s","Investors","2000 ","0","0","0",
"70 s","Investors","2001 ","0","0","0",
"70 s","Investors","2002 ","0","0","0",
"70 s","Investors","2003 ","1","1","0",
"70 s","Investors","2004 ","0","0","0",
"70 s","Investors","2005 ","1","1","0",
"70 s","Investors","2006 ","0","0","0",
"70 s","Investors","2007 ","0","0","0",
"70 s","Investors","2008 ","0","0","0",
"70 s","Investors","2009 ","0","0","0",
"70 s","Investors","2010 ","0","0","0",
"70 s","Investors","2013 ","2","1","1",
"70 s","Trade and Business","2000 ","1","1","0",
"70 s","Trade and Business","2001 ","0","0","0",
"70 s","Trade and Business","2002 ","0","0","0",
"70 s","Trade and Business","2003 ","1","1","0",
"70 s","Trade and Business","2004 ","0","0","0",
"70 s","Trade and Business","2005 ","0","0","0",
"70 s","Trade and Business","2006 ","0","0","0",
"70 s","Trade and Business","2007 ","1","1","0",
"70 s","Trade and Business","2008 ","1","1","0",
"70 s","Trade and Business","2009 ","0","0","0",
"70 s","Trade and Business","2010 ","1","1","0",
"70 s","Trade and Business","2011 ","1","1","",
"70 s","Trade and Business","2012 ","1","1","",
"70 s","Trade and Business","2013 ","1","1","0",
"70 s","Trade and Business","2017 ","3","3","0",
"70 s","Trade and Business","2018 ","3","3","0",
"70 s","Trade and Business","2019 ","3","3","0",
"70 s","Research","2000 ","2","2","0",
"70 s","Research","2001 ","0","0","0",
"70 s","Research","2002 ","1","1","0",
"70 s","Research","2003 ","0","0","0",
"70 s","Research","2004 ","2","2","0",
"70 s","Research","2005 ","0","0","0",
"70 s","Research","2006 ","1","1","0",
"70 s","Research","2007 ","0","0","0",
"70 s","Research","2008 ","0","0","0",
"70 s","Research","2009 ","0","0","0",
"70 s","Research","2010 ","0","0","0",
"70 s","Research","2014 ","1","1","0",
"70 s","Research","2015 ","1","1","0",
"70 s","Research","2016 ","1","1","0",
"70 s","Research","2017 ","1","1","0",
"70 s","Art and Entertainment","2000 ","0","0","0",
"70 s","Art and Entertainment","2001 ","1","1","0",
"70 s","Art and Entertainment","2002 ","0","0","0",
"70 s","Art and Entertainment","2003 ","0","0","0",
"70 s","Art and Entertainment","2004 ","0","0","0",
"70 s","Art and Entertainment","2005 ","0","0","0",
"70 s","Art and Entertainment","2006 ","1","1","0",
"70 s","Art and Entertainment","2007 ","0","0","0",
"70 s","Art and Entertainment","2008 ","0","0","0",
"70 s","Art and Entertainment","2009 ","0","0","0",
"70 s","Art and Entertainment","2010 ","0","0","0",
"70 s","Art and Entertainment","2011 ","1","1","",
"70 s","Unskilled Employment","2000 ","0","0","0",
"70 s","Unskilled Employment","2001 ","0","0","0",
"70 s","Unskilled Employment","2002 ","0","0","0",
"70 s","Unskilled Employment","2003 ","0","0","0",
"70 s","Unskilled Employment","2004 ","2","2","0",
"70 s","Unskilled Employment","2005 ","1","1","0",
"70 s","Unskilled Employment","2006 ","0","0","0",
"70 s","Unskilled Employment","2007 ","0","0","0",
"70 s","Unskilled Employment","2008 ","0","0","0",
"70 s","Unskilled Employment","2009 ","0","0","0",
"70 s","Unskilled Employment","2010 ","0","0","0",
"70 s","Visiting and Joining Family","2000 ","47","27","20",
"70 s","Visiting and Joining Family","2001 ","48","30","18",
"70 s","Visiting and Joining Family","2002 ","28","12","16",
"70 s","Visiting and Joining Family","2003 ","28","8","20",
"70 s","Visiting and Joining Family","2004 ","35","18","17",
"70 s","Visiting and Joining Family","2005 ","71","37","34",
"70 s","Visiting and Joining Family","2006 ","81","35","46",
"70 s","Visiting and Joining Family","2007 ","68","29","39",
"70 s","Visiting and Joining Family","2008 ","58","26","32",
"70 s","Visiting and Joining Family","2009 ","20","8","12",
"70 s","Visiting and Joining Family","2010 ","9","4","5",
"70 s","Visiting and Joining Family","2011 ","42","19","23",
"70 s","Visiting and Joining Family","2012 ","177","51","126",
"70 s","Visiting and Joining Family","2013 ","170","55","115",
"70 s","Visiting and Joining Family","2014 ","33","13","20",
"70 s","Visiting and Joining Family","2015 ","27","13","14",
"70 s","Visiting and Joining Family","2016 ","36","12","24",
"70 s","Visiting and Joining Family","2017 ","40","17","23",
"70 s","Visiting and Joining Family","2018 ","33","18","15",
"70 s","Visiting and Joining Family","2019 ","39","23","16",
"70 s","Overseas Koreans","2000 ","5","3","2",
"70 s","Overseas Koreans","2001 ","14","5","9",
"70 s","Overseas Koreans","2002 ","21","14","7",
"70 s","Overseas Koreans","2003 ","18","3","15",
"70 s","Overseas Koreans","2004 ","16","10","6",
"70 s","Overseas Koreans","2005 ","20","10","10",
"70 s","Overseas Koreans","2006 ","25","15","10",
"70 s","Overseas Koreans","2007 ","41","22","19",
"70 s","Overseas Koreans","2008 ","42","16","26",
"70 s","Overseas Koreans","2009 ","63","44","19",
"70 s","Overseas Koreans","2010 ","56","30","26",
"70 s","Overseas Koreans","2011 ","84","45","39",
"70 s","Overseas Koreans","2012 ","155","84","71",
"70 s","Overseas Koreans","2013 ","252","114","138",
"70 s","Overseas Koreans","2014 ","579","240","339",
"70 s","Overseas Koreans","2015 ","639","250","389",
"70 s","Overseas Koreans","2016 ","752","334","418",
"70 s","Overseas Koreans","2017 ","898","366","532",
"70 s","Overseas Koreans","2018 ","878","357","521",
"70 s","Overseas Koreans","2019 ","984","405","579",
"70 s","Permanent Residence","2000 ","0","0","0",
"70 s","Permanent Residence","2001 ","0","0","0",
"70 s","Permanent Residence","2002 ","0","0","0",
"70 s","Permanent Residence","2003 ","3","1","2",
"70 s","Permanent Residence","2004 ","8","4","4",
"70 s","Permanent Residence","2005 ","7","3","4",
"70 s","Permanent Residence","2006 ","5","3","2",
"70 s","Permanent Residence","2007 ","3","2","1",
"70 s","Permanent Residence","2008 ","9","4","5",
"70 s","Permanent Residence","2009 ","9","4","5",
"70 s","Permanent Residence","2010 ","6","3","3",
"70 s","Permanent Residence","2011 ","5","1","4",
"70 s","Permanent Residence","2012 ","10","6","4",
"70 s","Permanent Residence","2013 ","12","5","7",
"70 s","Permanent Residence","2014 ","16","7","9",
"70 s","Permanent Residence","2015 ","10","6","4",
"70 s","Permanent Residence","2016 ","20","10","10",
"70 s","Permanent Residence","2017 ","34","24","10",
"70 s","Permanent Residence","2018 ","33","13","20",
"70 s","Permanent Residence","2019 ","35","13","22",
"70 s","Marriage Immigration","2012 ","10","8","2",
"70 s","Marriage Immigration","2013 ","12","6","6",
"70 s","Marriage Immigration","2014 ","15","9","6",
"70 s","Marriage Immigration","2015 ","9","5","4",
"70 s","Marriage Immigration","2016 ","6","2","4",
"70 s","Marriage Immigration","2017 ","5","3","2",
"70 s","Marriage Immigration","2018 ","6","3","3",
"70 s","Marriage Immigration","2019 ","11","9","2",
"71 s","Total","2000 ","201","95","106",
"71 s","Total","2001 ","163","85","78",
"71 s","Total","2002 ","182","98","84",
"71 s","Total","2003 ","220","102","118",
"71 s","Total","2004 ","254","117","137",
"71 s","Total","2005 ","419","185","234",
"71 s","Total","2006 ","330","131","199",
"71 s","Total","2007 ","344","154","190",
"71 s","Total","2008 ","411","199","212",
"71 s","Total","2009 ","304","144","160",
"71 s","Total","2010 ","351","169","182",
"71 s","Total","2011 ","465","198","267",
"71 s","Total","2012 ","588","247","341",
"71 s","Total","2013 ","596","260","336",
"71 s","Total","2014 ","673","292","381",
"71 s","Total","2015 ","743","302","441",
"71 s","Total","2016 ","808","322","486",
"71 s","Total","2017 ","884","368","516",
"71 s","Total","2018 ","1019","438","581",
"71 s","Total","2019 ","988","408","580",
"71 s","Sightseeing Pass","2000 ","41","20","21",
"71 s","Sightseeing Pass","2001 ","42","24","18",
"71 s","Sightseeing Pass","2002 ","47","30","17",
"71 s","Sightseeing Pass","2003 ","45","24","21",
"71 s","Sightseeing Pass","2004 ","43","24","19",
"71 s","Sightseeing Pass","2005 ","66","33","33",
"71 s","Sightseeing Pass","2006 ","36","19","17",
"71 s","Sightseeing Pass","2007 ","22","11","11",
"71 s","Sightseeing Pass","2008 ","38","21","17",
"71 s","Sightseeing Pass","2009 ","47","18","29",
"71 s","Sightseeing Pass","2010 ","48","30","18",
"71 s","Sightseeing Pass","2011 ","63","28","35",
"71 s","Sightseeing Pass","2012 ","93","41","52",
"71 s","Sightseeing Pass","2013 ","79","39","40",
"71 s","Sightseeing Pass","2014 ","51","26","25",
"71 s","Sightseeing Pass","2015 ","62","27","35",
"71 s","Sightseeing Pass","2016 ","90","37","53",
"71 s","Sightseeing Pass","2017 ","37","20","17",
"71 s","Sightseeing Pass","2018 ","75","42","33",
"71 s","Sightseeing Pass","2019 ","62","28","34",
"71 s","Short-term Business","2000 ","2","1","1",
"71 s","Short-term Business","2001 ","0","0","0",
"71 s","Short-term Business","2002 ","1","1","0",
"71 s","Short-term Business","2003 ","0","0","0",
"71 s","Short-term Business","2004 ","0","0","0",
"71 s","Short-term Business","2005 ","2","2","0",
"71 s","Short-term Business","2006 ","0","0","0",
"71 s","Short-term Business","2007 ","1","1","0",
"71 s","Short-term Business","2008 ","0","0","0",
"71 s","Short-term Business","2009 ","0","0","0",
"71 s","Short-term Business","2010 ","0","0","0",
"71 s","Short-term Business","2011 ","2","1","1",
"71 s","Short-term Visitors","2000 ","94","38","56",
"71 s","Short-term Visitors","2001 ","41","17","24",
"71 s","Short-term Visitors","2002 ","77","31","46",
"71 s","Short-term Visitors","2003 ","114","49","65",
"71 s","Short-term Visitors","2004 ","130","55","75",
"71 s","Short-term Visitors","2005 ","243","95","148",
"71 s","Short-term Visitors","2006 ","194","65","129",
"71 s","Short-term Visitors","2007 ","138","52","86",
"71 s","Short-term Visitors","2008 ","56","22","34",
"71 s","Short-term Visitors","2009 ","87","34","53",
"71 s","Short-term Visitors","2010 ","102","39","63",
"71 s","Short-term Visitors","2011 ","138","44","94",
"71 s","Short-term Visitors","2012 ","59","21","38",
"71 s","Short-term Visitors","2013 ","67","22","45",
"71 s","Short-term Visitors","2014 ","48","17","31",
"71 s","Short-term Visitors","2015 ","53","19","34",
"71 s","Short-term Visitors","2016 ","47","22","25",
"71 s","Short-term Visitors","2017 ","40","17","23",
"71 s","Short-term Visitors","2018 ","51","24","27",
"71 s","Short-term Visitors","2019 ","55","19","36",
"71 s","Short-term Employment","2000 ","1","0","1",
"71 s","Short-term Employment","2001 ","0","0","0",
"71 s","Short-term Employment","2002 ","0","0","0",
"71 s","Short-term Employment","2003 ","0","0","0",
"71 s","Short-term Employment","2004 ","0","0","0",
"71 s","Short-term Employment","2005 ","0","0","0",
"71 s","Short-term Employment","2006 ","0","0","0",
"71 s","Short-term Employment","2007 ","1","0","1",
"71 s","Short-term Employment","2008 ","0","0","0",
"71 s","Short-term Employment","2009 ","0","0","0",
"71 s","Short-term Employment","2010 ","0","0","0",
"71 s","Job Seeking","2000 ","0","0","0",
"71 s","Job Seeking","2001 ","0","0","0",
"71 s","Job Seeking","2002 ","0","0","0",
"71 s","Job Seeking","2003 ","0","0","0",
"71 s","Job Seeking","2004 ","0","0","0",
"71 s","Job Seeking","2005 ","0","0","0",
"71 s","Job Seeking","2006 ","0","0","0",
"71 s","Job Seeking","2007 ","0","0","0",
"71 s","Job Seeking","2008 ","0","0","0",
"71 s","Job Seeking","2009 ","0","0","0",
"71 s","Job Seeking","2010 ","0","0","0",
"71 s","study","2000 ","0","0","0",
"71 s","study","2001 ","0","0","0",
"71 s","study","2002 ","1","0","1",
"71 s","study","2003 ","1","1","0",
"71 s","study","2004 ","0","0","0",
"71 s","study","2005 ","0","0","0",
"71 s","study","2006 ","0","0","0",
"71 s","study","2007 ","0","0","0",
"71 s","study","2008 ","0","0","0",
"71 s","study","2009 ","0","0","0",
"71 s","study","2010 ","0","0","0",
"71 s","General Trainees","2000 ","0","0","0",
"71 s","General Trainees","2001 ","0","0","0",
"71 s","General Trainees","2002 ","1","1","0",
"71 s","General Trainees","2003 ","0","0","0",
"71 s","General Trainees","2004 ","0","0","0",
"71 s","General Trainees","2005 ","0","0","0",
"71 s","General Trainees","2006 ","0","0","0",
"71 s","General Trainees","2007 ","0","0","0",
"71 s","General Trainees","2008 ","0","0","0",
"71 s","General Trainees","2009 ","0","0","0",
"71 s","General Trainees","2010 ","0","0","0",
"71 s","General Trainees","2014 ","1","1","0",
"71 s","Religious Activities","2000 ","2","1","1",
"71 s","Religious Activities","2001 ","2","2","0",
"71 s","Religious Activities","2002 ","5","3","2",
"71 s","Religious Activities","2003 ","2","0","2",
"71 s","Religious Activities","2004 ","3","0","3",
"71 s","Religious Activities","2005 ","1","1","0",
"71 s","Religious Activities","2006 ","2","1","1",
"71 s","Religious Activities","2007 ","2","0","2",
"71 s","Religious Activities","2008 ","4","3","1",
"71 s","Religious Activities","2009 ","2","2","0",
"71 s","Religious Activities","2010 ","1","1","0",
"71 s","Religious Activities","2011 ","2","1","1",
"71 s","Religious Activities","2012 ","1","1","",
"71 s","Religious Activities","2013 ","2","2","0",
"71 s","Religious Activities","2014 ","5","4","1",
"71 s","Religious Activities","2015 ","2","2","0",
"71 s","Religious Activities","2016 ","3","3","0",
"71 s","Religious Activities","2017 ","2","2","0",
"71 s","Religious Activities","2018 ","2","1","1",
"71 s","Religious Activities","2019 ","4","3","1",
"71 s","Investors","2000 ","0","0","0",
"71 s","Investors","2001 ","0","0","0",
"71 s","Investors","2002 ","0","0","0",
"71 s","Investors","2003 ","0","0","0",
"71 s","Investors","2004 ","0","0","0",
"71 s","Investors","2005 ","0","0","0",
"71 s","Investors","2006 ","0","0","0",
"71 s","Investors","2007 ","1","1","0",
"71 s","Investors","2008 ","0","0","0",
"71 s","Investors","2009 ","0","0","0",
"71 s","Investors","2010 ","0","0","0",
"71 s","Investors","2011 ","1","1","",
"71 s","Investors","2013 ","1","1","0",
"71 s","Investors","2016 ","1","1","0",
"71 s","Trade and Business","2000 ","0","0","0",
"71 s","Trade and Business","2001 ","0","0","0",
"71 s","Trade and Business","2002 ","0","0","0",
"71 s","Trade and Business","2003 ","0","0","0",
"71 s","Trade and Business","2004 ","0","0","0",
"71 s","Trade and Business","2005 ","0","0","0",
"71 s","Trade and Business","2006 ","0","0","0",
"71 s","Trade and Business","2007 ","0","0","0",
"71 s","Trade and Business","2008 ","0","0","0",
"71 s","Trade and Business","2009 ","0","0","0",
"71 s","Trade and Business","2010 ","1","1","0",
"71 s","Trade and Business","2011 ","1","1","",
"71 s","Trade and Business","2012 ","4","4","",
"71 s","Trade and Business","2014 ","1","1","0",
"71 s","Trade and Business","2015 ","1","1","0",
"71 s","Trade and Business","2016 ","1","1","0",
"71 s","Trade and Business","2018 ","2","2","0",
"71 s","Trade and Business","2019 ","1","1","0",
"71 s","Research","2000 ","1","1","0",
"71 s","Research","2001 ","0","0","0",
"71 s","Research","2002 ","0","0","0",
"71 s","Research","2003 ","1","1","0",
"71 s","Research","2004 ","0","0","0",
"71 s","Research","2005 ","0","0","0",
"71 s","Research","2006 ","0","0","0",
"71 s","Research","2007 ","1","1","0",
"71 s","Research","2008 ","0","0","0",
"71 s","Research","2009 ","0","0","0",
"71 s","Research","2010 ","0","0","0",
"71 s","Research","2012 ","1","1","",
"71 s","Research","2014 ","2","2","0",
"71 s","Research","2017 ","1","1","0",
"71 s","Research","2018 ","1","1","0",
"71 s","Art and Entertainment","2000 ","1","1","0",
"71 s","Art and Entertainment","2001 ","0","0","0",
"71 s","Art and Entertainment","2002 ","0","0","0",
"71 s","Art and Entertainment","2003 ","0","0","0",
"71 s","Art and Entertainment","2004 ","0","0","0",
"71 s","Art and Entertainment","2005 ","0","0","0",
"71 s","Art and Entertainment","2006 ","0","0","0",
"71 s","Art and Entertainment","2007 ","0","0","0",
"71 s","Art and Entertainment","2008 ","0","0","0",
"71 s","Art and Entertainment","2009 ","0","0","0",
"71 s","Art and Entertainment","2010 ","0","0","0",
"71 s","Art and Entertainment","2012 ","1","","1",
"71 s","Unskilled Employment","2000 ","0","0","0",
"71 s","Unskilled Employment","2001 ","0","0","0",
"71 s","Unskilled Employment","2002 ","0","0","0",
"71 s","Unskilled Employment","2003 ","0","0","0",
"71 s","Unskilled Employment","2004 ","0","0","0",
"71 s","Unskilled Employment","2005 ","0","0","0",
"71 s","Unskilled Employment","2006 ","0","0","0",
"71 s","Unskilled Employment","2007 ","0","0","0",
"71 s","Unskilled Employment","2008 ","0","0","0",
"71 s","Unskilled Employment","2009 ","0","0","0",
"71 s","Unskilled Employment","2010 ","0","0","0",
"71 s","Visiting and Joining Family","2000 ","32","15","17",
"71 s","Visiting and Joining Family","2001 ","41","18","23",
"71 s","Visiting and Joining Family","2002 ","25","17","8",
"71 s","Visiting and Joining Family","2003 ","20","10","10",
"71 s","Visiting and Joining Family","2004 ","32","16","16",
"71 s","Visiting and Joining Family","2005 ","64","35","29",
"71 s","Visiting and Joining Family","2006 ","57","24","33",
"71 s","Visiting and Joining Family","2007 ","73","34","39",
"71 s","Visiting and Joining Family","2008 ","54","22","32",
"71 s","Visiting and Joining Family","2009 ","22","10","12",
"71 s","Visiting and Joining Family","2010 ","13","9","4",
"71 s","Visiting and Joining Family","2011 ","39","15","24",
"71 s","Visiting and Joining Family","2012 ","172","55","117",
"71 s","Visiting and Joining Family","2013 ","155","44","111",
"71 s","Visiting and Joining Family","2014 ","34","18","16",
"71 s","Visiting and Joining Family","2015 ","14","6","8",
"71 s","Visiting and Joining Family","2016 ","22","12","10",
"71 s","Visiting and Joining Family","2017 ","31","20","11",
"71 s","Visiting and Joining Family","2018 ","17","10","7",
"71 s","Visiting and Joining Family","2019 ","28","12","16",
"71 s","Overseas Koreans","2000 ","5","2","3",
"71 s","Overseas Koreans","2001 ","15","10","5",
"71 s","Overseas Koreans","2002 ","8","2","6",
"71 s","Overseas Koreans","2003 ","15","5","10",
"71 s","Overseas Koreans","2004 ","11","7","4",
"71 s","Overseas Koreans","2005 ","8","4","4",
"71 s","Overseas Koreans","2006 ","23","13","10",
"71 s","Overseas Koreans","2007 ","30","18","12",
"71 s","Overseas Koreans","2008 ","39","22","17",
"71 s","Overseas Koreans","2009 ","40","24","16",
"71 s","Overseas Koreans","2010 ","46","27","19",
"71 s","Overseas Koreans","2011 ","73","39","34",
"71 s","Overseas Koreans","2012 ","146","69","77",
"71 s","Overseas Koreans","2013 ","232","115","117",
"71 s","Overseas Koreans","2014 ","498","204","294",
"71 s","Overseas Koreans","2015 ","566","226","340",
"71 s","Overseas Koreans","2016 ","593","216","377",
"71 s","Overseas Koreans","2017 ","740","292","448",
"71 s","Overseas Koreans","2018 ","829","330","499",
"71 s","Overseas Koreans","2019 ","792","315","477",
"71 s","Permanent Residence","2000 ","0","0","0",
"71 s","Permanent Residence","2001 ","0","0","0",
"71 s","Permanent Residence","2002 ","0","0","0",
"71 s","Permanent Residence","2003 ","4","3","1",
"71 s","Permanent Residence","2004 ","8","4","4",
"71 s","Permanent Residence","2005 ","4","1","3",
"71 s","Permanent Residence","2006 ","1","0","1",
"71 s","Permanent Residence","2007 ","5","3","2",
"71 s","Permanent Residence","2008 ","3","2","1",
"71 s","Permanent Residence","2009 ","3","3","0",
"71 s","Permanent Residence","2010 ","10","2","8",
"71 s","Permanent Residence","2011 ","8","5","3",
"71 s","Permanent Residence","2012 ","10","4","6",
"71 s","Permanent Residence","2013 ","14","7","7",
"71 s","Permanent Residence","2014 ","12","6","6",
"71 s","Permanent Residence","2015 ","15","5","10",
"71 s","Permanent Residence","2016 ","13","7","6",
"71 s","Permanent Residence","2017 ","24","13","11",
"71 s","Permanent Residence","2018 ","20","12","8",
"71 s","Permanent Residence","2019 ","29","19","10",
"71 s","Marriage Immigration","2012 ","9","4","5",
"71 s","Marriage Immigration","2013 ","9","6","3",
"71 s","Marriage Immigration","2014 ","4","4","0",
"71 s","Marriage Immigration","2015 ","8","6","2",
"71 s","Marriage Immigration","2016 ","6","5","1",
"71 s","Marriage Immigration","2017 ","3","2","1",
"71 s","Marriage Immigration","2018 ","4","4","0",
"71 s","Marriage Immigration","2019 ","5","5","0",
"72 s","Total","2000 ","186","90","96",
"72 s","Total","2001 ","154","80","74",
"72 s","Total","2002 ","154","66","88",
"72 s","Total","2003 ","190","94","96",
"72 s","Total","2004 ","206","83","123",
"72 s","Total","2005 ","356","149","207",
"72 s","Total","2006 ","270","122","148",
"72 s","Total","2007 ","275","114","161",
"72 s","Total","2008 ","381","171","210",
"72 s","Total","2009 ","253","115","138",
"72 s","Total","2010 ","327","138","189",
"72 s","Total","2011 ","445","212","233",
"72 s","Total","2012 ","534","209","325",
"72 s","Total","2013 ","549","231","318",
"72 s","Total","2014 ","673","263","410",
"72 s","Total","2015 ","736","287","449",
"72 s","Total","2016 ","719","284","435",
"72 s","Total","2017 ","704","274","430",
"72 s","Total","2018 ","851","376","475",
"72 s","Total","2019 ","852","342","510",
"72 s","Sightseeing Pass","2000 ","42","20","22",
"72 s","Sightseeing Pass","2001 ","43","27","16",
"72 s","Sightseeing Pass","2002 ","43","25","18",
"72 s","Sightseeing Pass","2003 ","53","29","24",
"72 s","Sightseeing Pass","2004 ","43","19","24",
"72 s","Sightseeing Pass","2005 ","54","27","27",
"72 s","Sightseeing Pass","2006 ","39","22","17",
"72 s","Sightseeing Pass","2007 ","20","11","9",
"72 s","Sightseeing Pass","2008 ","44","17","27",
"72 s","Sightseeing Pass","2009 ","32","14","18",
"72 s","Sightseeing Pass","2010 ","53","30","23",
"72 s","Sightseeing Pass","2011 ","75","29","46",
"72 s","Sightseeing Pass","2012 ","74","34","40",
"72 s","Sightseeing Pass","2013 ","73","41","32",
"72 s","Sightseeing Pass","2014 ","50","27","23",
"72 s","Sightseeing Pass","2015 ","63","28","35",
"72 s","Sightseeing Pass","2016 ","74","32","42",
"72 s","Sightseeing Pass","2017 ","37","15","22",
"72 s","Sightseeing Pass","2018 ","47","23","24",
"72 s","Sightseeing Pass","2019 ","55","26","29",
"72 s","Short-term Business","2000 ","0","0","0",
"72 s","Short-term Business","2001 ","3","0","3",
"72 s","Short-term Business","2002 ","2","2","0",
"72 s","Short-term Business","2003 ","2","2","0",
"72 s","Short-term Business","2004 ","4","2","2",
"72 s","Short-term Business","2005 ","2","1","1",
"72 s","Short-term Business","2006 ","0","0","0",
"72 s","Short-term Business","2007 ","0","0","0",
"72 s","Short-term Business","2008 ","0","0","0",
"72 s","Short-term Business","2009 ","0","0","0",
"72 s","Short-term Business","2010 ","0","0","0",
"72 s","Short-term Visitors","2000 ","88","38","50",
"72 s","Short-term Visitors","2001 ","45","20","25",
"72 s","Short-term Visitors","2002 ","61","14","47",
"72 s","Short-term Visitors","2003 ","79","30","49",
"72 s","Short-term Visitors","2004 ","113","38","75",
"72 s","Short-term Visitors","2005 ","202","68","134",
"72 s","Short-term Visitors","2006 ","144","52","92",
"72 s","Short-term Visitors","2007 ","116","45","71",
"72 s","Short-term Visitors","2008 ","68","24","44",
"72 s","Short-term Visitors","2009 ","55","25","30",
"72 s","Short-term Visitors","2010 ","102","35","67",
"72 s","Short-term Visitors","2011 ","114","45","69",
"72 s","Short-term Visitors","2012 ","48","19","29",
"72 s","Short-term Visitors","2013 ","51","20","31",
"72 s","Short-term Visitors","2014 ","38","19","19",
"72 s","Short-term Visitors","2015 ","28","9","19",
"72 s","Short-term Visitors","2016 ","49","17","32",
"72 s","Short-term Visitors","2017 ","27","12","15",
"72 s","Short-term Visitors","2018 ","35","19","16",
"72 s","Short-term Visitors","2019 ","34","14","20",
"72 s","Short-term Employment","2000 ","0","0","0",
"72 s","Short-term Employment","2001 ","0","0","0",
"72 s","Short-term Employment","2002 ","0","0","0",
"72 s","Short-term Employment","2003 ","0","0","0",
"72 s","Short-term Employment","2004 ","1","1","0",
"72 s","Short-term Employment","2005 ","0","0","0",
"72 s","Short-term Employment","2006 ","0","0","0",
"72 s","Short-term Employment","2007 ","0","0","0",
"72 s","Short-term Employment","2008 ","0","0","0",
"72 s","Short-term Employment","2009 ","0","0","0",
"72 s","Short-term Employment","2010 ","0","0","0",
"72 s","Job Seeking","2000 ","0","0","0",
"72 s","Job Seeking","2001 ","0","0","0",
"72 s","Job Seeking","2002 ","0","0","0",
"72 s","Job Seeking","2003 ","0","0","0",
"72 s","Job Seeking","2004 ","0","0","0",
"72 s","Job Seeking","2005 ","0","0","0",
"72 s","Job Seeking","2006 ","0","0","0",
"72 s","Job Seeking","2007 ","0","0","0",
"72 s","Job Seeking","2008 ","0","0","0",
"72 s","Job Seeking","2009 ","0","0","0",
"72 s","Job Seeking","2010 ","0","0","0",
"72 s","study","2000 ","0","0","0",
"72 s","study","2001 ","0","0","0",
"72 s","study","2002 ","0","0","0",
"72 s","study","2003 ","0","0","0",
"72 s","study","2004 ","0","0","0",
"72 s","study","2005 ","0","0","0",
"72 s","study","2006 ","0","0","0",
"72 s","study","2007 ","0","0","0",
"72 s","study","2008 ","0","0","0",
"72 s","study","2009 ","0","0","0",
"72 s","study","2010 ","0","0","0",
"72 s","study","2019 ","2","2","0",
"72 s","General Trainees","2000 ","0","0","0",
"72 s","General Trainees","2001 ","1","1","0",
"72 s","General Trainees","2002 ","0","0","0",
"72 s","General Trainees","2003 ","0","0","0",
"72 s","General Trainees","2004 ","1","1","0",
"72 s","General Trainees","2005 ","0","0","0",
"72 s","General Trainees","2006 ","0","0","0",
"72 s","General Trainees","2007 ","0","0","0",
"72 s","General Trainees","2008 ","0","0","0",
"72 s","General Trainees","2009 ","0","0","0",
"72 s","General Trainees","2010 ","0","0","0",
"72 s","General Trainees","2011 ","1","1","",
"72 s","Religious Activities","2000 ","1","1","0",
"72 s","Religious Activities","2001 ","2","1","1",
"72 s","Religious Activities","2002 ","3","2","1",
"72 s","Religious Activities","2003 ","2","2","0",
"72 s","Religious Activities","2004 ","1","1","0",
"72 s","Religious Activities","2005 ","1","1","0",
"72 s","Religious Activities","2006 ","1","1","0",
"72 s","Religious Activities","2007 ","0","0","0",
"72 s","Religious Activities","2008 ","3","3","0",
"72 s","Religious Activities","2009 ","2","0","2",
"72 s","Religious Activities","2010 ","0","0","0",
"72 s","Religious Activities","2011 ","4","3","1",
"72 s","Religious Activities","2014 ","1","1","0",
"72 s","Religious Activities","2015 ","2","1","1",
"72 s","Religious Activities","2017 ","2","1","1",
"72 s","Investors","2000 ","0","0","0",
"72 s","Investors","2001 ","0","0","0",
"72 s","Investors","2002 ","1","1","0",
"72 s","Investors","2003 ","0","0","0",
"72 s","Investors","2004 ","1","1","0",
"72 s","Investors","2005 ","1","1","0",
"72 s","Investors","2006 ","0","0","0",
"72 s","Investors","2007 ","0","0","0",
"72 s","Investors","2008 ","0","0","0",
"72 s","Investors","2009 ","0","0","0",
"72 s","Investors","2010 ","0","0","0",
"72 s","Investors","2014 ","1","1","0",
"72 s","Trade and Business","2000 ","1","1","0",
"72 s","Trade and Business","2001 ","0","0","0",
"72 s","Trade and Business","2002 ","0","0","0",
"72 s","Trade and Business","2003 ","0","0","0",
"72 s","Trade and Business","2004 ","0","0","0",
"72 s","Trade and Business","2005 ","0","0","0",
"72 s","Trade and Business","2006 ","0","0","0",
"72 s","Trade and Business","2007 ","1","1","0",
"72 s","Trade and Business","2008 ","1","1","0",
"72 s","Trade and Business","2009 ","1","1","0",
"72 s","Trade and Business","2010 ","1","1","0",
"72 s","Trade and Business","2011 ","1","1","",
"72 s","Trade and Business","2014 ","1","1","0",
"72 s","Trade and Business","2015 ","1","1","0",
"72 s","Trade and Business","2018 ","1","1","0",
"72 s","Trade and Business","2019 ","2","2","0",
"72 s","Research","2000 ","0","0","0",
"72 s","Research","2001 ","0","0","0",
"72 s","Research","2002 ","1","1","0",
"72 s","Research","2003 ","1","1","0",
"72 s","Research","2004 ","0","0","0",
"72 s","Research","2005 ","0","0","0",
"72 s","Research","2006 ","1","1","0",
"72 s","Research","2007 ","0","0","0",
"72 s","Research","2008 ","0","0","0",
"72 s","Research","2009 ","0","0","0",
"72 s","Research","2010 ","0","0","0",
"72 s","Research","2013 ","1","1","0",
"72 s","Research","2018 ","1","1","0",
"72 s","Research","2019 ","1","1","0",
"72 s","Art and Entertainment","2000 ","0","0","0",
"72 s","Art and Entertainment","2001 ","0","0","0",
"72 s","Art and Entertainment","2002 ","1","0","1",
"72 s","Art and Entertainment","2003 ","0","0","0",
"72 s","Art and Entertainment","2004 ","0","0","0",
"72 s","Art and Entertainment","2005 ","0","0","0",
"72 s","Art and Entertainment","2006 ","0","0","0",
"72 s","Art and Entertainment","2007 ","0","0","0",
"72 s","Art and Entertainment","2008 ","0","0","0",
"72 s","Art and Entertainment","2009 ","0","0","0",
"72 s","Art and Entertainment","2010 ","0","0","0",
"72 s","Unskilled Employment","2000 ","0","0","0",
"72 s","Unskilled Employment","2001 ","0","0","0",
"72 s","Unskilled Employment","2002 ","0","0","0",
"72 s","Unskilled Employment","2003 ","0","0","0",
"72 s","Unskilled Employment","2004 ","0","0","0",
"72 s","Unskilled Employment","2005 ","0","0","0",
"72 s","Unskilled Employment","2006 ","0","0","0",
"72 s","Unskilled Employment","2007 ","0","0","0",
"72 s","Unskilled Employment","2008 ","1","0","1",
"72 s","Unskilled Employment","2009 ","0","0","0",
"72 s","Unskilled Employment","2010 ","0","0","0",
"72 s","Visiting and Joining Family","2000 ","25","11","14",
"72 s","Visiting and Joining Family","2001 ","34","17","17",
"72 s","Visiting and Joining Family","2002 ","13","5","8",
"72 s","Visiting and Joining Family","2003 ","21","13","8",
"72 s","Visiting and Joining Family","2004 ","15","7","8",
"72 s","Visiting and Joining Family","2005 ","44","28","16",
"72 s","Visiting and Joining Family","2006 ","51","30","21",
"72 s","Visiting and Joining Family","2007 ","54","28","26",
"72 s","Visiting and Joining Family","2008 ","58","28","30",
"72 s","Visiting and Joining Family","2009 ","24","8","16",
"72 s","Visiting and Joining Family","2010 ","8","3","5",
"72 s","Visiting and Joining Family","2011 ","43","17","26",
"72 s","Visiting and Joining Family","2012 ","200","56","144",
"72 s","Visiting and Joining Family","2013 ","142","34","108",
"72 s","Visiting and Joining Family","2014 ","35","16","19",
"72 s","Visiting and Joining Family","2015 ","13","5","8",
"72 s","Visiting and Joining Family","2016 ","19","10","9",
"72 s","Visiting and Joining Family","2017 ","23","10","13",
"72 s","Visiting and Joining Family","2018 ","18","14","4",
"72 s","Visiting and Joining Family","2019 ","13","11","2",
"72 s","Overseas Koreans","2000 ","7","5","2",
"72 s","Overseas Koreans","2001 ","7","3","4",
"72 s","Overseas Koreans","2002 ","11","6","5",
"72 s","Overseas Koreans","2003 ","11","5","6",
"72 s","Overseas Koreans","2004 ","11","5","6",
"72 s","Overseas Koreans","2005 ","21","7","14",
"72 s","Overseas Koreans","2006 ","14","7","7",
"72 s","Overseas Koreans","2007 ","19","10","9",
"72 s","Overseas Koreans","2008 ","37","25","12",
"72 s","Overseas Koreans","2009 ","46","22","24",
"72 s","Overseas Koreans","2010 ","41","23","18",
"72 s","Overseas Koreans","2011 ","69","42","27",
"72 s","Overseas Koreans","2012 ","106","45","61",
"72 s","Overseas Koreans","2013 ","219","105","114",
"72 s","Overseas Koreans","2014 ","505","180","325",
"72 s","Overseas Koreans","2015 ","592","226","366",
"72 s","Overseas Koreans","2016 ","534","196","338",
"72 s","Overseas Koreans","2017 ","583","218","365",
"72 s","Overseas Koreans","2018 ","717","300","417",
"72 s","Overseas Koreans","2019 ","705","263","442",
"72 s","Permanent Residence","2000 ","0","0","0",
"72 s","Permanent Residence","2001 ","0","0","0",
"72 s","Permanent Residence","2002 ","0","0","0",
"72 s","Permanent Residence","2003 ","1","1","0",
"72 s","Permanent Residence","2004 ","1","1","0",
"72 s","Permanent Residence","2005 ","5","3","2",
"72 s","Permanent Residence","2006 ","5","2","3",
"72 s","Permanent Residence","2007 ","6","1","5",
"72 s","Permanent Residence","2008 ","5","2","3",
"72 s","Permanent Residence","2009 ","1","1","0",
"72 s","Permanent Residence","2010 ","8","3","5",
"72 s","Permanent Residence","2011 ","8","5","3",
"72 s","Permanent Residence","2012 ","13","7","6",
"72 s","Permanent Residence","2013 ","17","7","10",
"72 s","Permanent Residence","2014 ","15","5","10",
"72 s","Permanent Residence","2015 ","17","7","10",
"72 s","Permanent Residence","2016 ","18","10","8",
"72 s","Permanent Residence","2017 ","16","7","9",
"72 s","Permanent Residence","2018 ","15","9","6",
"72 s","Permanent Residence","2019 ","20","10","10",
"72 s","Marriage Immigration","2012 ","5","4","1",
"72 s","Marriage Immigration","2013 ","9","5","4",
"72 s","Marriage Immigration","2014 ","10","5","5",
"72 s","Marriage Immigration","2015 ","4","3","1",
"72 s","Marriage Immigration","2016 ","5","4","1",
"72 s","Marriage Immigration","2017 ","6","3","3",
"72 s","Marriage Immigration","2018 ","3","3","0",
"72 s","Marriage Immigration","2019 ","7","7","0",
"73 s","Total","2000 ","124","61","63",
"73 s","Total","2001 ","137","64","73",
"73 s","Total","2002 ","138","72","66",
"73 s","Total","2003 ","153","77","76",
"73 s","Total","2004 ","164","80","84",
"73 s","Total","2005 ","269","105","164",
"73 s","Total","2006 ","246","87","159",
"73 s","Total","2007 ","268","105","163",
"73 s","Total","2008 ","324","120","204",
"73 s","Total","2009 ","185","88","97",
"73 s","Total","2010 ","222","100","122",
"73 s","Total","2011 ","385","146","239",
"73 s","Total","2012 ","490","216","274",
"73 s","Total","2013 ","475","188","287",
"73 s","Total","2014 ","596","213","383",
"73 s","Total","2015 ","671","254","417",
"73 s","Total","2016 ","715","274","441",
"73 s","Total","2017 ","614","232","382",
"73 s","Total","2018 ","656","260","396",
"73 s","Total","2019 ","743","301","442",
"73 s","Sightseeing Pass","2000 ","31","7","24",
"73 s","Sightseeing Pass","2001 ","46","29","17",
"73 s","Sightseeing Pass","2002 ","40","24","16",
"73 s","Sightseeing Pass","2003 ","48","35","13",
"73 s","Sightseeing Pass","2004 ","40","28","12",
"73 s","Sightseeing Pass","2005 ","43","27","16",
"73 s","Sightseeing Pass","2006 ","32","16","16",
"73 s","Sightseeing Pass","2007 ","25","10","15",
"73 s","Sightseeing Pass","2008 ","24","13","11",
"73 s","Sightseeing Pass","2009 ","17","10","7",
"73 s","Sightseeing Pass","2010 ","35","21","14",
"73 s","Sightseeing Pass","2011 ","60","26","34",
"73 s","Sightseeing Pass","2012 ","73","33","40",
"73 s","Sightseeing Pass","2013 ","66","29","37",
"73 s","Sightseeing Pass","2014 ","55","26","29",
"73 s","Sightseeing Pass","2015 ","61","24","37",
"73 s","Sightseeing Pass","2016 ","79","35","44",
"73 s","Sightseeing Pass","2017 ","33","19","14",
"73 s","Sightseeing Pass","2018 ","36","19","17",
"73 s","Sightseeing Pass","2019 ","38","20","18",
"73 s","Short-term Business","2000 ","0","0","0",
"73 s","Short-term Business","2001 ","0","0","0",
"73 s","Short-term Business","2002 ","3","0","3",
"73 s","Short-term Business","2003 ","0","0","0",
"73 s","Short-term Business","2004 ","5","1","4",
"73 s","Short-term Business","2005 ","2","0","2",
"73 s","Short-term Business","2006 ","0","0","0",
"73 s","Short-term Business","2007 ","0","0","0",
"73 s","Short-term Business","2008 ","0","0","0",
"73 s","Short-term Business","2009 ","0","0","0",
"73 s","Short-term Business","2010 ","0","0","0",
"73 s","Short-term Visitors","2000 ","59","33","26",
"73 s","Short-term Visitors","2001 ","34","9","25",
"73 s","Short-term Visitors","2002 ","50","22","28",
"73 s","Short-term Visitors","2003 ","61","22","39",
"73 s","Short-term Visitors","2004 ","71","29","42",
"73 s","Short-term Visitors","2005 ","157","47","110",
"73 s","Short-term Visitors","2006 ","134","39","95",
"73 s","Short-term Visitors","2007 ","105","32","73",
"73 s","Short-term Visitors","2008 ","50","10","40",
"73 s","Short-term Visitors","2009 ","56","22","34",
"73 s","Short-term Visitors","2010 ","62","16","46",
"73 s","Short-term Visitors","2011 ","131","32","99",
"73 s","Short-term Visitors","2012 ","40","19","21",
"73 s","Short-term Visitors","2013 ","48","21","27",
"73 s","Short-term Visitors","2014 ","37","12","25",
"73 s","Short-term Visitors","2015 ","38","15","23",
"73 s","Short-term Visitors","2016 ","38","15","23",
"73 s","Short-term Visitors","2017 ","17","6","11",
"73 s","Short-term Visitors","2018 ","28","10","18",
"73 s","Short-term Visitors","2019 ","38","12","26",
"73 s","Short-term Employment","2000 ","0","0","0",
"73 s","Short-term Employment","2001 ","0","0","0",
"73 s","Short-term Employment","2002 ","0","0","0",
"73 s","Short-term Employment","2003 ","0","0","0",
"73 s","Short-term Employment","2004 ","0","0","0",
"73 s","Short-term Employment","2005 ","0","0","0",
"73 s","Short-term Employment","2006 ","0","0","0",
"73 s","Short-term Employment","2007 ","0","0","0",
"73 s","Short-term Employment","2008 ","0","0","0",
"73 s","Short-term Employment","2009 ","0","0","0",
"73 s","Short-term Employment","2010 ","0","0","0",
"73 s","Job Seeking","2000 ","0","0","0",
"73 s","Job Seeking","2001 ","0","0","0",
"73 s","Job Seeking","2002 ","0","0","0",
"73 s","Job Seeking","2003 ","0","0","0",
"73 s","Job Seeking","2004 ","0","0","0",
"73 s","Job Seeking","2005 ","0","0","0",
"73 s","Job Seeking","2006 ","0","0","0",
"73 s","Job Seeking","2007 ","0","0","0",
"73 s","Job Seeking","2008 ","0","0","0",
"73 s","Job Seeking","2009 ","0","0","0",
"73 s","Job Seeking","2010 ","0","0","0",
"73 s","study","2000 ","1","1","0",
"73 s","study","2001 ","0","0","0",
"73 s","study","2002 ","0","0","0",
"73 s","study","2003 ","0","0","0",
"73 s","study","2004 ","0","0","0",
"73 s","study","2005 ","0","0","0",
"73 s","study","2006 ","0","0","0",
"73 s","study","2007 ","0","0","0",
"73 s","study","2008 ","0","0","0",
"73 s","study","2009 ","0","0","0",
"73 s","study","2010 ","0","0","0",
"73 s","General Trainees","2000 ","0","0","0",
"73 s","General Trainees","2001 ","0","0","0",
"73 s","General Trainees","2002 ","0","0","0",
"73 s","General Trainees","2003 ","0","0","0",
"73 s","General Trainees","2004 ","0","0","0",
"73 s","General Trainees","2005 ","0","0","0",
"73 s","General Trainees","2006 ","1","0","1",
"73 s","General Trainees","2007 ","0","0","0",
"73 s","General Trainees","2008 ","0","0","0",
"73 s","General Trainees","2009 ","0","0","0",
"73 s","General Trainees","2010 ","0","0","0",
"73 s","Religious Activities","2000 ","0","0","0",
"73 s","Religious Activities","2001 ","2","1","1",
"73 s","Religious Activities","2002 ","1","1","0",
"73 s","Religious Activities","2003 ","1","0","1",
"73 s","Religious Activities","2004 ","2","1","1",
"73 s","Religious Activities","2005 ","0","0","0",
"73 s","Religious Activities","2006 ","0","0","0",
"73 s","Religious Activities","2007 ","3","1","2",
"73 s","Religious Activities","2008 ","0","0","0",
"73 s","Religious Activities","2009 ","1","1","0",
"73 s","Religious Activities","2010 ","2","1","1",
"73 s","Religious Activities","2011 ","2","2","",
"73 s","Religious Activities","2012 ","1","1","",
"73 s","Religious Activities","2014 ","1","1","0",
"73 s","Religious Activities","2015 ","3","1","2",
"73 s","Religious Activities","2016 ","1","1","0",
"73 s","Religious Activities","2017 ","5","3","2",
"73 s","Religious Activities","2018 ","1","1","0",
"73 s","Religious Activities","2019 ","2","2","0",
"73 s","Investors","2000 ","0","0","0",
"73 s","Investors","2001 ","0","0","0",
"73 s","Investors","2002 ","0","0","0",
"73 s","Investors","2003 ","0","0","0",
"73 s","Investors","2004 ","0","0","0",
"73 s","Investors","2005 ","0","0","0",
"73 s","Investors","2006 ","1","1","0",
"73 s","Investors","2007 ","0","0","0",
"73 s","Investors","2008 ","1","1","0",
"73 s","Investors","2009 ","0","0","0",
"73 s","Investors","2010 ","0","0","0",
"73 s","Investors","2016 ","1","0","1",
"73 s","Trade and Business","2000 ","0","0","0",
"73 s","Trade and Business","2001 ","0","0","0",
"73 s","Trade and Business","2002 ","0","0","0",
"73 s","Trade and Business","2003 ","0","0","0",
"73 s","Trade and Business","2004 ","0","0","0",
"73 s","Trade and Business","2005 ","0","0","0",
"73 s","Trade and Business","2006 ","0","0","0",
"73 s","Trade and Business","2007 ","0","0","0",
"73 s","Trade and Business","2008 ","0","0","0",
"73 s","Trade and Business","2009 ","1","1","0",
"73 s","Trade and Business","2010 ","0","0","0",
"73 s","Trade and Business","2012 ","1","1","",
"73 s","Trade and Business","2013 ","1","1","0",
"73 s","Trade and Business","2016 ","1","1","0",
"73 s","Research","2000 ","0","0","0",
"73 s","Research","2001 ","0","0","0",
"73 s","Research","2002 ","0","0","0",
"73 s","Research","2003 ","1","1","0",
"73 s","Research","2004 ","1","1","0",
"73 s","Research","2005 ","2","2","0",
"73 s","Research","2006 ","0","0","0",
"73 s","Research","2007 ","1","1","0",
"73 s","Research","2008 ","0","0","0",
"73 s","Research","2009 ","0","0","0",
"73 s","Research","2010 ","0","0","0",
"73 s","Research","2019 ","2","2","0",
"73 s","Art and Entertainment","2000 ","0","0","0",
"73 s","Art and Entertainment","2001 ","0","0","0",
"73 s","Art and Entertainment","2002 ","0","0","0",
"73 s","Art and Entertainment","2003 ","0","0","0",
"73 s","Art and Entertainment","2004 ","0","0","0",
"73 s","Art and Entertainment","2005 ","0","0","0",
"73 s","Art and Entertainment","2006 ","0","0","0",
"73 s","Art and Entertainment","2007 ","0","0","0",
"73 s","Art and Entertainment","2008 ","0","0","0",
"73 s","Art and Entertainment","2009 ","0","0","0",
"73 s","Art and Entertainment","2010 ","0","0","0",
"73 s","Unskilled Employment","2000 ","0","0","0",
"73 s","Unskilled Employment","2001 ","0","0","0",
"73 s","Unskilled Employment","2002 ","0","0","0",
"73 s","Unskilled Employment","2003 ","0","0","0",
"73 s","Unskilled Employment","2004 ","0","0","0",
"73 s","Unskilled Employment","2005 ","0","0","0",
"73 s","Unskilled Employment","2006 ","0","0","0",
"73 s","Unskilled Employment","2007 ","0","0","0",
"73 s","Unskilled Employment","2008 ","0","0","0",
"73 s","Unskilled Employment","2009 ","0","0","0",
"73 s","Unskilled Employment","2010 ","0","0","0",
"73 s","Visiting and Joining Family","2000 ","16","11","5",
"73 s","Visiting and Joining Family","2001 ","30","15","15",
"73 s","Visiting and Joining Family","2002 ","18","8","10",
"73 s","Visiting and Joining Family","2003 ","15","3","12",
"73 s","Visiting and Joining Family","2004 ","16","6","10",
"73 s","Visiting and Joining Family","2005 ","29","15","14",
"73 s","Visiting and Joining Family","2006 ","46","18","28",
"73 s","Visiting and Joining Family","2007 ","49","23","26",
"73 s","Visiting and Joining Family","2008 ","54","22","32",
"73 s","Visiting and Joining Family","2009 ","23","10","13",
"73 s","Visiting and Joining Family","2010 ","9","4","5",
"73 s","Visiting and Joining Family","2011 ","46","16","30",
"73 s","Visiting and Joining Family","2012 ","165","50","115",
"73 s","Visiting and Joining Family","2013 ","154","38","116",
"73 s","Visiting and Joining Family","2014 ","30","10","20",
"73 s","Visiting and Joining Family","2015 ","11","4","7",
"73 s","Visiting and Joining Family","2016 ","8","4","4",
"73 s","Visiting and Joining Family","2017 ","17","9","8",
"73 s","Visiting and Joining Family","2018 ","11","6","5",
"73 s","Visiting and Joining Family","2019 ","14","11","3",
"73 s","Overseas Koreans","2000 ","5","3","2",
"73 s","Overseas Koreans","2001 ","12","6","6",
"73 s","Overseas Koreans","2002 ","6","5","1",
"73 s","Overseas Koreans","2003 ","7","5","2",
"73 s","Overseas Koreans","2004 ","13","7","6",
"73 s","Overseas Koreans","2005 ","14","6","8",
"73 s","Overseas Koreans","2006 ","14","5","9",
"73 s","Overseas Koreans","2007 ","21","13","8",
"73 s","Overseas Koreans","2008 ","29","15","14",
"73 s","Overseas Koreans","2009 ","23","14","9",
"73 s","Overseas Koreans","2010 ","48","28","20",
"73 s","Overseas Koreans","2011 ","64","34","30",
"73 s","Overseas Koreans","2012 ","109","65","44",
"73 s","Overseas Koreans","2013 ","166","74","92",
"73 s","Overseas Koreans","2014 ","436","145","291",
"73 s","Overseas Koreans","2015 ","524","190","334",
"73 s","Overseas Koreans","2016 ","551","202","349",
"73 s","Overseas Koreans","2017 ","513","178","335",
"73 s","Overseas Koreans","2018 ","553","208","345",
"73 s","Overseas Koreans","2019 ","616","238","378",
"73 s","Permanent Residence","2000 ","0","0","0",
"73 s","Permanent Residence","2001 ","0","0","0",
"73 s","Permanent Residence","2002 ","0","0","0",
"73 s","Permanent Residence","2003 ","3","3","0",
"73 s","Permanent Residence","2004 ","6","3","3",
"73 s","Permanent Residence","2005 ","4","1","3",
"73 s","Permanent Residence","2006 ","5","2","3",
"73 s","Permanent Residence","2007 ","6","1","5",
"73 s","Permanent Residence","2008 ","2","0","2",
"73 s","Permanent Residence","2009 ","2","1","1",
"73 s","Permanent Residence","2010 ","0","0","0",
"73 s","Permanent Residence","2011 ","7","3","4",
"73 s","Permanent Residence","2012 ","14","8","6",
"73 s","Permanent Residence","2013 ","9","8","1",
"73 s","Permanent Residence","2014 ","15","4","11",
"73 s","Permanent Residence","2015 ","13","6","7",
"73 s","Permanent Residence","2016 ","16","6","10",
"73 s","Permanent Residence","2017 ","21","11","10",
"73 s","Permanent Residence","2018 ","12","5","7",
"73 s","Permanent Residence","2019 ","15","6","9",
"73 s","Marriage Immigration","2012 ","5","2","3",
"73 s","Marriage Immigration","2013 ","4","2","2",
"73 s","Marriage Immigration","2014 ","7","5","2",
"73 s","Marriage Immigration","2015 ","10","7","3",
"73 s","Marriage Immigration","2016 ","6","5","1",
"73 s","Marriage Immigration","2017 ","4","4","0",
"73 s","Marriage Immigration","2018 ","5","4","1",
"74 s","Total","2000 ","123","54","69",
"74 s","Total","2001 ","107","55","52",
"74 s","Total","2002 ","124","52","72",
"74 s","Total","2003 ","110","51","59",
"74 s","Total","2004 ","157","67","90",
"74 s","Total","2005 ","248","101","147",
"74 s","Total","2006 ","235","85","150",
"74 s","Total","2007 ","204","80","124",
"74 s","Total","2008 ","257","109","148",
"74 s","Total","2009 ","187","81","106",
"74 s","Total","2010 ","227","95","132",
"74 s","Total","2011 ","316","139","177",
"74 s","Total","2012 ","438","167","271",
"74 s","Total","2013 ","432","165","267",
"74 s","Total","2014 ","581","209","372",
"74 s","Total","2015 ","596","212","384",
"74 s","Total","2016 ","691","240","451",
"74 s","Total","2017 ","587","228","359",
"74 s","Total","2018 ","647","255","392",
"74 s","Total","2019 ","631","250","381",
"74 s","Sightseeing Pass","2000 ","27","15","12",
"74 s","Sightseeing Pass","2001 ","37","27","10",
"74 s","Sightseeing Pass","2002 ","37","22","15",
"74 s","Sightseeing Pass","2003 ","27","16","11",
"74 s","Sightseeing Pass","2004 ","29","15","14",
"74 s","Sightseeing Pass","2005 ","43","22","21",
"74 s","Sightseeing Pass","2006 ","29","12","17",
"74 s","Sightseeing Pass","2007 ","23","9","14",
"74 s","Sightseeing Pass","2008 ","14","7","7",
"74 s","Sightseeing Pass","2009 ","27","10","17",
"74 s","Sightseeing Pass","2010 ","34","11","23",
"74 s","Sightseeing Pass","2011 ","46","26","20",
"74 s","Sightseeing Pass","2012 ","55","26","29",
"74 s","Sightseeing Pass","2013 ","57","32","25",
"74 s","Sightseeing Pass","2014 ","53","29","24",
"74 s","Sightseeing Pass","2015 ","51","24","27",
"74 s","Sightseeing Pass","2016 ","84","34","50",
"74 s","Sightseeing Pass","2017 ","37","20","17",
"74 s","Sightseeing Pass","2018 ","43","23","20",
"74 s","Sightseeing Pass","2019 ","37","20","17",
"74 s","Short-term Business","2000 ","1","1","0",
"74 s","Short-term Business","2001 ","0","0","0",
"74 s","Short-term Business","2002 ","3","2","1",
"74 s","Short-term Business","2003 ","2","2","0",
"74 s","Short-term Business","2004 ","1","1","0",
"74 s","Short-term Business","2005 ","0","0","0",
"74 s","Short-term Business","2006 ","1","1","0",
"74 s","Short-term Business","2007 ","0","0","0",
"74 s","Short-term Business","2008 ","0","0","0",
"74 s","Short-term Business","2009 ","1","1","0",
"74 s","Short-term Business","2010 ","0","0","0",
"74 s","Short-term Visitors","2000 ","69","23","46",
"74 s","Short-term Visitors","2001 ","34","11","23",
"74 s","Short-term Visitors","2002 ","43","10","33",
"74 s","Short-term Visitors","2003 ","43","14","29",
"74 s","Short-term Visitors","2004 ","77","24","53",
"74 s","Short-term Visitors","2005 ","133","43","90",
"74 s","Short-term Visitors","2006 ","137","48","89",
"74 s","Short-term Visitors","2007 ","84","31","53",
"74 s","Short-term Visitors","2008 ","37","14","23",
"74 s","Short-term Visitors","2009 ","54","20","34",
"74 s","Short-term Visitors","2010 ","82","28","54",
"74 s","Short-term Visitors","2011 ","103","36","67",
"74 s","Short-term Visitors","2012 ","40","9","31",
"74 s","Short-term Visitors","2013 ","28","9","19",
"74 s","Short-term Visitors","2014 ","38","15","23",
"74 s","Short-term Visitors","2015 ","30","12","18",
"74 s","Short-term Visitors","2016 ","19","4","15",
"74 s","Short-term Visitors","2017 ","16","4","12",
"74 s","Short-term Visitors","2018 ","23","6","17",
"74 s","Short-term Visitors","2019 ","29","8","21",
"74 s","Short-term Employment","2000 ","1","0","1",
"74 s","Short-term Employment","2001 ","0","0","0",
"74 s","Short-term Employment","2002 ","0","0","0",
"74 s","Short-term Employment","2003 ","0","0","0",
"74 s","Short-term Employment","2004 ","0","0","0",
"74 s","Short-term Employment","2005 ","0","0","0",
"74 s","Short-term Employment","2006 ","0","0","0",
"74 s","Short-term Employment","2007 ","0","0","0",
"74 s","Short-term Employment","2008 ","0","0","0",
"74 s","Short-term Employment","2009 ","0","0","0",
"74 s","Short-term Employment","2010 ","0","0","0",
"74 s","Short-term Employment","2015 ","1","1","0",
"74 s","Job Seeking","2000 ","0","0","0",
"74 s","Job Seeking","2001 ","0","0","0",
"74 s","Job Seeking","2002 ","0","0","0",
"74 s","Job Seeking","2003 ","0","0","0",
"74 s","Job Seeking","2004 ","0","0","0",
"74 s","Job Seeking","2005 ","0","0","0",
"74 s","Job Seeking","2006 ","0","0","0",
"74 s","Job Seeking","2007 ","0","0","0",
"74 s","Job Seeking","2008 ","0","0","0",
"74 s","Job Seeking","2009 ","0","0","0",
"74 s","Job Seeking","2010 ","0","0","0",
"74 s","study","2000 ","0","0","0",
"74 s","study","2001 ","0","0","0",
"74 s","study","2002 ","0","0","0",
"74 s","study","2003 ","0","0","0",
"74 s","study","2004 ","0","0","0",
"74 s","study","2005 ","2","0","2",
"74 s","study","2006 ","0","0","0",
"74 s","study","2007 ","0","0","0",
"74 s","study","2008 ","0","0","0",
"74 s","study","2009 ","0","0","0",
"74 s","study","2010 ","0","0","0",
"74 s","General Trainees","2000 ","0","0","0",
"74 s","General Trainees","2001 ","0","0","0",
"74 s","General Trainees","2002 ","0","0","0",
"74 s","General Trainees","2003 ","0","0","0",
"74 s","General Trainees","2004 ","0","0","0",
"74 s","General Trainees","2005 ","0","0","0",
"74 s","General Trainees","2006 ","0","0","0",
"74 s","General Trainees","2007 ","0","0","0",
"74 s","General Trainees","2008 ","0","0","0",
"74 s","General Trainees","2009 ","0","0","0",
"74 s","General Trainees","2010 ","0","0","0",
"74 s","General Trainees","2014 ","1","0","1",
"74 s","Religious Activities","2000 ","1","0","1",
"74 s","Religious Activities","2001 ","2","2","0",
"74 s","Religious Activities","2002 ","2","2","0",
"74 s","Religious Activities","2003 ","1","1","0",
"74 s","Religious Activities","2004 ","2","1","1",
"74 s","Religious Activities","2005 ","0","0","0",
"74 s","Religious Activities","2006 ","2","1","1",
"74 s","Religious Activities","2007 ","3","3","0",
"74 s","Religious Activities","2008 ","2","2","0",
"74 s","Religious Activities","2009 ","1","0","1",
"74 s","Religious Activities","2010 ","2","2","0",
"74 s","Religious Activities","2011 ","3","2","1",
"74 s","Religious Activities","2012 ","4","4","",
"74 s","Religious Activities","2014 ","1","1","0",
"74 s","Religious Activities","2015 ","1","0","1",
"74 s","Religious Activities","2017 ","1","1","0",
"74 s","Religious Activities","2018 ","2","2","0",
"74 s","Religious Activities","2019 ","2","1","1",
"74 s","Investors","2000 ","0","0","0",
"74 s","Investors","2001 ","0","0","0",
"74 s","Investors","2002 ","0","0","0",
"74 s","Investors","2003 ","0","0","0",
"74 s","Investors","2004 ","0","0","0",
"74 s","Investors","2005 ","0","0","0",
"74 s","Investors","2006 ","0","0","0",
"74 s","Investors","2007 ","0","0","0",
"74 s","Investors","2008 ","0","0","0",
"74 s","Investors","2009 ","0","0","0",
"74 s","Investors","2010 ","2","2","0",
"74 s","Investors","2016 ","1","1","0",
"74 s","Trade and Business","2000 ","0","0","0",
"74 s","Trade and Business","2001 ","0","0","0",
"74 s","Trade and Business","2002 ","0","0","0",
"74 s","Trade and Business","2003 ","0","0","0",
"74 s","Trade and Business","2004 ","0","0","0",
"74 s","Trade and Business","2005 ","0","0","0",
"74 s","Trade and Business","2006 ","0","0","0",
"74 s","Trade and Business","2007 ","0","0","0",
"74 s","Trade and Business","2008 ","0","0","0",
"74 s","Trade and Business","2009 ","0","0","0",
"74 s","Trade and Business","2010 ","0","0","0",
"74 s","Trade and Business","2012 ","1","1","",
"74 s","Trade and Business","2014 ","1","1","0",
"74 s","Trade and Business","2015 ","1","1","0",
"74 s","Research","2000 ","0","0","0",
"74 s","Research","2001 ","0","0","0",
"74 s","Research","2002 ","0","0","0",
"74 s","Research","2003 ","0","0","0",
"74 s","Research","2004 ","0","0","0",
"74 s","Research","2005 ","0","0","0",
"74 s","Research","2006 ","0","0","0",
"74 s","Research","2007 ","0","0","0",
"74 s","Research","2008 ","1","1","0",
"74 s","Research","2009 ","0","0","0",
"74 s","Research","2010 ","0","0","0",
"74 s","Art and Entertainment","2000 ","0","0","0",
"74 s","Art and Entertainment","2001 ","0","0","0",
"74 s","Art and Entertainment","2002 ","0","0","0",
"74 s","Art and Entertainment","2003 ","1","0","1",
"74 s","Art and Entertainment","2004 ","0","0","0",
"74 s","Art and Entertainment","2005 ","0","0","0",
"74 s","Art and Entertainment","2006 ","0","0","0",
"74 s","Art and Entertainment","2007 ","0","0","0",
"74 s","Art and Entertainment","2008 ","0","0","0",
"74 s","Art and Entertainment","2009 ","0","0","0",
"74 s","Art and Entertainment","2010 ","0","0","0",
"74 s","Unskilled Employment","2000 ","0","0","0",
"74 s","Unskilled Employment","2001 ","0","0","0",
"74 s","Unskilled Employment","2002 ","0","0","0",
"74 s","Unskilled Employment","2003 ","0","0","0",
"74 s","Unskilled Employment","2004 ","1","1","0",
"74 s","Unskilled Employment","2005 ","1","0","1",
"74 s","Unskilled Employment","2006 ","1","1","0",
"74 s","Unskilled Employment","2007 ","1","0","1",
"74 s","Unskilled Employment","2008 ","0","0","0",
"74 s","Unskilled Employment","2009 ","0","0","0",
"74 s","Unskilled Employment","2010 ","0","0","0",
"74 s","Visiting and Joining Family","2000 ","12","7","5",
"74 s","Visiting and Joining Family","2001 ","15","5","10",
"74 s","Visiting and Joining Family","2002 ","18","4","14",
"74 s","Visiting and Joining Family","2003 ","16","5","11",
"74 s","Visiting and Joining Family","2004 ","17","7","10",
"74 s","Visiting and Joining Family","2005 ","33","15","18",
"74 s","Visiting and Joining Family","2006 ","37","12","25",
"74 s","Visiting and Joining Family","2007 ","39","23","16",
"74 s","Visiting and Joining Family","2008 ","53","30","23",
"74 s","Visiting and Joining Family","2009 ","12","5","7",
"74 s","Visiting and Joining Family","2010 ","16","7","9",
"74 s","Visiting and Joining Family","2011 ","48","12","36",
"74 s","Visiting and Joining Family","2012 ","176","46","130",
"74 s","Visiting and Joining Family","2013 ","151","40","111",
"74 s","Visiting and Joining Family","2014 ","28","7","21",
"74 s","Visiting and Joining Family","2015 ","13","5","8",
"74 s","Visiting and Joining Family","2016 ","10","3","7",
"74 s","Visiting and Joining Family","2017 ","11","7","4",
"74 s","Visiting and Joining Family","2018 ","12","5","7",
"74 s","Visiting and Joining Family","2019 ","15","9","6",
"74 s","Overseas Koreans","2000 ","1","1","0",
"74 s","Overseas Koreans","2001 ","9","6","3",
"74 s","Overseas Koreans","2002 ","9","5","4",
"74 s","Overseas Koreans","2003 ","5","3","2",
"74 s","Overseas Koreans","2004 ","10","7","3",
"74 s","Overseas Koreans","2005 ","10","4","6",
"74 s","Overseas Koreans","2006 ","13","2","11",
"74 s","Overseas Koreans","2007 ","13","1","12",
"74 s","Overseas Koreans","2008 ","22","11","11",
"74 s","Overseas Koreans","2009 ","33","16","17",
"74 s","Overseas Koreans","2010 ","34","18","16",
"74 s","Overseas Koreans","2011 ","47","27","20",
"74 s","Overseas Koreans","2012 ","87","51","36",
"74 s","Overseas Koreans","2013 ","155","65","90",
"74 s","Overseas Koreans","2014 ","428","143","285",
"74 s","Overseas Koreans","2015 ","469","153","316",
"74 s","Overseas Koreans","2016 ","545","184","361",
"74 s","Overseas Koreans","2017 ","498","182","316",
"74 s","Overseas Koreans","2018 ","533","202","331",
"74 s","Overseas Koreans","2019 ","521","195","326",
"74 s","Permanent Residence","2000 ","0","0","0",
"74 s","Permanent Residence","2001 ","0","0","0",
"74 s","Permanent Residence","2002 ","0","0","0",
"74 s","Permanent Residence","2003 ","0","0","0",
"74 s","Permanent Residence","2004 ","8","6","2",
"74 s","Permanent Residence","2005 ","4","2","2",
"74 s","Permanent Residence","2006 ","1","1","0",
"74 s","Permanent Residence","2007 ","4","0","4",
"74 s","Permanent Residence","2008 ","5","1","4",
"74 s","Permanent Residence","2009 ","3","1","2",
"74 s","Permanent Residence","2010 ","2","0","2",
"74 s","Permanent Residence","2011 ","5","3","2",
"74 s","Permanent Residence","2012 ","10","6","4",
"74 s","Permanent Residence","2013 ","14","5","9",
"74 s","Permanent Residence","2014 ","14","6","8",
"74 s","Permanent Residence","2015 ","17","8","9",
"74 s","Permanent Residence","2016 ","15","6","9",
"74 s","Permanent Residence","2017 ","12","8","4",
"74 s","Permanent Residence","2018 ","20","9","11",
"74 s","Permanent Residence","2019 ","11","7","4",
"74 s","Marriage Immigration","2012 ","9","3","6",
"74 s","Marriage Immigration","2013 ","4","3","1",
"74 s","Marriage Immigration","2014 ","1","0","1",
"74 s","Marriage Immigration","2015 ","4","3","1",
"74 s","Marriage Immigration","2016 ","4","2","2",
"74 s","Marriage Immigration","2017 ","3","3","0",
"74 s","Marriage Immigration","2018 ","6","5","1",
"74 s","Marriage Immigration","2019 ","3","3","0",
"75 s","Total","2000 ","131","63","68",
"75 s","Total","2001 ","97","41","56",
"75 s","Total","2002 ","108","58","50",
"75 s","Total","2003 ","118","49","69",
"75 s","Total","2004 ","148","60","88",
"75 s","Total","2005 ","218","72","146",
"75 s","Total","2006 ","175","63","112",
"75 s","Total","2007 ","194","64","130",
"75 s","Total","2008 ","191","73","118",
"75 s","Total","2009 ","143","57","86",
"75 s","Total","2010 ","220","91","129",
"75 s","Total","2011 ","292","127","165",
"75 s","Total","2012 ","364","128","236",
"75 s","Total","2013 ","376","143","233",
"75 s","Total","2014 ","527","167","360",
"75 s","Total","2015 ","577","180","397",
"75 s","Total","2016 ","618","217","401",
"75 s","Total","2017 ","557","211","346",
"75 s","Total","2018 ","586","213","373",
"75 s","Total","2019 ","529","194","335",
"75 s","Sightseeing Pass","2000 ","27","13","14",
"75 s","Sightseeing Pass","2001 ","29","18","11",
"75 s","Sightseeing Pass","2002 ","28","19","9",
"75 s","Sightseeing Pass","2003 ","26","17","9",
"75 s","Sightseeing Pass","2004 ","26","13","13",
"75 s","Sightseeing Pass","2005 ","29","12","17",
"75 s","Sightseeing Pass","2006 ","35","12","23",
"75 s","Sightseeing Pass","2007 ","23","12","11",
"75 s","Sightseeing Pass","2008 ","26","14","12",
"75 s","Sightseeing Pass","2009 ","27","15","12",
"75 s","Sightseeing Pass","2010 ","32","13","19",
"75 s","Sightseeing Pass","2011 ","41","20","21",
"75 s","Sightseeing Pass","2012 ","63","28","35",
"75 s","Sightseeing Pass","2013 ","41","20","21",
"75 s","Sightseeing Pass","2014 ","34","15","19",
"75 s","Sightseeing Pass","2015 ","51","20","31",
"75 s","Sightseeing Pass","2016 ","68","37","31",
"75 s","Sightseeing Pass","2017 ","58","24","34",
"75 s","Sightseeing Pass","2018 ","41","22","19",
"75 s","Sightseeing Pass","2019 ","35","16","19",
"75 s","Short-term Business","2000 ","1","1","0",
"75 s","Short-term Business","2001 ","0","0","0",
"75 s","Short-term Business","2002 ","0","0","0",
"75 s","Short-term Business","2003 ","1","1","0",
"75 s","Short-term Business","2004 ","0","0","0",
"75 s","Short-term Business","2005 ","1","1","0",
"75 s","Short-term Business","2006 ","2","2","0",
"75 s","Short-term Business","2007 ","0","0","0",
"75 s","Short-term Business","2008 ","0","0","0",
"75 s","Short-term Business","2009 ","0","0","0",
"75 s","Short-term Business","2010 ","0","0","0",
"75 s","Short-term Visitors","2000 ","66","33","33",
"75 s","Short-term Visitors","2001 ","33","10","23",
"75 s","Short-term Visitors","2002 ","48","23","25",
"75 s","Short-term Visitors","2003 ","51","15","36",
"75 s","Short-term Visitors","2004 ","70","18","52",
"75 s","Short-term Visitors","2005 ","137","30","107",
"75 s","Short-term Visitors","2006 ","86","21","65",
"75 s","Short-term Visitors","2007 ","75","17","58",
"75 s","Short-term Visitors","2008 ","34","9","25",
"75 s","Short-term Visitors","2009 ","32","8","24",
"75 s","Short-term Visitors","2010 ","89","26","63",
"75 s","Short-term Visitors","2011 ","102","36","66",
"75 s","Short-term Visitors","2012 ","27","4","23",
"75 s","Short-term Visitors","2013 ","43","17","26",
"75 s","Short-term Visitors","2014 ","25","9","16",
"75 s","Short-term Visitors","2015 ","32","16","16",
"75 s","Short-term Visitors","2016 ","26","10","16",
"75 s","Short-term Visitors","2017 ","16","7","9",
"75 s","Short-term Visitors","2018 ","14","4","10",
"75 s","Short-term Visitors","2019 ","22","6","16",
"75 s","Short-term Employment","2000 ","0","0","0",
"75 s","Short-term Employment","2001 ","0","0","0",
"75 s","Short-term Employment","2002 ","0","0","0",
"75 s","Short-term Employment","2003 ","0","0","0",
"75 s","Short-term Employment","2004 ","0","0","0",
"75 s","Short-term Employment","2005 ","1","1","0",
"75 s","Short-term Employment","2006 ","0","0","0",
"75 s","Short-term Employment","2007 ","0","0","0",
"75 s","Short-term Employment","2008 ","0","0","0",
"75 s","Short-term Employment","2009 ","0","0","0",
"75 s","Short-term Employment","2010 ","0","0","0",
"75 s","Job Seeking","2000 ","0","0","0",
"75 s","Job Seeking","2001 ","0","0","0",
"75 s","Job Seeking","2002 ","0","0","0",
"75 s","Job Seeking","2003 ","0","0","0",
"75 s","Job Seeking","2004 ","0","0","0",
"75 s","Job Seeking","2005 ","0","0","0",
"75 s","Job Seeking","2006 ","0","0","0",
"75 s","Job Seeking","2007 ","0","0","0",
"75 s","Job Seeking","2008 ","0","0","0",
"75 s","Job Seeking","2009 ","0","0","0",
"75 s","Job Seeking","2010 ","0","0","0",
"75 s","study","2000 ","0","0","0",
"75 s","study","2001 ","0","0","0",
"75 s","study","2002 ","0","0","0",
"75 s","study","2003 ","0","0","0",
"75 s","study","2004 ","0","0","0",
"75 s","study","2005 ","0","0","0",
"75 s","study","2006 ","0","0","0",
"75 s","study","2007 ","0","0","0",
"75 s","study","2008 ","0","0","0",
"75 s","study","2009 ","0","0","0",
"75 s","study","2010 ","0","0","0",
"75 s","General Trainees","2000 ","1","0","1",
"75 s","General Trainees","2001 ","0","0","0",
"75 s","General Trainees","2002 ","0","0","0",
"75 s","General Trainees","2003 ","0","0","0",
"75 s","General Trainees","2004 ","0","0","0",
"75 s","General Trainees","2005 ","0","0","0",
"75 s","General Trainees","2006 ","0","0","0",
"75 s","General Trainees","2007 ","0","0","0",
"75 s","General Trainees","2008 ","0","0","0",
"75 s","General Trainees","2009 ","0","0","0",
"75 s","General Trainees","2010 ","0","0","0",
"75 s","Religious Activities","2000 ","1","1","0",
"75 s","Religious Activities","2001 ","2","1","1",
"75 s","Religious Activities","2002 ","1","1","0",
"75 s","Religious Activities","2003 ","0","0","0",
"75 s","Religious Activities","2004 ","0","0","0",
"75 s","Religious Activities","2005 ","0","0","0",
"75 s","Religious Activities","2006 ","2","1","1",
"75 s","Religious Activities","2007 ","0","0","0",
"75 s","Religious Activities","2008 ","3","2","1",
"75 s","Religious Activities","2009 ","0","0","0",
"75 s","Religious Activities","2010 ","1","1","0",
"75 s","Religious Activities","2011 ","3","3","",
"75 s","Religious Activities","2013 ","1","1","0",
"75 s","Religious Activities","2014 ","2","1","1",
"75 s","Religious Activities","2016 ","1","0","1",
"75 s","Religious Activities","2017 ","2","1","1",
"75 s","Religious Activities","2018 ","1","0","1",
"75 s","Religious Activities","2019 ","1","1","0",
"75 s","Investors","2000 ","0","0","0",
"75 s","Investors","2001 ","0","0","0",
"75 s","Investors","2002 ","0","0","0",
"75 s","Investors","2003 ","0","0","0",
"75 s","Investors","2004 ","0","0","0",
"75 s","Investors","2005 ","0","0","0",
"75 s","Investors","2006 ","0","0","0",
"75 s","Investors","2007 ","0","0","0",
"75 s","Investors","2008 ","0","0","0",
"75 s","Investors","2009 ","0","0","0",
"75 s","Investors","2010 ","1","1","0",
"75 s","Trade and Business","2000 ","0","0","0",
"75 s","Trade and Business","2001 ","0","0","0",
"75 s","Trade and Business","2002 ","0","0","0",
"75 s","Trade and Business","2003 ","0","0","0",
"75 s","Trade and Business","2004 ","0","0","0",
"75 s","Trade and Business","2005 ","0","0","0",
"75 s","Trade and Business","2006 ","0","0","0",
"75 s","Trade and Business","2007 ","0","0","0",
"75 s","Trade and Business","2008 ","0","0","0",
"75 s","Trade and Business","2009 ","0","0","0",
"75 s","Trade and Business","2010 ","0","0","0",
"75 s","Trade and Business","2011 ","2","2","",
"75 s","Trade and Business","2013 ","1","1","0",
"75 s","Trade and Business","2014 ","1","1","0",
"75 s","Trade and Business","2016 ","1","1","0",
"75 s","Trade and Business","2017 ","1","1","0",
"75 s","Trade and Business","2018 ","1","1","0",
"75 s","Research","2000 ","0","0","0",
"75 s","Research","2001 ","0","0","0",
"75 s","Research","2002 ","0","0","0",
"75 s","Research","2003 ","0","0","0",
"75 s","Research","2004 ","0","0","0",
"75 s","Research","2005 ","1","1","0",
"75 s","Research","2006 ","0","0","0",
"75 s","Research","2007 ","0","0","0",
"75 s","Research","2008 ","0","0","0",
"75 s","Research","2009 ","1","1","0",
"75 s","Research","2010 ","0","0","0",
"75 s","Research","2013 ","1","1","0",
"75 s","Art and Entertainment","2000 ","0","0","0",
"75 s","Art and Entertainment","2001 ","0","0","0",
"75 s","Art and Entertainment","2002 ","0","0","0",
"75 s","Art and Entertainment","2003 ","0","0","0",
"75 s","Art and Entertainment","2004 ","0","0","0",
"75 s","Art and Entertainment","2005 ","0","0","0",
"75 s","Art and Entertainment","2006 ","0","0","0",
"75 s","Art and Entertainment","2007 ","0","0","0",
"75 s","Art and Entertainment","2008 ","0","0","0",
"75 s","Art and Entertainment","2009 ","0","0","0",
"75 s","Art and Entertainment","2010 ","0","0","0",
"75 s","Unskilled Employment","2000 ","0","0","0",
"75 s","Unskilled Employment","2001 ","0","0","0",
"75 s","Unskilled Employment","2002 ","0","0","0",
"75 s","Unskilled Employment","2003 ","0","0","0",
"75 s","Unskilled Employment","2004 ","1","1","0",
"75 s","Unskilled Employment","2005 ","1","1","0",
"75 s","Unskilled Employment","2006 ","0","0","0",
"75 s","Unskilled Employment","2007 ","0","0","0",
"75 s","Unskilled Employment","2008 ","0","0","0",
"75 s","Unskilled Employment","2009 ","0","0","0",
"75 s","Unskilled Employment","2010 ","0","0","0",
"75 s","Visiting and Joining Family","2000 ","20","7","13",
"75 s","Visiting and Joining Family","2001 ","16","5","11",
"75 s","Visiting and Joining Family","2002 ","11","6","5",
"75 s","Visiting and Joining Family","2003 ","19","4","15",
"75 s","Visiting and Joining Family","2004 ","16","7","9",
"75 s","Visiting and Joining Family","2005 ","25","10","15",
"75 s","Visiting and Joining Family","2006 ","26","14","12",
"75 s","Visiting and Joining Family","2007 ","44","15","29",
"75 s","Visiting and Joining Family","2008 ","36","15","21",
"75 s","Visiting and Joining Family","2009 ","18","9","9",
"75 s","Visiting and Joining Family","2010 ","9","3","6",
"75 s","Visiting and Joining Family","2011 ","49","18","31",
"75 s","Visiting and Joining Family","2012 ","133","22","111",
"75 s","Visiting and Joining Family","2013 ","129","35","94",
"75 s","Visiting and Joining Family","2014 ","25","5","20",
"75 s","Visiting and Joining Family","2015 ","14","5","9",
"75 s","Visiting and Joining Family","2016 ","13","7","6",
"75 s","Visiting and Joining Family","2017 ","7","2","5",
"75 s","Visiting and Joining Family","2018 ","8","5","3",
"75 s","Visiting and Joining Family","2019 ","8","5","3",
"75 s","Overseas Koreans","2000 ","1","1","0",
"75 s","Overseas Koreans","2001 ","5","2","3",
"75 s","Overseas Koreans","2002 ","3","2","1",
"75 s","Overseas Koreans","2003 ","8","5","3",
"75 s","Overseas Koreans","2004 ","13","6","7",
"75 s","Overseas Koreans","2005 ","9","6","3",
"75 s","Overseas Koreans","2006 ","10","6","4",
"75 s","Overseas Koreans","2007 ","13","5","8",
"75 s","Overseas Koreans","2008 ","17","8","9",
"75 s","Overseas Koreans","2009 ","18","10","8",
"75 s","Overseas Koreans","2010 ","35","21","14",
"75 s","Overseas Koreans","2011 ","45","24","21",
"75 s","Overseas Koreans","2012 ","90","52","38",
"75 s","Overseas Koreans","2013 ","127","54","73",
"75 s","Overseas Koreans","2014 ","415","126","289",
"75 s","Overseas Koreans","2015 ","455","129","326",
"75 s","Overseas Koreans","2016 ","478","146","332",
"75 s","Overseas Koreans","2017 ","442","158","284",
"75 s","Overseas Koreans","2018 ","493","164","329",
"75 s","Overseas Koreans","2019 ","437","150","287",
"75 s","Permanent Residence","2000 ","0","0","0",
"75 s","Permanent Residence","2001 ","0","0","0",
"75 s","Permanent Residence","2002 ","0","0","0",
"75 s","Permanent Residence","2003 ","3","2","1",
"75 s","Permanent Residence","2004 ","2","2","0",
"75 s","Permanent Residence","2005 ","2","2","0",
"75 s","Permanent Residence","2006 ","2","1","1",
"75 s","Permanent Residence","2007 ","3","2","1",
"75 s","Permanent Residence","2008 ","5","2","3",
"75 s","Permanent Residence","2009 ","7","1","6",
"75 s","Permanent Residence","2010 ","3","2","1",
"75 s","Permanent Residence","2011 ","2","","2",
"75 s","Permanent Residence","2012 ","6","1","5",
"75 s","Permanent Residence","2013 ","10","6","4",
"75 s","Permanent Residence","2014 ","7","5","2",
"75 s","Permanent Residence","2015 ","13","5","8",
"75 s","Permanent Residence","2016 ","13","4","9",
"75 s","Permanent Residence","2017 ","13","6","7",
"75 s","Permanent Residence","2018 ","7","5","2",
"75 s","Permanent Residence","2019 ","11","5","6",
"75 s","Marriage Immigration","2012 ","6","5","1",
"75 s","Marriage Immigration","2013 ","4","4","0",
"75 s","Marriage Immigration","2014 ","4","1","3",
"75 s","Marriage Immigration","2015 ","3","2","1",
"75 s","Marriage Immigration","2016 ","4","4","0",
"75 s","Marriage Immigration","2017 ","7","5","2",
"75 s","Marriage Immigration","2018 ","5","5","0",
"75 s","Marriage Immigration","2019 ","4","4","0",
"76 s","Total","2000 ","89","41","48",
"76 s","Total","2001 ","87","42","45",
"76 s","Total","2002 ","91","33","58",
"76 s","Total","2003 ","97","37","60",
"76 s","Total","2004 ","139","52","87",
"76 s","Total","2005 ","182","66","116",
"76 s","Total","2006 ","165","58","107",
"76 s","Total","2007 ","137","46","91",
"76 s","Total","2008 ","186","57","129",
"76 s","Total","2009 ","137","62","75",
"76 s","Total","2010 ","167","72","95",
"76 s","Total","2011 ","239","92","147",
"76 s","Total","2012 ","323","115","208",
"76 s","Total","2013 ","327","118","209",
"76 s","Total","2014 ","485","151","334",
"76 s","Total","2015 ","548","184","364",
"76 s","Total","2016 ","576","189","387",
"76 s","Total","2017 ","528","185","343",
"76 s","Total","2018 ","559","184","375",
"76 s","Total","2019 ","521","183","338",
"76 s","Sightseeing Pass","2000 ","16","10","6",
"76 s","Sightseeing Pass","2001 ","32","20","12",
"76 s","Sightseeing Pass","2002 ","22","10","12",
"76 s","Sightseeing Pass","2003 ","26","13","13",
"76 s","Sightseeing Pass","2004 ","30","16","14",
"76 s","Sightseeing Pass","2005 ","24","13","11",
"76 s","Sightseeing Pass","2006 ","25","12","13",
"76 s","Sightseeing Pass","2007 ","16","7","9",
"76 s","Sightseeing Pass","2008 ","22","6","16",
"76 s","Sightseeing Pass","2009 ","23","10","13",
"76 s","Sightseeing Pass","2010 ","34","14","20",
"76 s","Sightseeing Pass","2011 ","33","13","20",
"76 s","Sightseeing Pass","2012 ","49","20","29",
"76 s","Sightseeing Pass","2013 ","38","23","15",
"76 s","Sightseeing Pass","2014 ","41","22","19",
"76 s","Sightseeing Pass","2015 ","38","15","23",
"76 s","Sightseeing Pass","2016 ","49","18","31",
"76 s","Sightseeing Pass","2017 ","27","13","14",
"76 s","Sightseeing Pass","2018 ","45","23","22",
"76 s","Sightseeing Pass","2019 ","29","13","16",
"76 s","Short-term Business","2000 ","0","0","0",
"76 s","Short-term Business","2001 ","0","0","0",
"76 s","Short-term Business","2002 ","0","0","0",
"76 s","Short-term Business","2003 ","1","0","1",
"76 s","Short-term Business","2004 ","1","1","0",
"76 s","Short-term Business","2005 ","3","2","1",
"76 s","Short-term Business","2006 ","1","0","1",
"76 s","Short-term Business","2007 ","0","0","0",
"76 s","Short-term Business","2008 ","0","0","0",
"76 s","Short-term Business","2009 ","0","0","0",
"76 s","Short-term Business","2010 ","0","0","0",
"76 s","Short-term Visitors","2000 ","48","20","28",
"76 s","Short-term Visitors","2001 ","23","7","16",
"76 s","Short-term Visitors","2002 ","37","5","32",
"76 s","Short-term Visitors","2003 ","39","5","34",
"76 s","Short-term Visitors","2004 ","63","19","44",
"76 s","Short-term Visitors","2005 ","99","23","76",
"76 s","Short-term Visitors","2006 ","85","25","60",
"76 s","Short-term Visitors","2007 ","54","9","45",
"76 s","Short-term Visitors","2008 ","39","10","29",
"76 s","Short-term Visitors","2009 ","46","14","32",
"76 s","Short-term Visitors","2010 ","61","22","39",
"76 s","Short-term Visitors","2011 ","91","33","58",
"76 s","Short-term Visitors","2012 ","22","7","15",
"76 s","Short-term Visitors","2013 ","23","8","15",
"76 s","Short-term Visitors","2014 ","14","6","8",
"76 s","Short-term Visitors","2015 ","18","5","13",
"76 s","Short-term Visitors","2016 ","20","8","12",
"76 s","Short-term Visitors","2017 ","9","4","5",
"76 s","Short-term Visitors","2018 ","11","3","8",
"76 s","Short-term Visitors","2019 ","19","13","6",
"76 s","Short-term Employment","2000 ","0","0","0",
"76 s","Short-term Employment","2001 ","0","0","0",
"76 s","Short-term Employment","2002 ","1","1","0",
"76 s","Short-term Employment","2003 ","0","0","0",
"76 s","Short-term Employment","2004 ","0","0","0",
"76 s","Short-term Employment","2005 ","0","0","0",
"76 s","Short-term Employment","2006 ","0","0","0",
"76 s","Short-term Employment","2007 ","0","0","0",
"76 s","Short-term Employment","2008 ","0","0","0",
"76 s","Short-term Employment","2009 ","0","0","0",
"76 s","Short-term Employment","2010 ","0","0","0",
"76 s","Job Seeking","2000 ","0","0","0",
"76 s","Job Seeking","2001 ","0","0","0",
"76 s","Job Seeking","2002 ","0","0","0",
"76 s","Job Seeking","2003 ","0","0","0",
"76 s","Job Seeking","2004 ","0","0","0",
"76 s","Job Seeking","2005 ","0","0","0",
"76 s","Job Seeking","2006 ","0","0","0",
"76 s","Job Seeking","2007 ","0","0","0",
"76 s","Job Seeking","2008 ","0","0","0",
"76 s","Job Seeking","2009 ","0","0","0",
"76 s","Job Seeking","2010 ","0","0","0",
"76 s","study","2000 ","0","0","0",
"76 s","study","2001 ","0","0","0",
"76 s","study","2002 ","0","0","0",
"76 s","study","2003 ","0","0","0",
"76 s","study","2004 ","0","0","0",
"76 s","study","2005 ","0","0","0",
"76 s","study","2006 ","0","0","0",
"76 s","study","2007 ","0","0","0",
"76 s","study","2008 ","0","0","0",
"76 s","study","2009 ","0","0","0",
"76 s","study","2010 ","0","0","0",
"76 s","General Trainees","2000 ","0","0","0",
"76 s","General Trainees","2001 ","0","0","0",
"76 s","General Trainees","2002 ","0","0","0",
"76 s","General Trainees","2003 ","0","0","0",
"76 s","General Trainees","2004 ","0","0","0",
"76 s","General Trainees","2005 ","0","0","0",
"76 s","General Trainees","2006 ","0","0","0",
"76 s","General Trainees","2007 ","0","0","0",
"76 s","General Trainees","2008 ","0","0","0",
"76 s","General Trainees","2009 ","0","0","0",
"76 s","General Trainees","2010 ","0","0","0",
"76 s","Religious Activities","2000 ","0","0","0",
"76 s","Religious Activities","2001 ","1","0","1",
"76 s","Religious Activities","2002 ","0","0","0",
"76 s","Religious Activities","2003 ","0","0","0",
"76 s","Religious Activities","2004 ","3","1","2",
"76 s","Religious Activities","2005 ","2","1","1",
"76 s","Religious Activities","2006 ","0","0","0",
"76 s","Religious Activities","2007 ","1","1","0",
"76 s","Religious Activities","2008 ","0","0","0",
"76 s","Religious Activities","2009 ","0","0","0",
"76 s","Religious Activities","2010 ","1","1","0",
"76 s","Religious Activities","2012 ","1","1","",
"76 s","Religious Activities","2013 ","1","0","1",
"76 s","Religious Activities","2014 ","2","2","0",
"76 s","Religious Activities","2015 ","2","1","1",
"76 s","Religious Activities","2017 ","1","1","0",
"76 s","Investors","2000 ","0","0","0",
"76 s","Investors","2001 ","0","0","0",
"76 s","Investors","2002 ","2","2","0",
"76 s","Investors","2003 ","1","1","0",
"76 s","Investors","2004 ","0","0","0",
"76 s","Investors","2005 ","0","0","0",
"76 s","Investors","2006 ","0","0","0",
"76 s","Investors","2007 ","0","0","0",
"76 s","Investors","2008 ","0","0","0",
"76 s","Investors","2009 ","0","0","0",
"76 s","Investors","2010 ","0","0","0",
"76 s","Trade and Business","2000 ","0","0","0",
"76 s","Trade and Business","2001 ","0","0","0",
"76 s","Trade and Business","2002 ","0","0","0",
"76 s","Trade and Business","2003 ","0","0","0",
"76 s","Trade and Business","2004 ","0","0","0",
"76 s","Trade and Business","2005 ","0","0","0",
"76 s","Trade and Business","2006 ","0","0","0",
"76 s","Trade and Business","2007 ","0","0","0",
"76 s","Trade and Business","2008 ","0","0","0",
"76 s","Trade and Business","2009 ","0","0","0",
"76 s","Trade and Business","2010 ","0","0","0",
"76 s","Research","2000 ","0","0","0",
"76 s","Research","2001 ","0","0","0",
"76 s","Research","2002 ","0","0","0",
"76 s","Research","2003 ","0","0","0",
"76 s","Research","2004 ","0","0","0",
"76 s","Research","2005 ","0","0","0",
"76 s","Research","2006 ","0","0","0",
"76 s","Research","2007 ","0","0","0",
"76 s","Research","2008 ","0","0","0",
"76 s","Research","2009 ","0","0","0",
"76 s","Research","2010 ","0","0","0",
"76 s","Art and Entertainment","2000 ","0","0","0",
"76 s","Art and Entertainment","2001 ","0","0","0",
"76 s","Art and Entertainment","2002 ","0","0","0",
"76 s","Art and Entertainment","2003 ","0","0","0",
"76 s","Art and Entertainment","2004 ","2","2","0",
"76 s","Art and Entertainment","2005 ","1","1","0",
"76 s","Art and Entertainment","2006 ","1","0","1",
"76 s","Art and Entertainment","2007 ","0","0","0",
"76 s","Art and Entertainment","2008 ","0","0","0",
"76 s","Art and Entertainment","2009 ","0","0","0",
"76 s","Art and Entertainment","2010 ","0","0","0",
"76 s","Unskilled Employment","2000 ","0","0","0",
"76 s","Unskilled Employment","2001 ","0","0","0",
"76 s","Unskilled Employment","2002 ","0","0","0",
"76 s","Unskilled Employment","2003 ","0","0","0",
"76 s","Unskilled Employment","2004 ","0","0","0",
"76 s","Unskilled Employment","2005 ","0","0","0",
"76 s","Unskilled Employment","2006 ","0","0","0",
"76 s","Unskilled Employment","2007 ","0","0","0",
"76 s","Unskilled Employment","2008 ","0","0","0",
"76 s","Unskilled Employment","2009 ","0","0","0",
"76 s","Unskilled Employment","2010 ","0","0","0",
"76 s","Visiting and Joining Family","2000 ","11","3","8",
"76 s","Visiting and Joining Family","2001 ","16","8","8",
"76 s","Visiting and Joining Family","2002 ","11","4","7",
"76 s","Visiting and Joining Family","2003 ","13","10","3",
"76 s","Visiting and Joining Family","2004 ","18","8","10",
"76 s","Visiting and Joining Family","2005 ","37","19","18",
"76 s","Visiting and Joining Family","2006 ","29","6","23",
"76 s","Visiting and Joining Family","2007 ","30","12","18",
"76 s","Visiting and Joining Family","2008 ","30","13","17",
"76 s","Visiting and Joining Family","2009 ","19","12","7",
"76 s","Visiting and Joining Family","2010 ","4","2","2",
"76 s","Visiting and Joining Family","2011 ","38","16","22",
"76 s","Visiting and Joining Family","2012 ","151","34","117",
"76 s","Visiting and Joining Family","2013 ","124","22","102",
"76 s","Visiting and Joining Family","2014 ","30","7","23",
"76 s","Visiting and Joining Family","2015 ","8","5","3",
"76 s","Visiting and Joining Family","2016 ","12","4","8",
"76 s","Visiting and Joining Family","2017 ","9","4","5",
"76 s","Visiting and Joining Family","2018 ","6","4","2",
"76 s","Visiting and Joining Family","2019 ","11","7","4",
"76 s","Overseas Koreans","2000 ","1","0","1",
"76 s","Overseas Koreans","2001 ","1","1","0",
"76 s","Overseas Koreans","2002 ","1","1","0",
"76 s","Overseas Koreans","2003 ","5","4","1",
"76 s","Overseas Koreans","2004 ","7","2","5",
"76 s","Overseas Koreans","2005 ","9","3","6",
"76 s","Overseas Koreans","2006 ","11","8","3",
"76 s","Overseas Koreans","2007 ","10","4","6",
"76 s","Overseas Koreans","2008 ","14","7","7",
"76 s","Overseas Koreans","2009 ","16","12","4",
"76 s","Overseas Koreans","2010 ","28","15","13",
"76 s","Overseas Koreans","2011 ","38","18","20",
"76 s","Overseas Koreans","2012 ","64","33","31",
"76 s","Overseas Koreans","2013 ","109","50","59",
"76 s","Overseas Koreans","2014 ","374","101","273",
"76 s","Overseas Koreans","2015 ","461","149","312",
"76 s","Overseas Koreans","2016 ","464","142","322",
"76 s","Overseas Koreans","2017 ","461","150","311",
"76 s","Overseas Koreans","2018 ","464","136","328",
"76 s","Overseas Koreans","2019 ","434","131","303",
"76 s","Permanent Residence","2000 ","0","0","0",
"76 s","Permanent Residence","2001 ","0","0","0",
"76 s","Permanent Residence","2002 ","0","0","0",
"76 s","Permanent Residence","2003 ","2","2","0",
"76 s","Permanent Residence","2004 ","6","0","6",
"76 s","Permanent Residence","2005 ","2","1","1",
"76 s","Permanent Residence","2006 ","3","2","1",
"76 s","Permanent Residence","2007 ","1","1","0",
"76 s","Permanent Residence","2008 ","5","2","3",
"76 s","Permanent Residence","2009 ","6","2","4",
"76 s","Permanent Residence","2010 ","3","1","2",
"76 s","Permanent Residence","2011 ","5","1","4",
"76 s","Permanent Residence","2012 ","5","1","4",
"76 s","Permanent Residence","2013 ","8","2","6",
"76 s","Permanent Residence","2014 ","8","5","3",
"76 s","Permanent Residence","2015 ","8","2","6",
"76 s","Permanent Residence","2016 ","11","7","4",
"76 s","Permanent Residence","2017 ","13","7","6",
"76 s","Permanent Residence","2018 ","14","5","9",
"76 s","Permanent Residence","2019 ","10","7","3",
"76 s","Marriage Immigration","2012 ","2","2","",
"76 s","Marriage Immigration","2013 ","4","2","2",
"76 s","Marriage Immigration","2014 ","4","3","1",
"76 s","Marriage Immigration","2015 ","2","2","0",
"76 s","Marriage Immigration","2016 ","4","3","1",
"76 s","Marriage Immigration","2017 ","5","5","0",
"76 s","Marriage Immigration","2018 ","8","8","0",
"76 s","Marriage Immigration","2019 ","3","3","0",
"77 s","Total","2000 ","104","44","60",
"77 s","Total","2001 ","86","35","51",
"77 s","Total","2002 ","94","34","60",
"77 s","Total","2003 ","71","28","43",
"77 s","Total","2004 ","88","31","57",
"77 s","Total","2005 ","175","54","121",
"77 s","Total","2006 ","170","54","116",
"77 s","Total","2007 ","134","38","96",
"77 s","Total","2008 ","136","45","91",
"77 s","Total","2009 ","106","36","70",
"77 s","Total","2010 ","155","57","98",
"77 s","Total","2011 ","220","72","148",
"77 s","Total","2012 ","289","101","188",
"77 s","Total","2013 ","268","82","186",
"77 s","Total","2014 ","390","110","280",
"77 s","Total","2015 ","454","141","313",
"77 s","Total","2016 ","548","197","351",
"77 s","Total","2017 ","461","129","332",
"77 s","Total","2018 ","490","163","327",
"77 s","Total","2019 ","511","176","335",
"77 s","Sightseeing Pass","2000 ","21","6","15",
"77 s","Sightseeing Pass","2001 ","31","16","15",
"77 s","Sightseeing Pass","2002 ","20","8","12",
"77 s","Sightseeing Pass","2003 ","24","11","13",
"77 s","Sightseeing Pass","2004 ","19","9","10",
"77 s","Sightseeing Pass","2005 ","23","7","16",
"77 s","Sightseeing Pass","2006 ","19","8","11",
"77 s","Sightseeing Pass","2007 ","16","8","8",
"77 s","Sightseeing Pass","2008 ","22","6","16",
"77 s","Sightseeing Pass","2009 ","21","8","13",
"77 s","Sightseeing Pass","2010 ","33","13","20",
"77 s","Sightseeing Pass","2011 ","27","15","12",
"77 s","Sightseeing Pass","2012 ","58","29","29",
"77 s","Sightseeing Pass","2013 ","33","15","18",
"77 s","Sightseeing Pass","2014 ","27","9","18",
"77 s","Sightseeing Pass","2015 ","42","17","25",
"77 s","Sightseeing Pass","2016 ","45","23","22",
"77 s","Sightseeing Pass","2017 ","26","10","16",
"77 s","Sightseeing Pass","2018 ","39","17","22",
"77 s","Sightseeing Pass","2019 ","39","14","25",
"77 s","Short-term Business","2000 ","0","0","0",
"77 s","Short-term Business","2001 ","1","0","1",
"77 s","Short-term Business","2002 ","1","0","1",
"77 s","Short-term Business","2003 ","0","0","0",
"77 s","Short-term Business","2004 ","0","0","0",
"77 s","Short-term Business","2005 ","0","0","0",
"77 s","Short-term Business","2006 ","1","1","0",
"77 s","Short-term Business","2007 ","0","0","0",
"77 s","Short-term Business","2008 ","0","0","0",
"77 s","Short-term Business","2009 ","0","0","0",
"77 s","Short-term Business","2010 ","0","0","0",
"77 s","Short-term Visitors","2000 ","59","27","32",
"77 s","Short-term Visitors","2001 ","28","7","21",
"77 s","Short-term Visitors","2002 ","34","10","24",
"77 s","Short-term Visitors","2003 ","29","9","20",
"77 s","Short-term Visitors","2004 ","47","14","33",
"77 s","Short-term Visitors","2005 ","103","24","79",
"77 s","Short-term Visitors","2006 ","97","26","71",
"77 s","Short-term Visitors","2007 ","58","8","50",
"77 s","Short-term Visitors","2008 ","36","13","23",
"77 s","Short-term Visitors","2009 ","31","4","27",
"77 s","Short-term Visitors","2010 ","60","18","42",
"77 s","Short-term Visitors","2011 ","99","24","75",
"77 s","Short-term Visitors","2012 ","22","8","14",
"77 s","Short-term Visitors","2013 ","21","8","13",
"77 s","Short-term Visitors","2014 ","15","4","11",
"77 s","Short-term Visitors","2015 ","16","8","8",
"77 s","Short-term Visitors","2016 ","17","4","13",
"77 s","Short-term Visitors","2017 ","17","8","9",
"77 s","Short-term Visitors","2018 ","15","3","12",
"77 s","Short-term Visitors","2019 ","18","4","14",
"77 s","Short-term Employment","2000 ","0","0","0",
"77 s","Short-term Employment","2001 ","0","0","0",
"77 s","Short-term Employment","2002 ","0","0","0",
"77 s","Short-term Employment","2003 ","0","0","0",
"77 s","Short-term Employment","2004 ","0","0","0",
"77 s","Short-term Employment","2005 ","0","0","0",
"77 s","Short-term Employment","2006 ","0","0","0",
"77 s","Short-term Employment","2007 ","0","0","0",
"77 s","Short-term Employment","2008 ","0","0","0",
"77 s","Short-term Employment","2009 ","0","0","0",
"77 s","Short-term Employment","2010 ","0","0","0",
"77 s","Job Seeking","2000 ","0","0","0",
"77 s","Job Seeking","2001 ","0","0","0",
"77 s","Job Seeking","2002 ","0","0","0",
"77 s","Job Seeking","2003 ","0","0","0",
"77 s","Job Seeking","2004 ","0","0","0",
"77 s","Job Seeking","2005 ","0","0","0",
"77 s","Job Seeking","2006 ","0","0","0",
"77 s","Job Seeking","2007 ","0","0","0",
"77 s","Job Seeking","2008 ","0","0","0",
"77 s","Job Seeking","2009 ","0","0","0",
"77 s","Job Seeking","2010 ","0","0","0",
"77 s","study","2000 ","0","0","0",
"77 s","study","2001 ","0","0","0",
"77 s","study","2002 ","0","0","0",
"77 s","study","2003 ","0","0","0",
"77 s","study","2004 ","0","0","0",
"77 s","study","2005 ","0","0","0",
"77 s","study","2006 ","0","0","0",
"77 s","study","2007 ","0","0","0",
"77 s","study","2008 ","0","0","0",
"77 s","study","2009 ","0","0","0",
"77 s","study","2010 ","0","0","0",
"77 s","study","2011 ","1","","1",
"77 s","General Trainees","2000 ","0","0","0",
"77 s","General Trainees","2001 ","0","0","0",
"77 s","General Trainees","2002 ","0","0","0",
"77 s","General Trainees","2003 ","0","0","0",
"77 s","General Trainees","2004 ","0","0","0",
"77 s","General Trainees","2005 ","0","0","0",
"77 s","General Trainees","2006 ","0","0","0",
"77 s","General Trainees","2007 ","0","0","0",
"77 s","General Trainees","2008 ","0","0","0",
"77 s","General Trainees","2009 ","0","0","0",
"77 s","General Trainees","2010 ","0","0","0",
"77 s","Religious Activities","2000 ","0","0","0",
"77 s","Religious Activities","2001 ","0","0","0",
"77 s","Religious Activities","2002 ","3","0","3",
"77 s","Religious Activities","2003 ","0","0","0",
"77 s","Religious Activities","2004 ","0","0","0",
"77 s","Religious Activities","2005 ","2","2","0",
"77 s","Religious Activities","2006 ","1","1","0",
"77 s","Religious Activities","2007 ","2","1","1",
"77 s","Religious Activities","2008 ","0","0","0",
"77 s","Religious Activities","2009 ","0","0","0",
"77 s","Religious Activities","2010 ","0","0","0",
"77 s","Religious Activities","2011 ","2","2","",
"77 s","Religious Activities","2014 ","2","2","0",
"77 s","Religious Activities","2015 ","1","0","1",
"77 s","Religious Activities","2017 ","3","2","1",
"77 s","Religious Activities","2019 ","1","1","0",
"77 s","Investors","2000 ","0","0","0",
"77 s","Investors","2001 ","0","0","0",
"77 s","Investors","2002 ","0","0","0",
"77 s","Investors","2003 ","1","1","0",
"77 s","Investors","2004 ","0","0","0",
"77 s","Investors","2005 ","0","0","0",
"77 s","Investors","2006 ","0","0","0",
"77 s","Investors","2007 ","0","0","0",
"77 s","Investors","2008 ","0","0","0",
"77 s","Investors","2009 ","0","0","0",
"77 s","Investors","2010 ","0","0","0",
"77 s","Trade and Business","2000 ","0","0","0",
"77 s","Trade and Business","2001 ","1","1","0",
"77 s","Trade and Business","2002 ","0","0","0",
"77 s","Trade and Business","2003 ","0","0","0",
"77 s","Trade and Business","2004 ","0","0","0",
"77 s","Trade and Business","2005 ","0","0","0",
"77 s","Trade and Business","2006 ","0","0","0",
"77 s","Trade and Business","2007 ","0","0","0",
"77 s","Trade and Business","2008 ","0","0","0",
"77 s","Trade and Business","2009 ","0","0","0",
"77 s","Trade and Business","2010 ","0","0","0",
"77 s","Trade and Business","2019 ","1","1","0",
"77 s","Research","2000 ","0","0","0",
"77 s","Research","2001 ","0","0","0",
"77 s","Research","2002 ","0","0","0",
"77 s","Research","2003 ","0","0","0",
"77 s","Research","2004 ","0","0","0",
"77 s","Research","2005 ","0","0","0",
"77 s","Research","2006 ","1","1","0",
"77 s","Research","2007 ","1","1","0",
"77 s","Research","2008 ","0","0","0",
"77 s","Research","2009 ","0","0","0",
"77 s","Research","2010 ","0","0","0",
"77 s","Research","2019 ","1","1","0",
"77 s","Art and Entertainment","2000 ","0","0","0",
"77 s","Art and Entertainment","2001 ","0","0","0",
"77 s","Art and Entertainment","2002 ","0","0","0",
"77 s","Art and Entertainment","2003 ","0","0","0",
"77 s","Art and Entertainment","2004 ","0","0","0",
"77 s","Art and Entertainment","2005 ","0","0","0",
"77 s","Art and Entertainment","2006 ","0","0","0",
"77 s","Art and Entertainment","2007 ","0","0","0",
"77 s","Art and Entertainment","2008 ","0","0","0",
"77 s","Art and Entertainment","2009 ","0","0","0",
"77 s","Art and Entertainment","2010 ","0","0","0",
"77 s","Unskilled Employment","2000 ","0","0","0",
"77 s","Unskilled Employment","2001 ","0","0","0",
"77 s","Unskilled Employment","2002 ","0","0","0",
"77 s","Unskilled Employment","2003 ","0","0","0",
"77 s","Unskilled Employment","2004 ","0","0","0",
"77 s","Unskilled Employment","2005 ","0","0","0",
"77 s","Unskilled Employment","2006 ","0","0","0",
"77 s","Unskilled Employment","2007 ","0","0","0",
"77 s","Unskilled Employment","2008 ","0","0","0",
"77 s","Unskilled Employment","2009 ","0","0","0",
"77 s","Unskilled Employment","2010 ","0","0","0",
"77 s","Visiting and Joining Family","2000 ","9","3","6",
"77 s","Visiting and Joining Family","2001 ","13","7","6",
"77 s","Visiting and Joining Family","2002 ","15","5","10",
"77 s","Visiting and Joining Family","2003 ","7","1","6",
"77 s","Visiting and Joining Family","2004 ","8","3","5",
"77 s","Visiting and Joining Family","2005 ","24","11","13",
"77 s","Visiting and Joining Family","2006 ","28","4","24",
"77 s","Visiting and Joining Family","2007 ","26","11","15",
"77 s","Visiting and Joining Family","2008 ","21","15","6",
"77 s","Visiting and Joining Family","2009 ","18","7","11",
"77 s","Visiting and Joining Family","2010 ","3","2","1",
"77 s","Visiting and Joining Family","2011 ","22","10","12",
"77 s","Visiting and Joining Family","2012 ","124","28","96",
"77 s","Visiting and Joining Family","2013 ","106","16","90",
"77 s","Visiting and Joining Family","2014 ","17","2","15",
"77 s","Visiting and Joining Family","2015 ","7","4","3",
"77 s","Visiting and Joining Family","2016 ","7","6","1",
"77 s","Visiting and Joining Family","2017 ","4","0","4",
"77 s","Visiting and Joining Family","2018 ","4","3","1",
"77 s","Visiting and Joining Family","2019 ","2","2","0",
"77 s","Overseas Koreans","2000 ","4","3","1",
"77 s","Overseas Koreans","2001 ","3","1","2",
"77 s","Overseas Koreans","2002 ","1","0","1",
"77 s","Overseas Koreans","2003 ","5","2","3",
"77 s","Overseas Koreans","2004 ","4","2","2",
"77 s","Overseas Koreans","2005 ","8","3","5",
"77 s","Overseas Koreans","2006 ","7","4","3",
"77 s","Overseas Koreans","2007 ","7","4","3",
"77 s","Overseas Koreans","2008 ","6","3","3",
"77 s","Overseas Koreans","2009 ","12","6","6",
"77 s","Overseas Koreans","2010 ","22","11","11",
"77 s","Overseas Koreans","2011 ","32","14","18",
"77 s","Overseas Koreans","2012 ","43","19","24",
"77 s","Overseas Koreans","2013 ","87","33","54",
"77 s","Overseas Koreans","2014 ","303","87","216",
"77 s","Overseas Koreans","2015 ","364","101","263",
"77 s","Overseas Koreans","2016 ","455","151","304",
"77 s","Overseas Koreans","2017 ","384","94","290",
"77 s","Overseas Koreans","2018 ","414","134","280",
"77 s","Overseas Koreans","2019 ","420","139","281",
"77 s","Permanent Residence","2000 ","0","0","0",
"77 s","Permanent Residence","2001 ","0","0","0",
"77 s","Permanent Residence","2002 ","0","0","0",
"77 s","Permanent Residence","2003 ","0","0","0",
"77 s","Permanent Residence","2004 ","4","2","2",
"77 s","Permanent Residence","2005 ","1","0","1",
"77 s","Permanent Residence","2006 ","3","1","2",
"77 s","Permanent Residence","2007 ","2","0","2",
"77 s","Permanent Residence","2008 ","1","1","0",
"77 s","Permanent Residence","2009 ","2","2","0",
"77 s","Permanent Residence","2010 ","8","2","6",
"77 s","Permanent Residence","2011 ","10","1","9",
"77 s","Permanent Residence","2012 ","9","4","5",
"77 s","Permanent Residence","2013 ","11","3","8",
"77 s","Permanent Residence","2014 ","12","2","10",
"77 s","Permanent Residence","2015 ","8","2","6",
"77 s","Permanent Residence","2016 ","11","4","7",
"77 s","Permanent Residence","2017 ","15","8","7",
"77 s","Permanent Residence","2018 ","6","1","5",
"77 s","Permanent Residence","2019 ","10","3","7",
"77 s","Marriage Immigration","2011 ","1","1","",
"77 s","Marriage Immigration","2012 ","1","","1",
"77 s","Marriage Immigration","2014 ","3","1","2",
"77 s","Marriage Immigration","2015 ","6","4","2",
"77 s","Marriage Immigration","2016 ","1","1","0",
"77 s","Marriage Immigration","2017 ","4","3","1",
"77 s","Marriage Immigration","2018 ","1","1","0",
"77 s","Marriage Immigration","2019 ","9","6","3",
"78 s","Total","2000 ","69","42","27",
"78 s","Total","2001 ","68","36","32",
"78 s","Total","2002 ","61","28","33",
"78 s","Total","2003 ","63","18","45",
"78 s","Total","2004 ","81","35","46",
"78 s","Total","2005 ","138","46","92",
"78 s","Total","2006 ","129","51","78",
"78 s","Total","2007 ","116","28","88",
"78 s","Total","2008 ","136","37","99",
"78 s","Total","2009 ","88","37","51",
"78 s","Total","2010 ","129","51","78",
"78 s","Total","2011 ","196","85","111",
"78 s","Total","2012 ","231","80","151",
"78 s","Total","2013 ","220","76","144",
"78 s","Total","2014 ","315","96","219",
"78 s","Total","2015 ","403","107","296",
"78 s","Total","2016 ","454","136","318",
"78 s","Total","2017 ","447","138","309",
"78 s","Total","2018 ","463","145","318",
"78 s","Total","2019 ","497","158","339",
"78 s","Sightseeing Pass","2000 ","18","10","8",
"78 s","Sightseeing Pass","2001 ","24","15","9",
"78 s","Sightseeing Pass","2002 ","19","9","10",
"78 s","Sightseeing Pass","2003 ","19","7","12",
"78 s","Sightseeing Pass","2004 ","18","7","11",
"78 s","Sightseeing Pass","2005 ","21","7","14",
"78 s","Sightseeing Pass","2006 ","19","12","7",
"78 s","Sightseeing Pass","2007 ","11","4","7",
"78 s","Sightseeing Pass","2008 ","12","5","7",
"78 s","Sightseeing Pass","2009 ","11","5","6",
"78 s","Sightseeing Pass","2010 ","28","12","16",
"78 s","Sightseeing Pass","2011 ","33","14","19",
"78 s","Sightseeing Pass","2012 ","52","23","29",
"78 s","Sightseeing Pass","2013 ","36","16","20",
"78 s","Sightseeing Pass","2014 ","18","10","8",
"78 s","Sightseeing Pass","2015 ","41","14","27",
"78 s","Sightseeing Pass","2016 ","50","24","26",
"78 s","Sightseeing Pass","2017 ","26","17","9",
"78 s","Sightseeing Pass","2018 ","35","20","15",
"78 s","Sightseeing Pass","2019 ","29","11","18",
"78 s","Short-term Business","2000 ","1","0","1",
"78 s","Short-term Business","2001 ","3","2","1",
"78 s","Short-term Business","2002 ","1","0","1",
"78 s","Short-term Business","2003 ","0","0","0",
"78 s","Short-term Business","2004 ","2","1","1",
"78 s","Short-term Business","2005 ","3","1","2",
"78 s","Short-term Business","2006 ","1","1","0",
"78 s","Short-term Business","2007 ","1","0","1",
"78 s","Short-term Business","2008 ","0","0","0",
"78 s","Short-term Business","2009 ","0","0","0",
"78 s","Short-term Business","2010 ","0","0","0",
"78 s","Short-term Visitors","2000 ","40","25","15",
"78 s","Short-term Visitors","2001 ","22","10","12",
"78 s","Short-term Visitors","2002 ","23","8","15",
"78 s","Short-term Visitors","2003 ","28","5","23",
"78 s","Short-term Visitors","2004 ","41","14","27",
"78 s","Short-term Visitors","2005 ","72","15","57",
"78 s","Short-term Visitors","2006 ","74","22","52",
"78 s","Short-term Visitors","2007 ","49","10","39",
"78 s","Short-term Visitors","2008 ","34","2","32",
"78 s","Short-term Visitors","2009 ","26","8","18",
"78 s","Short-term Visitors","2010 ","49","14","35",
"78 s","Short-term Visitors","2011 ","70","28","42",
"78 s","Short-term Visitors","2012 ","13","5","8",
"78 s","Short-term Visitors","2013 ","11","4","7",
"78 s","Short-term Visitors","2014 ","15","6","9",
"78 s","Short-term Visitors","2015 ","15","6","9",
"78 s","Short-term Visitors","2016 ","12","5","7",
"78 s","Short-term Visitors","2017 ","7","2","5",
"78 s","Short-term Visitors","2018 ","16","3","13",
"78 s","Short-term Visitors","2019 ","6","2","4",
"78 s","Short-term Employment","2000 ","0","0","0",
"78 s","Short-term Employment","2001 ","0","0","0",
"78 s","Short-term Employment","2002 ","0","0","0",
"78 s","Short-term Employment","2003 ","0","0","0",
"78 s","Short-term Employment","2004 ","0","0","0",
"78 s","Short-term Employment","2005 ","0","0","0",
"78 s","Short-term Employment","2006 ","0","0","0",
"78 s","Short-term Employment","2007 ","0","0","0",
"78 s","Short-term Employment","2008 ","0","0","0",
"78 s","Short-term Employment","2009 ","0","0","0",
"78 s","Short-term Employment","2010 ","0","0","0",
"78 s","Job Seeking","2000 ","0","0","0",
"78 s","Job Seeking","2001 ","0","0","0",
"78 s","Job Seeking","2002 ","0","0","0",
"78 s","Job Seeking","2003 ","0","0","0",
"78 s","Job Seeking","2004 ","0","0","0",
"78 s","Job Seeking","2005 ","0","0","0",
"78 s","Job Seeking","2006 ","0","0","0",
"78 s","Job Seeking","2007 ","0","0","0",
"78 s","Job Seeking","2008 ","0","0","0",
"78 s","Job Seeking","2009 ","0","0","0",
"78 s","Job Seeking","2010 ","0","0","0",
"78 s","study","2000 ","0","0","0",
"78 s","study","2001 ","0","0","0",
"78 s","study","2002 ","0","0","0",
"78 s","study","2003 ","0","0","0",
"78 s","study","2004 ","0","0","0",
"78 s","study","2005 ","0","0","0",
"78 s","study","2006 ","0","0","0",
"78 s","study","2007 ","0","0","0",
"78 s","study","2008 ","0","0","0",
"78 s","study","2009 ","0","0","0",
"78 s","study","2010 ","0","0","0",
"78 s","General Trainees","2000 ","0","0","0",
"78 s","General Trainees","2001 ","0","0","0",
"78 s","General Trainees","2002 ","0","0","0",
"78 s","General Trainees","2003 ","0","0","0",
"78 s","General Trainees","2004 ","0","0","0",
"78 s","General Trainees","2005 ","0","0","0",
"78 s","General Trainees","2006 ","0","0","0",
"78 s","General Trainees","2007 ","0","0","0",
"78 s","General Trainees","2008 ","0","0","0",
"78 s","General Trainees","2009 ","0","0","0",
"78 s","General Trainees","2010 ","0","0","0",
"78 s","Religious Activities","2000 ","0","0","0",
"78 s","Religious Activities","2001 ","1","1","0",
"78 s","Religious Activities","2002 ","0","0","0",
"78 s","Religious Activities","2003 ","0","0","0",
"78 s","Religious Activities","2004 ","1","1","0",
"78 s","Religious Activities","2005 ","1","1","0",
"78 s","Religious Activities","2006 ","0","0","0",
"78 s","Religious Activities","2007 ","1","1","0",
"78 s","Religious Activities","2008 ","1","1","0",
"78 s","Religious Activities","2009 ","3","3","0",
"78 s","Religious Activities","2010 ","0","0","0",
"78 s","Religious Activities","2011 ","2","","2",
"78 s","Religious Activities","2012 ","1","1","",
"78 s","Religious Activities","2013 ","1","1","0",
"78 s","Religious Activities","2014 ","1","0","1",
"78 s","Religious Activities","2016 ","1","0","1",
"78 s","Investors","2000 ","0","0","0",
"78 s","Investors","2001 ","0","0","0",
"78 s","Investors","2002 ","0","0","0",
"78 s","Investors","2003 ","0","0","0",
"78 s","Investors","2004 ","1","1","0",
"78 s","Investors","2005 ","0","0","0",
"78 s","Investors","2006 ","0","0","0",
"78 s","Investors","2007 ","0","0","0",
"78 s","Investors","2008 ","0","0","0",
"78 s","Investors","2009 ","0","0","0",
"78 s","Investors","2010 ","0","0","0",
"78 s","Trade and Business","2000 ","0","0","0",
"78 s","Trade and Business","2001 ","0","0","0",
"78 s","Trade and Business","2002 ","0","0","0",
"78 s","Trade and Business","2003 ","0","0","0",
"78 s","Trade and Business","2004 ","0","0","0",
"78 s","Trade and Business","2005 ","0","0","0",
"78 s","Trade and Business","2006 ","0","0","0",
"78 s","Trade and Business","2007 ","0","0","0",
"78 s","Trade and Business","2008 ","0","0","0",
"78 s","Trade and Business","2009 ","0","0","0",
"78 s","Trade and Business","2010 ","0","0","0",
"78 s","Trade and Business","2011 ","1","1","",
"78 s","Research","2000 ","0","0","0",
"78 s","Research","2001 ","0","0","0",
"78 s","Research","2002 ","0","0","0",
"78 s","Research","2003 ","0","0","0",
"78 s","Research","2004 ","0","0","0",
"78 s","Research","2005 ","0","0","0",
"78 s","Research","2006 ","0","0","0",
"78 s","Research","2007 ","0","0","0",
"78 s","Research","2008 ","0","0","0",
"78 s","Research","2009 ","0","0","0",
"78 s","Research","2010 ","0","0","0",
"78 s","Research","2016 ","1","1","0",
"78 s","Art and Entertainment","2000 ","0","0","0",
"78 s","Art and Entertainment","2001 ","0","0","0",
"78 s","Art and Entertainment","2002 ","0","0","0",
"78 s","Art and Entertainment","2003 ","0","0","0",
"78 s","Art and Entertainment","2004 ","0","0","0",
"78 s","Art and Entertainment","2005 ","0","0","0",
"78 s","Art and Entertainment","2006 ","0","0","0",
"78 s","Art and Entertainment","2007 ","0","0","0",
"78 s","Art and Entertainment","2008 ","0","0","0",
"78 s","Art and Entertainment","2009 ","0","0","0",
"78 s","Art and Entertainment","2010 ","0","0","0",
"78 s","Unskilled Employment","2000 ","0","0","0",
"78 s","Unskilled Employment","2001 ","0","0","0",
"78 s","Unskilled Employment","2002 ","0","0","0",
"78 s","Unskilled Employment","2003 ","0","0","0",
"78 s","Unskilled Employment","2004 ","0","0","0",
"78 s","Unskilled Employment","2005 ","0","0","0",
"78 s","Unskilled Employment","2006 ","0","0","0",
"78 s","Unskilled Employment","2007 ","0","0","0",
"78 s","Unskilled Employment","2008 ","0","0","0",
"78 s","Unskilled Employment","2009 ","0","0","0",
"78 s","Unskilled Employment","2010 ","0","0","0",
"78 s","Visiting and Joining Family","2000 ","5","4","1",
"78 s","Visiting and Joining Family","2001 ","11","3","8",
"78 s","Visiting and Joining Family","2002 ","8","4","4",
"78 s","Visiting and Joining Family","2003 ","7","0","7",
"78 s","Visiting and Joining Family","2004 ","5","1","4",
"78 s","Visiting and Joining Family","2005 ","19","8","11",
"78 s","Visiting and Joining Family","2006 ","18","8","10",
"78 s","Visiting and Joining Family","2007 ","29","8","21",
"78 s","Visiting and Joining Family","2008 ","28","11","17",
"78 s","Visiting and Joining Family","2009 ","16","8","8",
"78 s","Visiting and Joining Family","2010 ","6","5","1",
"78 s","Visiting and Joining Family","2011 ","34","15","19",
"78 s","Visiting and Joining Family","2012 ","91","22","69",
"78 s","Visiting and Joining Family","2013 ","78","16","62",
"78 s","Visiting and Joining Family","2014 ","9","0","9",
"78 s","Visiting and Joining Family","2015 ","2","0","2",
"78 s","Visiting and Joining Family","2016 ","1","1","0",
"78 s","Visiting and Joining Family","2017 ","3","2","1",
"78 s","Visiting and Joining Family","2018 ","5","3","2",
"78 s","Visiting and Joining Family","2019 ","3","1","2",
"78 s","Overseas Koreans","2000 ","0","0","0",
"78 s","Overseas Koreans","2001 ","3","2","1",
"78 s","Overseas Koreans","2002 ","3","3","0",
"78 s","Overseas Koreans","2003 ","3","3","0",
"78 s","Overseas Koreans","2004 ","4","4","0",
"78 s","Overseas Koreans","2005 ","7","6","1",
"78 s","Overseas Koreans","2006 ","6","2","4",
"78 s","Overseas Koreans","2007 ","10","2","8",
"78 s","Overseas Koreans","2008 ","11","7","4",
"78 s","Overseas Koreans","2009 ","11","7","4",
"78 s","Overseas Koreans","2010 ","11","7","4",
"78 s","Overseas Koreans","2011 ","24","15","9",
"78 s","Overseas Koreans","2012 ","32","14","18",
"78 s","Overseas Koreans","2013 ","72","28","44",
"78 s","Overseas Koreans","2014 ","257","71","186",
"78 s","Overseas Koreans","2015 ","331","84","247",
"78 s","Overseas Koreans","2016 ","370","93","277",
"78 s","Overseas Koreans","2017 ","399","113","286",
"78 s","Overseas Koreans","2018 ","396","114","282",
"78 s","Overseas Koreans","2019 ","427","134","293",
"78 s","Permanent Residence","2000 ","0","0","0",
"78 s","Permanent Residence","2001 ","0","0","0",
"78 s","Permanent Residence","2002 ","0","0","0",
"78 s","Permanent Residence","2003 ","1","0","1",
"78 s","Permanent Residence","2004 ","1","1","0",
"78 s","Permanent Residence","2005 ","2","1","1",
"78 s","Permanent Residence","2006 ","1","1","0",
"78 s","Permanent Residence","2007 ","2","0","2",
"78 s","Permanent Residence","2008 ","1","1","0",
"78 s","Permanent Residence","2009 ","6","2","4",
"78 s","Permanent Residence","2010 ","5","1","4",
"78 s","Permanent Residence","2011 ","6","3","3",
"78 s","Permanent Residence","2012 ","11","5","6",
"78 s","Permanent Residence","2013 ","10","4","6",
"78 s","Permanent Residence","2014 ","7","6","1",
"78 s","Permanent Residence","2015 ","8","1","7",
"78 s","Permanent Residence","2016 ","8","4","4",
"78 s","Permanent Residence","2017 ","6","2","4",
"78 s","Permanent Residence","2018 ","4","2","2",
"78 s","Permanent Residence","2019 ","16","6","10",
"78 s","Marriage Immigration","2012 ","3","2","1",
"78 s","Marriage Immigration","2013 ","6","4","2",
"78 s","Marriage Immigration","2014 ","1","1","0",
"78 s","Marriage Immigration","2016 ","3","3","0",
"78 s","Marriage Immigration","2017 ","2","0","2",
"78 s","Marriage Immigration","2018 ","2","1","1",
"78 s","Marriage Immigration","2019 ","2","0","2",
"79 s","Total","2000 ","64","34","30",
"79 s","Total","2001 ","52","33","19",
"79 s","Total","2002 ","56","25","31",
"79 s","Total","2003 ","45","13","32",
"79 s","Total","2004 ","64","18","46",
"79 s","Total","2005 ","123","44","79",
"79 s","Total","2006 ","118","28","90",
"79 s","Total","2007 ","97","34","63",
"79 s","Total","2008 ","95","26","69",
"79 s","Total","2009 ","98","34","64",
"79 s","Total","2010 ","124","42","82",
"79 s","Total","2011 ","162","55","107",
"79 s","Total","2012 ","186","58","128",
"79 s","Total","2013 ","185","49","136",
"79 s","Total","2014 ","304","85","219",
"79 s","Total","2015 ","320","97","223",
"79 s","Total","2016 ","363","121","242",
"79 s","Total","2017 ","387","121","266",
"79 s","Total","2018 ","452","139","313",
"79 s","Total","2019 ","444","129","315",
"79 s","Sightseeing Pass","2000 ","17","7","10",
"79 s","Sightseeing Pass","2001 ","19","14","5",
"79 s","Sightseeing Pass","2002 ","19","9","10",
"79 s","Sightseeing Pass","2003 ","14","5","9",
"79 s","Sightseeing Pass","2004 ","12","4","8",
"79 s","Sightseeing Pass","2005 ","19","14","5",
"79 s","Sightseeing Pass","2006 ","28","8","20",
"79 s","Sightseeing Pass","2007 ","7","3","4",
"79 s","Sightseeing Pass","2008 ","11","5","6",
"79 s","Sightseeing Pass","2009 ","19","5","14",
"79 s","Sightseeing Pass","2010 ","37","19","18",
"79 s","Sightseeing Pass","2011 ","31","12","19",
"79 s","Sightseeing Pass","2012 ","38","13","25",
"79 s","Sightseeing Pass","2013 ","24","6","18",
"79 s","Sightseeing Pass","2014 ","25","13","12",
"79 s","Sightseeing Pass","2015 ","23","9","14",
"79 s","Sightseeing Pass","2016 ","36","20","16",
"79 s","Sightseeing Pass","2017 ","22","7","15",
"79 s","Sightseeing Pass","2018 ","23","9","14",
"79 s","Sightseeing Pass","2019 ","26","11","15",
"79 s","Short-term Business","2000 ","0","0","0",
"79 s","Short-term Business","2001 ","0","0","0",
"79 s","Short-term Business","2002 ","1","1","0",
"79 s","Short-term Business","2003 ","0","0","0",
"79 s","Short-term Business","2004 ","1","1","0",
"79 s","Short-term Business","2005 ","0","0","0",
"79 s","Short-term Business","2006 ","0","0","0",
"79 s","Short-term Business","2007 ","0","0","0",
"79 s","Short-term Business","2008 ","0","0","0",
"79 s","Short-term Business","2009 ","0","0","0",
"79 s","Short-term Business","2010 ","0","0","0",
"79 s","Short-term Visitors","2000 ","29","15","14",
"79 s","Short-term Visitors","2001 ","14","7","7",
"79 s","Short-term Visitors","2002 ","19","5","14",
"79 s","Short-term Visitors","2003 ","17","3","14",
"79 s","Short-term Visitors","2004 ","29","5","24",
"79 s","Short-term Visitors","2005 ","76","17","59",
"79 s","Short-term Visitors","2006 ","61","6","55",
"79 s","Short-term Visitors","2007 ","45","8","37",
"79 s","Short-term Visitors","2008 ","22","7","15",
"79 s","Short-term Visitors","2009 ","25","5","20",
"79 s","Short-term Visitors","2010 ","52","13","39",
"79 s","Short-term Visitors","2011 ","63","16","47",
"79 s","Short-term Visitors","2012 ","18","6","12",
"79 s","Short-term Visitors","2013 ","13","4","9",
"79 s","Short-term Visitors","2014 ","10","5","5",
"79 s","Short-term Visitors","2015 ","8","4","4",
"79 s","Short-term Visitors","2016 ","15","6","9",
"79 s","Short-term Visitors","2017 ","7","2","5",
"79 s","Short-term Visitors","2018 ","8","2","6",
"79 s","Short-term Visitors","2019 ","12","5","7",
"79 s","Short-term Employment","2000 ","0","0","0",
"79 s","Short-term Employment","2001 ","0","0","0",
"79 s","Short-term Employment","2002 ","0","0","0",
"79 s","Short-term Employment","2003 ","0","0","0",
"79 s","Short-term Employment","2004 ","0","0","0",
"79 s","Short-term Employment","2005 ","0","0","0",
"79 s","Short-term Employment","2006 ","0","0","0",
"79 s","Short-term Employment","2007 ","0","0","0",
"79 s","Short-term Employment","2008 ","0","0","0",
"79 s","Short-term Employment","2009 ","0","0","0",
"79 s","Short-term Employment","2010 ","0","0","0",
"79 s","Job Seeking","2000 ","0","0","0",
"79 s","Job Seeking","2001 ","0","0","0",
"79 s","Job Seeking","2002 ","0","0","0",
"79 s","Job Seeking","2003 ","0","0","0",
"79 s","Job Seeking","2004 ","0","0","0",
"79 s","Job Seeking","2005 ","0","0","0",
"79 s","Job Seeking","2006 ","0","0","0",
"79 s","Job Seeking","2007 ","0","0","0",
"79 s","Job Seeking","2008 ","0","0","0",
"79 s","Job Seeking","2009 ","0","0","0",
"79 s","Job Seeking","2010 ","0","0","0",
"79 s","study","2000 ","0","0","0",
"79 s","study","2001 ","0","0","0",
"79 s","study","2002 ","0","0","0",
"79 s","study","2003 ","0","0","0",
"79 s","study","2004 ","0","0","0",
"79 s","study","2005 ","0","0","0",
"79 s","study","2006 ","0","0","0",
"79 s","study","2007 ","0","0","0",
"79 s","study","2008 ","0","0","0",
"79 s","study","2009 ","0","0","0",
"79 s","study","2010 ","0","0","0",
"79 s","General Trainees","2000 ","0","0","0",
"79 s","General Trainees","2001 ","0","0","0",
"79 s","General Trainees","2002 ","0","0","0",
"79 s","General Trainees","2003 ","0","0","0",
"79 s","General Trainees","2004 ","0","0","0",
"79 s","General Trainees","2005 ","0","0","0",
"79 s","General Trainees","2006 ","0","0","0",
"79 s","General Trainees","2007 ","0","0","0",
"79 s","General Trainees","2008 ","0","0","0",
"79 s","General Trainees","2009 ","0","0","0",
"79 s","General Trainees","2010 ","0","0","0",
"79 s","Religious Activities","2000 ","1","1","0",
"79 s","Religious Activities","2001 ","0","0","0",
"79 s","Religious Activities","2002 ","0","0","0",
"79 s","Religious Activities","2003 ","0","0","0",
"79 s","Religious Activities","2004 ","1","0","1",
"79 s","Religious Activities","2005 ","0","0","0",
"79 s","Religious Activities","2006 ","0","0","0",
"79 s","Religious Activities","2007 ","1","1","0",
"79 s","Religious Activities","2008 ","1","1","0",
"79 s","Religious Activities","2009 ","1","0","1",
"79 s","Religious Activities","2010 ","1","1","0",
"79 s","Religious Activities","2011 ","2","","2",
"79 s","Religious Activities","2013 ","2","2","0",
"79 s","Religious Activities","2018 ","1","1","0",
"79 s","Religious Activities","2019 ","1","1","0",
"79 s","Investors","2000 ","0","0","0",
"79 s","Investors","2001 ","0","0","0",
"79 s","Investors","2002 ","1","1","0",
"79 s","Investors","2003 ","0","0","0",
"79 s","Investors","2004 ","0","0","0",
"79 s","Investors","2005 ","0","0","0",
"79 s","Investors","2006 ","0","0","0",
"79 s","Investors","2007 ","0","0","0",
"79 s","Investors","2008 ","0","0","0",
"79 s","Investors","2009 ","0","0","0",
"79 s","Investors","2010 ","0","0","0",
"79 s","Trade and Business","2000 ","0","0","0",
"79 s","Trade and Business","2001 ","0","0","0",
"79 s","Trade and Business","2002 ","0","0","0",
"79 s","Trade and Business","2003 ","0","0","0",
"79 s","Trade and Business","2004 ","0","0","0",
"79 s","Trade and Business","2005 ","0","0","0",
"79 s","Trade and Business","2006 ","0","0","0",
"79 s","Trade and Business","2007 ","0","0","0",
"79 s","Trade and Business","2008 ","0","0","0",
"79 s","Trade and Business","2009 ","0","0","0",
"79 s","Trade and Business","2010 ","0","0","0",
"79 s","Research","2000 ","0","0","0",
"79 s","Research","2001 ","0","0","0",
"79 s","Research","2002 ","0","0","0",
"79 s","Research","2003 ","0","0","0",
"79 s","Research","2004 ","0","0","0",
"79 s","Research","2005 ","0","0","0",
"79 s","Research","2006 ","0","0","0",
"79 s","Research","2007 ","0","0","0",
"79 s","Research","2008 ","0","0","0",
"79 s","Research","2009 ","0","0","0",
"79 s","Research","2010 ","0","0","0",
"79 s","Art and Entertainment","2000 ","0","0","0",
"79 s","Art and Entertainment","2001 ","0","0","0",
"79 s","Art and Entertainment","2002 ","0","0","0",
"79 s","Art and Entertainment","2003 ","0","0","0",
"79 s","Art and Entertainment","2004 ","0","0","0",
"79 s","Art and Entertainment","2005 ","0","0","0",
"79 s","Art and Entertainment","2006 ","0","0","0",
"79 s","Art and Entertainment","2007 ","0","0","0",
"79 s","Art and Entertainment","2008 ","0","0","0",
"79 s","Art and Entertainment","2009 ","0","0","0",
"79 s","Art and Entertainment","2010 ","0","0","0",
"79 s","Unskilled Employment","2000 ","0","0","0",
"79 s","Unskilled Employment","2001 ","0","0","0",
"79 s","Unskilled Employment","2002 ","0","0","0",
"79 s","Unskilled Employment","2003 ","0","0","0",
"79 s","Unskilled Employment","2004 ","0","0","0",
"79 s","Unskilled Employment","2005 ","0","0","0",
"79 s","Unskilled Employment","2006 ","0","0","0",
"79 s","Unskilled Employment","2007 ","0","0","0",
"79 s","Unskilled Employment","2008 ","0","0","0",
"79 s","Unskilled Employment","2009 ","0","0","0",
"79 s","Unskilled Employment","2010 ","0","0","0",
"79 s","Visiting and Joining Family","2000 ","8","4","4",
"79 s","Visiting and Joining Family","2001 ","7","5","2",
"79 s","Visiting and Joining Family","2002 ","7","2","5",
"79 s","Visiting and Joining Family","2003 ","4","1","3",
"79 s","Visiting and Joining Family","2004 ","8","2","6",
"79 s","Visiting and Joining Family","2005 ","13","4","9",
"79 s","Visiting and Joining Family","2006 ","17","7","10",
"79 s","Visiting and Joining Family","2007 ","14","7","7",
"79 s","Visiting and Joining Family","2008 ","19","5","14",
"79 s","Visiting and Joining Family","2009 ","11","4","7",
"79 s","Visiting and Joining Family","2010 ","3","0","3",
"79 s","Visiting and Joining Family","2011 ","31","9","22",
"79 s","Visiting and Joining Family","2012 ","84","14","70",
"79 s","Visiting and Joining Family","2013 ","78","13","65",
"79 s","Visiting and Joining Family","2014 ","15","5","10",
"79 s","Visiting and Joining Family","2015 ","4","1","3",
"79 s","Visiting and Joining Family","2016 ","3","0","3",
"79 s","Visiting and Joining Family","2017 ","3","2","1",
"79 s","Visiting and Joining Family","2018 ","4","2","2",
"79 s","Visiting and Joining Family","2019 ","1","1","0",
"79 s","Overseas Koreans","2000 ","2","2","0",
"79 s","Overseas Koreans","2001 ","3","1","2",
"79 s","Overseas Koreans","2002 ","4","4","0",
"79 s","Overseas Koreans","2003 ","2","2","0",
"79 s","Overseas Koreans","2004 ","4","1","3",
"79 s","Overseas Koreans","2005 ","6","3","3",
"79 s","Overseas Koreans","2006 ","4","2","2",
"79 s","Overseas Koreans","2007 ","9","5","4",
"79 s","Overseas Koreans","2008 ","7","3","4",
"79 s","Overseas Koreans","2009 ","17","11","6",
"79 s","Overseas Koreans","2010 ","9","3","6",
"79 s","Overseas Koreans","2011 ","10","5","5",
"79 s","Overseas Koreans","2012 ","20","14","6",
"79 s","Overseas Koreans","2013 ","55","20","35",
"79 s","Overseas Koreans","2014 ","239","56","183",
"79 s","Overseas Koreans","2015 ","270","80","190",
"79 s","Overseas Koreans","2016 ","299","88","211",
"79 s","Overseas Koreans","2017 ","345","105","240",
"79 s","Overseas Koreans","2018 ","401","116","285",
"79 s","Overseas Koreans","2019 ","384","100","284",
"79 s","Permanent Residence","2000 ","0","0","0",
"79 s","Permanent Residence","2001 ","0","0","0",
"79 s","Permanent Residence","2002 ","0","0","0",
"79 s","Permanent Residence","2003 ","0","0","0",
"79 s","Permanent Residence","2004 ","1","0","1",
"79 s","Permanent Residence","2005 ","0","0","0",
"79 s","Permanent Residence","2006 ","3","2","1",
"79 s","Permanent Residence","2007 ","2","1","1",
"79 s","Permanent Residence","2008 ","4","3","1",
"79 s","Permanent Residence","2009 ","2","2","0",
"79 s","Permanent Residence","2010 ","3","2","1",
"79 s","Permanent Residence","2011 ","6","3","3",
"79 s","Permanent Residence","2012 ","11","6","5",
"79 s","Permanent Residence","2013 ","5","2","3",
"79 s","Permanent Residence","2014 ","9","2","7",
"79 s","Permanent Residence","2015 ","11","1","10",
"79 s","Permanent Residence","2016 ","5","4","1",
"79 s","Permanent Residence","2017 ","4","2","2",
"79 s","Permanent Residence","2018 ","6","3","3",
"79 s","Permanent Residence","2019 ","12","7","5",
"79 s","Marriage Immigration","2011 ","2","2","",
"79 s","Marriage Immigration","2012 ","1","1","",
"79 s","Marriage Immigration","2013 ","2","1","1",
"79 s","Marriage Immigration","2014 ","4","2","2",
"79 s","Marriage Immigration","2015 ","1","1","0",
"79 s","Marriage Immigration","2016 ","2","2","0",
"79 s","Marriage Immigration","2017 ","2","2","0",
"79 s","Marriage Immigration","2018 ","1","1","0",
"79 s","Marriage Immigration","2019 ","3","2","1",
"80 s","Total","2000 ","47","24","23",
"80 s","Total","2001 ","44","21","23",
"80 s","Total","2002 ","53","24","29",
"80 s","Total","2003 ","48","18","30",
"80 s","Total","2004 ","60","30","30",
"80 s","Total","2005 ","114","31","83",
"80 s","Total","2006 ","106","28","78",
"80 s","Total","2007 ","82","16","66",
"80 s","Total","2008 ","95","25","70",
"80 s","Total","2009 ","65","24","41",
"80 s","Total","2010 ","99","26","73",
"80 s","Total","2011 ","120","39","81",
"80 s","Total","2012 ","176","55","121",
"80 s","Total","2013 ","182","58","124",
"80 s","Total","2014 ","243","68","175",
"80 s","Total","2015 ","266","81","185",
"80 s","Total","2016 ","314","95","219",
"80 s","Total","2017 ","317","110","207",
"80 s","Total","2018 ","330","101","229",
"80 s","Total","2019 ","318","87","231",
"80 s","Sightseeing Pass","2000 ","13","2","11",
"80 s","Sightseeing Pass","2001 ","14","9","5",
"80 s","Sightseeing Pass","2002 ","20","9","11",
"80 s","Sightseeing Pass","2003 ","16","7","9",
"80 s","Sightseeing Pass","2004 ","14","8","6",
"80 s","Sightseeing Pass","2005 ","19","6","13",
"80 s","Sightseeing Pass","2006 ","20","8","12",
"80 s","Sightseeing Pass","2007 ","13","4","9",
"80 s","Sightseeing Pass","2008 ","16","7","9",
"80 s","Sightseeing Pass","2009 ","9","4","5",
"80 s","Sightseeing Pass","2010 ","21","9","12",
"80 s","Sightseeing Pass","2011 ","24","4","20",
"80 s","Sightseeing Pass","2012 ","36","20","16",
"80 s","Sightseeing Pass","2013 ","27","8","19",
"80 s","Sightseeing Pass","2014 ","24","8","16",
"80 s","Sightseeing Pass","2015 ","26","14","12",
"80 s","Sightseeing Pass","2016 ","22","11","11",
"80 s","Sightseeing Pass","2017 ","34","17","17",
"80 s","Sightseeing Pass","2018 ","18","6","12",
"80 s","Sightseeing Pass","2019 ","15","5","10",
"80 s","Short-term Business","2000 ","0","0","0",
"80 s","Short-term Business","2001 ","0","0","0",
"80 s","Short-term Business","2002 ","0","0","0",
"80 s","Short-term Business","2003 ","1","1","0",
"80 s","Short-term Business","2004 ","1","0","1",
"80 s","Short-term Business","2005 ","1","1","0",
"80 s","Short-term Business","2006 ","1","0","1",
"80 s","Short-term Business","2007 ","0","0","0",
"80 s","Short-term Business","2008 ","1","1","0",
"80 s","Short-term Business","2009 ","0","0","0",
"80 s","Short-term Business","2010 ","0","0","0",
"80 s","Short-term Visitors","2000 ","18","11","7",
"80 s","Short-term Visitors","2001 ","16","6","10",
"80 s","Short-term Visitors","2002 ","14","5","9",
"80 s","Short-term Visitors","2003 ","17","2","15",
"80 s","Short-term Visitors","2004 ","24","10","14",
"80 s","Short-term Visitors","2005 ","67","16","51",
"80 s","Short-term Visitors","2006 ","55","6","49",
"80 s","Short-term Visitors","2007 ","36","4","32",
"80 s","Short-term Visitors","2008 ","25","5","20",
"80 s","Short-term Visitors","2009 ","22","4","18",
"80 s","Short-term Visitors","2010 ","45","7","38",
"80 s","Short-term Visitors","2011 ","52","18","34",
"80 s","Short-term Visitors","2012 ","13","2","11",
"80 s","Short-term Visitors","2013 ","10","3","7",
"80 s","Short-term Visitors","2014 ","10","1","9",
"80 s","Short-term Visitors","2015 ","8","3","5",
"80 s","Short-term Visitors","2016 ","13","6","7",
"80 s","Short-term Visitors","2017 ","7","2","5",
"80 s","Short-term Visitors","2018 ","3","1","2",
"80 s","Short-term Visitors","2019 ","9","3","6",
"80 s","Short-term Employment","2000 ","0","0","0",
"80 s","Short-term Employment","2001 ","0","0","0",
"80 s","Short-term Employment","2002 ","1","1","0",
"80 s","Short-term Employment","2003 ","0","0","0",
"80 s","Short-term Employment","2004 ","0","0","0",
"80 s","Short-term Employment","2005 ","0","0","0",
"80 s","Short-term Employment","2006 ","0","0","0",
"80 s","Short-term Employment","2007 ","0","0","0",
"80 s","Short-term Employment","2008 ","0","0","0",
"80 s","Short-term Employment","2009 ","0","0","0",
"80 s","Short-term Employment","2010 ","0","0","0",
"80 s","Job Seeking","2000 ","0","0","0",
"80 s","Job Seeking","2001 ","0","0","0",
"80 s","Job Seeking","2002 ","0","0","0",
"80 s","Job Seeking","2003 ","0","0","0",
"80 s","Job Seeking","2004 ","0","0","0",
"80 s","Job Seeking","2005 ","0","0","0",
"80 s","Job Seeking","2006 ","0","0","0",
"80 s","Job Seeking","2007 ","0","0","0",
"80 s","Job Seeking","2008 ","0","0","0",
"80 s","Job Seeking","2009 ","0","0","0",
"80 s","Job Seeking","2010 ","0","0","0",
"80 s","study","2000 ","0","0","0",
"80 s","study","2001 ","0","0","0",
"80 s","study","2002 ","0","0","0",
"80 s","study","2003 ","0","0","0",
"80 s","study","2004 ","0","0","0",
"80 s","study","2005 ","0","0","0",
"80 s","study","2006 ","0","0","0",
"80 s","study","2007 ","0","0","0",
"80 s","study","2008 ","0","0","0",
"80 s","study","2009 ","0","0","0",
"80 s","study","2010 ","0","0","0",
"80 s","General Trainees","2000 ","0","0","0",
"80 s","General Trainees","2001 ","0","0","0",
"80 s","General Trainees","2002 ","0","0","0",
"80 s","General Trainees","2003 ","0","0","0",
"80 s","General Trainees","2004 ","0","0","0",
"80 s","General Trainees","2005 ","0","0","0",
"80 s","General Trainees","2006 ","0","0","0",
"80 s","General Trainees","2007 ","0","0","0",
"80 s","General Trainees","2008 ","0","0","0",
"80 s","General Trainees","2009 ","0","0","0",
"80 s","General Trainees","2010 ","0","0","0",
"80 s","Religious Activities","2000 ","0","0","0",
"80 s","Religious Activities","2001 ","1","0","1",
"80 s","Religious Activities","2002 ","1","0","1",
"80 s","Religious Activities","2003 ","0","0","0",
"80 s","Religious Activities","2004 ","1","1","0",
"80 s","Religious Activities","2005 ","0","0","0",
"80 s","Religious Activities","2006 ","0","0","0",
"80 s","Religious Activities","2007 ","0","0","0",
"80 s","Religious Activities","2008 ","1","1","0",
"80 s","Religious Activities","2009 ","1","0","1",
"80 s","Religious Activities","2010 ","0","0","0",
"80 s","Religious Activities","2011 ","1","","1",
"80 s","Religious Activities","2012 ","1","1","",
"80 s","Religious Activities","2013 ","1","1","0",
"80 s","Religious Activities","2014 ","2","1","1",
"80 s","Religious Activities","2015 ","1","1","0",
"80 s","Religious Activities","2018 ","3","3","0",
"80 s","Religious Activities","2019 ","1","0","1",
"80 s","Investors","2000 ","0","0","0",
"80 s","Investors","2001 ","0","0","0",
"80 s","Investors","2002 ","0","0","0",
"80 s","Investors","2003 ","1","1","0",
"80 s","Investors","2004 ","1","1","0",
"80 s","Investors","2005 ","0","0","0",
"80 s","Investors","2006 ","0","0","0",
"80 s","Investors","2007 ","0","0","0",
"80 s","Investors","2008 ","0","0","0",
"80 s","Investors","2009 ","0","0","0",
"80 s","Investors","2010 ","0","0","0",
"80 s","Trade and Business","2000 ","0","0","0",
"80 s","Trade and Business","2001 ","0","0","0",
"80 s","Trade and Business","2002 ","0","0","0",
"80 s","Trade and Business","2003 ","0","0","0",
"80 s","Trade and Business","2004 ","0","0","0",
"80 s","Trade and Business","2005 ","0","0","0",
"80 s","Trade and Business","2006 ","0","0","0",
"80 s","Trade and Business","2007 ","0","0","0",
"80 s","Trade and Business","2008 ","0","0","0",
"80 s","Trade and Business","2009 ","0","0","0",
"80 s","Trade and Business","2010 ","0","0","0",
"80 s","Research","2000 ","0","0","0",
"80 s","Research","2001 ","0","0","0",
"80 s","Research","2002 ","0","0","0",
"80 s","Research","2003 ","1","1","0",
"80 s","Research","2004 ","0","0","0",
"80 s","Research","2005 ","0","0","0",
"80 s","Research","2006 ","0","0","0",
"80 s","Research","2007 ","0","0","0",
"80 s","Research","2008 ","0","0","0",
"80 s","Research","2009 ","0","0","0",
"80 s","Research","2010 ","0","0","0",
"80 s","Art and Entertainment","2000 ","0","0","0",
"80 s","Art and Entertainment","2001 ","0","0","0",
"80 s","Art and Entertainment","2002 ","0","0","0",
"80 s","Art and Entertainment","2003 ","0","0","0",
"80 s","Art and Entertainment","2004 ","0","0","0",
"80 s","Art and Entertainment","2005 ","0","0","0",
"80 s","Art and Entertainment","2006 ","0","0","0",
"80 s","Art and Entertainment","2007 ","0","0","0",
"80 s","Art and Entertainment","2008 ","0","0","0",
"80 s","Art and Entertainment","2009 ","0","0","0",
"80 s","Art and Entertainment","2010 ","0","0","0",
"80 s","Unskilled Employment","2000 ","0","0","0",
"80 s","Unskilled Employment","2001 ","0","0","0",
"80 s","Unskilled Employment","2002 ","0","0","0",
"80 s","Unskilled Employment","2003 ","0","0","0",
"80 s","Unskilled Employment","2004 ","0","0","0",
"80 s","Unskilled Employment","2005 ","0","0","0",
"80 s","Unskilled Employment","2006 ","0","0","0",
"80 s","Unskilled Employment","2007 ","0","0","0",
"80 s","Unskilled Employment","2008 ","0","0","0",
"80 s","Unskilled Employment","2009 ","0","0","0",
"80 s","Unskilled Employment","2010 ","0","0","0",
"80 s","Visiting and Joining Family","2000 ","4","3","1",
"80 s","Visiting and Joining Family","2001 ","6","0","6",
"80 s","Visiting and Joining Family","2002 ","10","5","5",
"80 s","Visiting and Joining Family","2003 ","6","1","5",
"80 s","Visiting and Joining Family","2004 ","7","5","2",
"80 s","Visiting and Joining Family","2005 ","18","6","12",
"80 s","Visiting and Joining Family","2006 ","18","7","11",
"80 s","Visiting and Joining Family","2007 ","14","1","13",
"80 s","Visiting and Joining Family","2008 ","14","4","10",
"80 s","Visiting and Joining Family","2009 ","11","5","6",
"80 s","Visiting and Joining Family","2010 ","6","0","6",
"80 s","Visiting and Joining Family","2011 ","18","4","14",
"80 s","Visiting and Joining Family","2012 ","86","14","72",
"80 s","Visiting and Joining Family","2013 ","72","14","58",
"80 s","Visiting and Joining Family","2014 ","12","4","8",
"80 s","Visiting and Joining Family","2015 ","8","4","4",
"80 s","Visiting and Joining Family","2016 ","4","2","2",
"80 s","Visiting and Joining Family","2017 ","4","2","2",
"80 s","Visiting and Joining Family","2018 ","4","1","3",
"80 s","Visiting and Joining Family","2019 ","3","1","2",
"80 s","Overseas Koreans","2000 ","1","1","0",
"80 s","Overseas Koreans","2001 ","0","0","0",
"80 s","Overseas Koreans","2002 ","3","1","2",
"80 s","Overseas Koreans","2003 ","4","4","0",
"80 s","Overseas Koreans","2004 ","5","2","3",
"80 s","Overseas Koreans","2005 ","0","0","0",
"80 s","Overseas Koreans","2006 ","3","2","1",
"80 s","Overseas Koreans","2007 ","7","5","2",
"80 s","Overseas Koreans","2008 ","5","3","2",
"80 s","Overseas Koreans","2009 ","9","5","4",
"80 s","Overseas Koreans","2010 ","11","5","6",
"80 s","Overseas Koreans","2011 ","11","8","3",
"80 s","Overseas Koreans","2012 ","22","11","11",
"80 s","Overseas Koreans","2013 ","53","24","29",
"80 s","Overseas Koreans","2014 ","185","50","135",
"80 s","Overseas Koreans","2015 ","210","53","157",
"80 s","Overseas Koreans","2016 ","258","69","189",
"80 s","Overseas Koreans","2017 ","260","83","177",
"80 s","Overseas Koreans","2018 ","287","82","205",
"80 s","Overseas Koreans","2019 ","277","73","204",
"80 s","Permanent Residence","2000 ","0","0","0",
"80 s","Permanent Residence","2001 ","0","0","0",
"80 s","Permanent Residence","2002 ","0","0","0",
"80 s","Permanent Residence","2003 ","0","0","0",
"80 s","Permanent Residence","2004 ","4","1","3",
"80 s","Permanent Residence","2005 ","2","0","2",
"80 s","Permanent Residence","2006 ","1","1","0",
"80 s","Permanent Residence","2007 ","1","1","0",
"80 s","Permanent Residence","2008 ","2","0","2",
"80 s","Permanent Residence","2009 ","0","0","0",
"80 s","Permanent Residence","2010 ","1","1","0",
"80 s","Permanent Residence","2011 ","2","1","1",
"80 s","Permanent Residence","2012 ","6","1","5",
"80 s","Permanent Residence","2013 ","7","4","3",
"80 s","Permanent Residence","2014 ","5","2","3",
"80 s","Permanent Residence","2015 ","8","4","4",
"80 s","Permanent Residence","2016 ","10","3","7",
"80 s","Permanent Residence","2017 ","2","2","0",
"80 s","Permanent Residence","2018 ","10","4","6",
"80 s","Permanent Residence","2019 ","8","5","3",
"80 s","Marriage Immigration","2012 ","1","1","",
"80 s","Marriage Immigration","2015 ","1","1","0",
"80 s","Marriage Immigration","2017 ","2","2","0",
"80 s","Marriage Immigration","2018 ","3","3","0",
"81 s","Total","2000 ","28","15","13",
"81 s","Total","2001 ","38","16","22",
"81 s","Total","2002 ","43","20","23",
"81 s","Total","2003 ","39","12","27",
"81 s","Total","2004 ","61","26","35",
"81 s","Total","2005 ","92","27","65",
"81 s","Total","2006 ","86","22","64",
"81 s","Total","2007 ","67","21","46",
"81 s","Total","2008 ","83","21","62",
"81 s","Total","2009 ","64","20","44",
"81 s","Total","2010 ","70","24","46",
"81 s","Total","2011 ","125","35","90",
"81 s","Total","2012 ","145","56","89",
"81 s","Total","2013 ","144","43","101",
"81 s","Total","2014 ","178","47","131",
"81 s","Total","2015 ","221","63","158",
"81 s","Total","2016 ","284","87","197",
"81 s","Total","2017 ","256","91","165",
"81 s","Total","2018 ","249","73","176",
"81 s","Total","2019 ","294","102","192",
"81 s","Sightseeing Pass","2000 ","9","3","6",
"81 s","Sightseeing Pass","2001 ","16","10","6",
"81 s","Sightseeing Pass","2002 ","18","11","7",
"81 s","Sightseeing Pass","2003 ","11","4","7",
"81 s","Sightseeing Pass","2004 ","18","7","11",
"81 s","Sightseeing Pass","2005 ","18","8","10",
"81 s","Sightseeing Pass","2006 ","13","2","11",
"81 s","Sightseeing Pass","2007 ","11","1","10",
"81 s","Sightseeing Pass","2008 ","17","4","13",
"81 s","Sightseeing Pass","2009 ","21","9","12",
"81 s","Sightseeing Pass","2010 ","23","7","16",
"81 s","Sightseeing Pass","2011 ","35","13","22",
"81 s","Sightseeing Pass","2012 ","44","19","25",
"81 s","Sightseeing Pass","2013 ","24","8","16",
"81 s","Sightseeing Pass","2014 ","15","4","11",
"81 s","Sightseeing Pass","2015 ","26","13","13",
"81 s","Sightseeing Pass","2016 ","35","17","18",
"81 s","Sightseeing Pass","2017 ","14","10","4",
"81 s","Sightseeing Pass","2018 ","23","8","15",
"81 s","Sightseeing Pass","2019 ","23","13","10",
"81 s","Short-term Business","2000 ","0","0","0",
"81 s","Short-term Business","2001 ","0","0","0",
"81 s","Short-term Business","2002 ","2","2","0",
"81 s","Short-term Business","2003 ","1","0","1",
"81 s","Short-term Business","2004 ","1","1","0",
"81 s","Short-term Business","2005 ","0","0","0",
"81 s","Short-term Business","2006 ","0","0","0",
"81 s","Short-term Business","2007 ","0","0","0",
"81 s","Short-term Business","2008 ","0","0","0",
"81 s","Short-term Business","2009 ","0","0","0",
"81 s","Short-term Business","2010 ","1","1","0",
"81 s","Short-term Visitors","2000 ","11","6","5",
"81 s","Short-term Visitors","2001 ","14","3","11",
"81 s","Short-term Visitors","2002 ","12","3","9",
"81 s","Short-term Visitors","2003 ","14","4","10",
"81 s","Short-term Visitors","2004 ","25","10","15",
"81 s","Short-term Visitors","2005 ","49","8","41",
"81 s","Short-term Visitors","2006 ","47","7","40",
"81 s","Short-term Visitors","2007 ","25","8","17",
"81 s","Short-term Visitors","2008 ","20","3","17",
"81 s","Short-term Visitors","2009 ","20","3","17",
"81 s","Short-term Visitors","2010 ","23","8","15",
"81 s","Short-term Visitors","2011 ","45","11","34",
"81 s","Short-term Visitors","2012 ","5","2","3",
"81 s","Short-term Visitors","2013 ","15","5","10",
"81 s","Short-term Visitors","2014 ","4","3","1",
"81 s","Short-term Visitors","2015 ","5","0","5",
"81 s","Short-term Visitors","2016 ","6","2","4",
"81 s","Short-term Visitors","2017 ","5","4","1",
"81 s","Short-term Visitors","2018 ","5","3","2",
"81 s","Short-term Visitors","2019 ","4","3","1",
"81 s","Short-term Employment","2000 ","0","0","0",
"81 s","Short-term Employment","2001 ","0","0","0",
"81 s","Short-term Employment","2002 ","0","0","0",
"81 s","Short-term Employment","2003 ","0","0","0",
"81 s","Short-term Employment","2004 ","0","0","0",
"81 s","Short-term Employment","2005 ","0","0","0",
"81 s","Short-term Employment","2006 ","0","0","0",
"81 s","Short-term Employment","2007 ","0","0","0",
"81 s","Short-term Employment","2008 ","0","0","0",
"81 s","Short-term Employment","2009 ","0","0","0",
"81 s","Short-term Employment","2010 ","0","0","0",
"81 s","Job Seeking","2000 ","0","0","0",
"81 s","Job Seeking","2001 ","0","0","0",
"81 s","Job Seeking","2002 ","0","0","0",
"81 s","Job Seeking","2003 ","0","0","0",
"81 s","Job Seeking","2004 ","0","0","0",
"81 s","Job Seeking","2005 ","0","0","0",
"81 s","Job Seeking","2006 ","0","0","0",
"81 s","Job Seeking","2007 ","0","0","0",
"81 s","Job Seeking","2008 ","0","0","0",
"81 s","Job Seeking","2009 ","0","0","0",
"81 s","Job Seeking","2010 ","0","0","0",
"81 s","study","2000 ","0","0","0",
"81 s","study","2001 ","0","0","0",
"81 s","study","2002 ","0","0","0",
"81 s","study","2003 ","0","0","0",
"81 s","study","2004 ","0","0","0",
"81 s","study","2005 ","0","0","0",
"81 s","study","2006 ","0","0","0",
"81 s","study","2007 ","0","0","0",
"81 s","study","2008 ","0","0","0",
"81 s","study","2009 ","0","0","0",
"81 s","study","2010 ","0","0","0",
"81 s","General Trainees","2000 ","0","0","0",
"81 s","General Trainees","2001 ","0","0","0",
"81 s","General Trainees","2002 ","0","0","0",
"81 s","General Trainees","2003 ","0","0","0",
"81 s","General Trainees","2004 ","0","0","0",
"81 s","General Trainees","2005 ","0","0","0",
"81 s","General Trainees","2006 ","0","0","0",
"81 s","General Trainees","2007 ","0","0","0",
"81 s","General Trainees","2008 ","0","0","0",
"81 s","General Trainees","2009 ","0","0","0",
"81 s","General Trainees","2010 ","0","0","0",
"81 s","Religious Activities","2000 ","0","0","0",
"81 s","Religious Activities","2001 ","0","0","0",
"81 s","Religious Activities","2002 ","0","0","0",
"81 s","Religious Activities","2003 ","0","0","0",
"81 s","Religious Activities","2004 ","2","1","1",
"81 s","Religious Activities","2005 ","0","0","0",
"81 s","Religious Activities","2006 ","0","0","0",
"81 s","Religious Activities","2007 ","1","1","0",
"81 s","Religious Activities","2008 ","0","0","0",
"81 s","Religious Activities","2009 ","0","0","0",
"81 s","Religious Activities","2010 ","0","0","0",
"81 s","Religious Activities","2011 ","1","1","",
"81 s","Religious Activities","2015 ","3","3","0",
"81 s","Investors","2000 ","0","0","0",
"81 s","Investors","2001 ","0","0","0",
"81 s","Investors","2002 ","0","0","0",
"81 s","Investors","2003 ","0","0","0",
"81 s","Investors","2004 ","0","0","0",
"81 s","Investors","2005 ","1","1","0",
"81 s","Investors","2006 ","0","0","0",
"81 s","Investors","2007 ","0","0","0",
"81 s","Investors","2008 ","0","0","0",
"81 s","Investors","2009 ","0","0","0",
"81 s","Investors","2010 ","0","0","0",
"81 s","Trade and Business","2000 ","0","0","0",
"81 s","Trade and Business","2001 ","0","0","0",
"81 s","Trade and Business","2002 ","0","0","0",
"81 s","Trade and Business","2003 ","0","0","0",
"81 s","Trade and Business","2004 ","0","0","0",
"81 s","Trade and Business","2005 ","0","0","0",
"81 s","Trade and Business","2006 ","0","0","0",
"81 s","Trade and Business","2007 ","0","0","0",
"81 s","Trade and Business","2008 ","0","0","0",
"81 s","Trade and Business","2009 ","0","0","0",
"81 s","Trade and Business","2010 ","0","0","0",
"81 s","Research","2000 ","0","0","0",
"81 s","Research","2001 ","0","0","0",
"81 s","Research","2002 ","0","0","0",
"81 s","Research","2003 ","0","0","0",
"81 s","Research","2004 ","0","0","0",
"81 s","Research","2005 ","0","0","0",
"81 s","Research","2006 ","0","0","0",
"81 s","Research","2007 ","0","0","0",
"81 s","Research","2008 ","0","0","0",
"81 s","Research","2009 ","0","0","0",
"81 s","Research","2010 ","0","0","0",
"81 s","Art and Entertainment","2000 ","0","0","0",
"81 s","Art and Entertainment","2001 ","0","0","0",
"81 s","Art and Entertainment","2002 ","0","0","0",
"81 s","Art and Entertainment","2003 ","0","0","0",
"81 s","Art and Entertainment","2004 ","0","0","0",
"81 s","Art and Entertainment","2005 ","0","0","0",
"81 s","Art and Entertainment","2006 ","0","0","0",
"81 s","Art and Entertainment","2007 ","0","0","0",
"81 s","Art and Entertainment","2008 ","0","0","0",
"81 s","Art and Entertainment","2009 ","0","0","0",
"81 s","Art and Entertainment","2010 ","0","0","0",
"81 s","Unskilled Employment","2000 ","0","0","0",
"81 s","Unskilled Employment","2001 ","0","0","0",
"81 s","Unskilled Employment","2002 ","0","0","0",
"81 s","Unskilled Employment","2003 ","0","0","0",
"81 s","Unskilled Employment","2004 ","0","0","0",
"81 s","Unskilled Employment","2005 ","0","0","0",
"81 s","Unskilled Employment","2006 ","0","0","0",
"81 s","Unskilled Employment","2007 ","0","0","0",
"81 s","Unskilled Employment","2008 ","0","0","0",
"81 s","Unskilled Employment","2009 ","0","0","0",
"81 s","Unskilled Employment","2010 ","0","0","0",
"81 s","Visiting and Joining Family","2000 ","4","3","1",
"81 s","Visiting and Joining Family","2001 ","3","1","2",
"81 s","Visiting and Joining Family","2002 ","5","1","4",
"81 s","Visiting and Joining Family","2003 ","6","1","5",
"81 s","Visiting and Joining Family","2004 ","10","4","6",
"81 s","Visiting and Joining Family","2005 ","14","7","7",
"81 s","Visiting and Joining Family","2006 ","12","5","7",
"81 s","Visiting and Joining Family","2007 ","12","6","6",
"81 s","Visiting and Joining Family","2008 ","18","9","9",
"81 s","Visiting and Joining Family","2009 ","5","3","2",
"81 s","Visiting and Joining Family","2010 ","4","0","4",
"81 s","Visiting and Joining Family","2011 ","20","2","18",
"81 s","Visiting and Joining Family","2012 ","64","14","50",
"81 s","Visiting and Joining Family","2013 ","50","4","46",
"81 s","Visiting and Joining Family","2014 ","7","0","7",
"81 s","Visiting and Joining Family","2015 ","3","1","2",
"81 s","Visiting and Joining Family","2016 ","5","4","1",
"81 s","Visiting and Joining Family","2017 ","2","2","0",
"81 s","Visiting and Joining Family","2018 ","2","1","1",
"81 s","Visiting and Joining Family","2019 ","2","1","1",
"81 s","Overseas Koreans","2000 ","2","1","1",
"81 s","Overseas Koreans","2001 ","1","0","1",
"81 s","Overseas Koreans","2002 ","1","1","0",
"81 s","Overseas Koreans","2003 ","4","1","3",
"81 s","Overseas Koreans","2004 ","4","2","2",
"81 s","Overseas Koreans","2005 ","3","0","3",
"81 s","Overseas Koreans","2006 ","2","2","0",
"81 s","Overseas Koreans","2007 ","6","4","2",
"81 s","Overseas Koreans","2008 ","5","2","3",
"81 s","Overseas Koreans","2009 ","8","2","6",
"81 s","Overseas Koreans","2010 ","10","4","6",
"81 s","Overseas Koreans","2011 ","10","3","7",
"81 s","Overseas Koreans","2012 ","19","11","8",
"81 s","Overseas Koreans","2013 ","37","16","21",
"81 s","Overseas Koreans","2014 ","140","38","102",
"81 s","Overseas Koreans","2015 ","175","44","131",
"81 s","Overseas Koreans","2016 ","225","61","164",
"81 s","Overseas Koreans","2017 ","224","71","153",
"81 s","Overseas Koreans","2018 ","214","59","155",
"81 s","Overseas Koreans","2019 ","248","79","169",
"81 s","Permanent Residence","2000 ","0","0","0",
"81 s","Permanent Residence","2001 ","0","0","0",
"81 s","Permanent Residence","2002 ","0","0","0",
"81 s","Permanent Residence","2003 ","0","0","0",
"81 s","Permanent Residence","2004 ","0","0","0",
"81 s","Permanent Residence","2005 ","2","1","1",
"81 s","Permanent Residence","2006 ","3","1","2",
"81 s","Permanent Residence","2007 ","1","0","1",
"81 s","Permanent Residence","2008 ","3","0","3",
"81 s","Permanent Residence","2009 ","2","1","1",
"81 s","Permanent Residence","2010 ","3","0","3",
"81 s","Permanent Residence","2011 ","5","3","2",
"81 s","Permanent Residence","2012 ","3","2","1",
"81 s","Permanent Residence","2013 ","8","5","3",
"81 s","Permanent Residence","2014 ","9","1","8",
"81 s","Permanent Residence","2015 ","5","2","3",
"81 s","Permanent Residence","2016 ","9","2","7",
"81 s","Permanent Residence","2017 ","7","3","4",
"81 s","Permanent Residence","2018 ","2","0","2",
"81 s","Permanent Residence","2019 ","8","3","5",
"81 s","Marriage Immigration","2012 ","1","1","",
"81 s","Marriage Immigration","2018 ","2","2","0",
"81 s","Marriage Immigration","2019 ","2","1","1",
"82 s","Total","2000 ","28","14","14",
"82 s","Total","2001 ","28","14","14",
"82 s","Total","2002 ","33","13","20",
"82 s","Total","2003 ","33","12","21",
"82 s","Total","2004 ","46","14","32",
"82 s","Total","2005 ","72","23","49",
"82 s","Total","2006 ","55","16","39",
"82 s","Total","2007 ","51","15","36",
"82 s","Total","2008 ","68","12","56",
"82 s","Total","2009 ","51","13","38",
"82 s","Total","2010 ","73","26","47",
"82 s","Total","2011 ","82","23","59",
"82 s","Total","2012 ","128","38","90",
"82 s","Total","2013 ","99","33","66",
"82 s","Total","2014 ","155","41","114",
"82 s","Total","2015 ","200","56","144",
"82 s","Total","2016 ","206","54","152",
"82 s","Total","2017 ","223","69","154",
"82 s","Total","2018 ","251","82","169",
"82 s","Total","2019 ","223","69","154",
"82 s","Sightseeing Pass","2000 ","5","4","1",
"82 s","Sightseeing Pass","2001 ","9","6","3",
"82 s","Sightseeing Pass","2002 ","13","6","7",
"82 s","Sightseeing Pass","2003 ","9","3","6",
"82 s","Sightseeing Pass","2004 ","12","7","5",
"82 s","Sightseeing Pass","2005 ","14","3","11",
"82 s","Sightseeing Pass","2006 ","4","0","4",
"82 s","Sightseeing Pass","2007 ","7","2","5",
"82 s","Sightseeing Pass","2008 ","11","2","9",
"82 s","Sightseeing Pass","2009 ","12","3","9",
"82 s","Sightseeing Pass","2010 ","21","11","10",
"82 s","Sightseeing Pass","2011 ","20","10","10",
"82 s","Sightseeing Pass","2012 ","41","17","24",
"82 s","Sightseeing Pass","2013 ","14","8","6",
"82 s","Sightseeing Pass","2014 ","22","6","16",
"82 s","Sightseeing Pass","2015 ","26","11","15",
"82 s","Sightseeing Pass","2016 ","30","13","17",
"82 s","Sightseeing Pass","2017 ","10","5","5",
"82 s","Sightseeing Pass","2018 ","21","11","10",
"82 s","Sightseeing Pass","2019 ","21","10","11",
"82 s","Short-term Business","2000 ","0","0","0",
"82 s","Short-term Business","2001 ","1","1","0",
"82 s","Short-term Business","2002 ","0","0","0",
"82 s","Short-term Business","2003 ","2","2","0",
"82 s","Short-term Business","2004 ","0","0","0",
"82 s","Short-term Business","2005 ","0","0","0",
"82 s","Short-term Business","2006 ","0","0","0",
"82 s","Short-term Business","2007 ","0","0","0",
"82 s","Short-term Business","2008 ","0","0","0",
"82 s","Short-term Business","2009 ","0","0","0",
"82 s","Short-term Business","2010 ","0","0","0",
"82 s","Short-term Visitors","2000 ","13","4","9",
"82 s","Short-term Visitors","2001 ","7","1","6",
"82 s","Short-term Visitors","2002 ","10","2","8",
"82 s","Short-term Visitors","2003 ","15","3","12",
"82 s","Short-term Visitors","2004 ","21","4","17",
"82 s","Short-term Visitors","2005 ","35","12","23",
"82 s","Short-term Visitors","2006 ","35","5","30",
"82 s","Short-term Visitors","2007 ","23","5","18",
"82 s","Short-term Visitors","2008 ","21","2","19",
"82 s","Short-term Visitors","2009 ","19","4","15",
"82 s","Short-term Visitors","2010 ","23","6","17",
"82 s","Short-term Visitors","2011 ","34","5","29",
"82 s","Short-term Visitors","2012 ","4","1","3",
"82 s","Short-term Visitors","2013 ","4","1","3",
"82 s","Short-term Visitors","2014 ","2","1","1",
"82 s","Short-term Visitors","2015 ","9","2","7",
"82 s","Short-term Visitors","2016 ","4","3","1",
"82 s","Short-term Visitors","2017 ","2","1","1",
"82 s","Short-term Visitors","2018 ","6","2","4",
"82 s","Short-term Visitors","2019 ","6","3","3",
"82 s","Short-term Employment","2000 ","0","0","0",
"82 s","Short-term Employment","2001 ","0","0","0",
"82 s","Short-term Employment","2002 ","0","0","0",
"82 s","Short-term Employment","2003 ","0","0","0",
"82 s","Short-term Employment","2004 ","0","0","0",
"82 s","Short-term Employment","2005 ","0","0","0",
"82 s","Short-term Employment","2006 ","0","0","0",
"82 s","Short-term Employment","2007 ","0","0","0",
"82 s","Short-term Employment","2008 ","0","0","0",
"82 s","Short-term Employment","2009 ","0","0","0",
"82 s","Short-term Employment","2010 ","0","0","0",
"82 s","Job Seeking","2000 ","0","0","0",
"82 s","Job Seeking","2001 ","0","0","0",
"82 s","Job Seeking","2002 ","0","0","0",
"82 s","Job Seeking","2003 ","0","0","0",
"82 s","Job Seeking","2004 ","0","0","0",
"82 s","Job Seeking","2005 ","0","0","0",
"82 s","Job Seeking","2006 ","0","0","0",
"82 s","Job Seeking","2007 ","0","0","0",
"82 s","Job Seeking","2008 ","0","0","0",
"82 s","Job Seeking","2009 ","0","0","0",
"82 s","Job Seeking","2010 ","0","0","0",
"82 s","study","2000 ","0","0","0",
"82 s","study","2001 ","0","0","0",
"82 s","study","2002 ","0","0","0",
"82 s","study","2003 ","0","0","0",
"82 s","study","2004 ","0","0","0",
"82 s","study","2005 ","0","0","0",
"82 s","study","2006 ","0","0","0",
"82 s","study","2007 ","0","0","0",
"82 s","study","2008 ","0","0","0",
"82 s","study","2009 ","0","0","0",
"82 s","study","2010 ","0","0","0",
"82 s","General Trainees","2000 ","0","0","0",
"82 s","General Trainees","2001 ","0","0","0",
"82 s","General Trainees","2002 ","0","0","0",
"82 s","General Trainees","2003 ","0","0","0",
"82 s","General Trainees","2004 ","0","0","0",
"82 s","General Trainees","2005 ","0","0","0",
"82 s","General Trainees","2006 ","0","0","0",
"82 s","General Trainees","2007 ","0","0","0",
"82 s","General Trainees","2008 ","0","0","0",
"82 s","General Trainees","2009 ","0","0","0",
"82 s","General Trainees","2010 ","0","0","0",
"82 s","Religious Activities","2000 ","0","0","0",
"82 s","Religious Activities","2001 ","0","0","0",
"82 s","Religious Activities","2002 ","0","0","0",
"82 s","Religious Activities","2003 ","0","0","0",
"82 s","Religious Activities","2004 ","0","0","0",
"82 s","Religious Activities","2005 ","0","0","0",
"82 s","Religious Activities","2006 ","0","0","0",
"82 s","Religious Activities","2007 ","0","0","0",
"82 s","Religious Activities","2008 ","0","0","0",
"82 s","Religious Activities","2009 ","0","0","0",
"82 s","Religious Activities","2010 ","1","1","0",
"82 s","Religious Activities","2013 ","2","2","0",
"82 s","Religious Activities","2016 ","1","1","0",
"82 s","Investors","2000 ","0","0","0",
"82 s","Investors","2001 ","0","0","0",
"82 s","Investors","2002 ","0","0","0",
"82 s","Investors","2003 ","0","0","0",
"82 s","Investors","2004 ","0","0","0",
"82 s","Investors","2005 ","0","0","0",
"82 s","Investors","2006 ","1","1","0",
"82 s","Investors","2007 ","0","0","0",
"82 s","Investors","2008 ","0","0","0",
"82 s","Investors","2009 ","0","0","0",
"82 s","Investors","2010 ","0","0","0",
"82 s","Trade and Business","2000 ","0","0","0",
"82 s","Trade and Business","2001 ","0","0","0",
"82 s","Trade and Business","2002 ","0","0","0",
"82 s","Trade and Business","2003 ","0","0","0",
"82 s","Trade and Business","2004 ","0","0","0",
"82 s","Trade and Business","2005 ","0","0","0",
"82 s","Trade and Business","2006 ","0","0","0",
"82 s","Trade and Business","2007 ","0","0","0",
"82 s","Trade and Business","2008 ","0","0","0",
"82 s","Trade and Business","2009 ","0","0","0",
"82 s","Trade and Business","2010 ","0","0","0",
"82 s","Research","2000 ","0","0","0",
"82 s","Research","2001 ","0","0","0",
"82 s","Research","2002 ","0","0","0",
"82 s","Research","2003 ","0","0","0",
"82 s","Research","2004 ","0","0","0",
"82 s","Research","2005 ","0","0","0",
"82 s","Research","2006 ","0","0","0",
"82 s","Research","2007 ","0","0","0",
"82 s","Research","2008 ","0","0","0",
"82 s","Research","2009 ","0","0","0",
"82 s","Research","2010 ","0","0","0",
"82 s","Art and Entertainment","2000 ","0","0","0",
"82 s","Art and Entertainment","2001 ","0","0","0",
"82 s","Art and Entertainment","2002 ","0","0","0",
"82 s","Art and Entertainment","2003 ","0","0","0",
"82 s","Art and Entertainment","2004 ","0","0","0",
"82 s","Art and Entertainment","2005 ","0","0","0",
"82 s","Art and Entertainment","2006 ","0","0","0",
"82 s","Art and Entertainment","2007 ","0","0","0",
"82 s","Art and Entertainment","2008 ","0","0","0",
"82 s","Art and Entertainment","2009 ","0","0","0",
"82 s","Art and Entertainment","2010 ","0","0","0",
"82 s","Unskilled Employment","2000 ","0","0","0",
"82 s","Unskilled Employment","2001 ","0","0","0",
"82 s","Unskilled Employment","2002 ","0","0","0",
"82 s","Unskilled Employment","2003 ","0","0","0",
"82 s","Unskilled Employment","2004 ","0","0","0",
"82 s","Unskilled Employment","2005 ","0","0","0",
"82 s","Unskilled Employment","2006 ","0","0","0",
"82 s","Unskilled Employment","2007 ","0","0","0",
"82 s","Unskilled Employment","2008 ","0","0","0",
"82 s","Unskilled Employment","2009 ","0","0","0",
"82 s","Unskilled Employment","2010 ","0","0","0",
"82 s","Visiting and Joining Family","2000 ","3","2","1",
"82 s","Visiting and Joining Family","2001 ","5","2","3",
"82 s","Visiting and Joining Family","2002 ","6","5","1",
"82 s","Visiting and Joining Family","2003 ","1","0","1",
"82 s","Visiting and Joining Family","2004 ","6","1","5",
"82 s","Visiting and Joining Family","2005 ","12","4","8",
"82 s","Visiting and Joining Family","2006 ","9","6","3",
"82 s","Visiting and Joining Family","2007 ","9","4","5",
"82 s","Visiting and Joining Family","2008 ","12","4","8",
"82 s","Visiting and Joining Family","2009 ","6","3","3",
"82 s","Visiting and Joining Family","2010 ","8","4","4",
"82 s","Visiting and Joining Family","2011 ","13","2","11",
"82 s","Visiting and Joining Family","2012 ","59","11","48",
"82 s","Visiting and Joining Family","2013 ","42","6","36",
"82 s","Visiting and Joining Family","2014 ","7","0","7",
"82 s","Visiting and Joining Family","2015 ","4","2","2",
"82 s","Visiting and Joining Family","2016 ","4","3","1",
"82 s","Visiting and Joining Family","2017 ","2","1","1",
"82 s","Visiting and Joining Family","2018 ","4","3","1",
"82 s","Overseas Koreans","2000 ","2","1","1",
"82 s","Overseas Koreans","2001 ","2","0","2",
"82 s","Overseas Koreans","2002 ","2","0","2",
"82 s","Overseas Koreans","2003 ","1","0","1",
"82 s","Overseas Koreans","2004 ","1","0","1",
"82 s","Overseas Koreans","2005 ","4","2","2",
"82 s","Overseas Koreans","2006 ","2","1","1",
"82 s","Overseas Koreans","2007 ","2","1","1",
"82 s","Overseas Koreans","2008 ","4","2","2",
"82 s","Overseas Koreans","2009 ","5","3","2",
"82 s","Overseas Koreans","2010 ","11","3","8",
"82 s","Overseas Koreans","2011 ","5","2","3",
"82 s","Overseas Koreans","2012 ","14","6","8",
"82 s","Overseas Koreans","2013 ","27","13","14",
"82 s","Overseas Koreans","2014 ","117","30","87",
"82 s","Overseas Koreans","2015 ","152","39","113",
"82 s","Overseas Koreans","2016 ","158","32","126",
"82 s","Overseas Koreans","2017 ","200","59","141",
"82 s","Overseas Koreans","2018 ","213","62","151",
"82 s","Overseas Koreans","2019 ","184","50","134",
"82 s","Permanent Residence","2000 ","0","0","0",
"82 s","Permanent Residence","2001 ","0","0","0",
"82 s","Permanent Residence","2002 ","0","0","0",
"82 s","Permanent Residence","2003 ","1","1","0",
"82 s","Permanent Residence","2004 ","3","1","2",
"82 s","Permanent Residence","2005 ","1","0","1",
"82 s","Permanent Residence","2006 ","2","1","1",
"82 s","Permanent Residence","2007 ","4","2","2",
"82 s","Permanent Residence","2008 ","0","0","0",
"82 s","Permanent Residence","2009 ","1","0","1",
"82 s","Permanent Residence","2010 ","1","0","1",
"82 s","Permanent Residence","2011 ","3","2","1",
"82 s","Permanent Residence","2012 ","2","1","1",
"82 s","Permanent Residence","2013 ","3","1","2",
"82 s","Permanent Residence","2014 ","6","3","3",
"82 s","Permanent Residence","2015 ","5","1","4",
"82 s","Permanent Residence","2016 ","4","1","3",
"82 s","Permanent Residence","2017 ","5","2","3",
"82 s","Permanent Residence","2018 ","5","2","3",
"82 s","Permanent Residence","2019 ","4","1","3",
"82 s","Marriage Immigration","2013 ","1","1","0",
"82 s","Marriage Immigration","2016 ","1","0","1",
"82 s","Marriage Immigration","2017 ","1","1","0",
"82 s","Marriage Immigration","2018 ","1","1","0",
"82 s","Marriage Immigration","2019 ","3","3","0",
"83 s","Total","2000 ","24","11","13",
"83 s","Total","2001 ","24","11","13",
"83 s","Total","2002 ","31","14","17",
"83 s","Total","2003 ","23","8","15",
"83 s","Total","2004 ","34","13","21",
"83 s","Total","2005 ","66","24","42",
"83 s","Total","2006 ","66","14","52",
"83 s","Total","2007 ","41","8","33",
"83 s","Total","2008 ","51","10","41",
"83 s","Total","2009 ","33","11","22",
"83 s","Total","2010 ","69","27","42",
"83 s","Total","2011 ","86","34","52",
"83 s","Total","2012 ","95","28","67",
"83 s","Total","2013 ","114","23","91",
"83 s","Total","2014 ","139","33","106",
"83 s","Total","2015 ","132","38","94",
"83 s","Total","2016 ","150","39","111",
"83 s","Total","2017 ","171","32","139",
"83 s","Total","2018 ","173","58","115",
"83 s","Total","2019 ","178","62","116",
"83 s","Sightseeing Pass","2000 ","4","1","3",
"83 s","Sightseeing Pass","2001 ","7","4","3",
"83 s","Sightseeing Pass","2002 ","15","9","6",
"83 s","Sightseeing Pass","2003 ","9","3","6",
"83 s","Sightseeing Pass","2004 ","5","1","4",
"83 s","Sightseeing Pass","2005 ","15","4","11",
"83 s","Sightseeing Pass","2006 ","20","6","14",
"83 s","Sightseeing Pass","2007 ","11","4","7",
"83 s","Sightseeing Pass","2008 ","11","2","9",
"83 s","Sightseeing Pass","2009 ","14","4","10",
"83 s","Sightseeing Pass","2010 ","26","11","15",
"83 s","Sightseeing Pass","2011 ","25","13","12",
"83 s","Sightseeing Pass","2012 ","25","10","15",
"83 s","Sightseeing Pass","2013 ","20","7","13",
"83 s","Sightseeing Pass","2014 ","17","6","11",
"83 s","Sightseeing Pass","2015 ","25","6","19",
"83 s","Sightseeing Pass","2016 ","21","9","12",
"83 s","Sightseeing Pass","2017 ","12","4","8",
"83 s","Sightseeing Pass","2018 ","14","6","8",
"83 s","Sightseeing Pass","2019 ","16","10","6",
"83 s","Short-term Business","2000 ","0","0","0",
"83 s","Short-term Business","2001 ","0","0","0",
"83 s","Short-term Business","2002 ","0","0","0",
"83 s","Short-term Business","2003 ","1","1","0",
"83 s","Short-term Business","2004 ","1","0","1",
"83 s","Short-term Business","2005 ","2","1","1",
"83 s","Short-term Business","2006 ","0","0","0",
"83 s","Short-term Business","2007 ","0","0","0",
"83 s","Short-term Business","2008 ","0","0","0",
"83 s","Short-term Business","2009 ","0","0","0",
"83 s","Short-term Business","2010 ","0","0","0",
"83 s","Short-term Visitors","2000 ","12","4","8",
"83 s","Short-term Visitors","2001 ","5","0","5",
"83 s","Short-term Visitors","2002 ","8","2","6",
"83 s","Short-term Visitors","2003 ","9","2","7",
"83 s","Short-term Visitors","2004 ","14","4","10",
"83 s","Short-term Visitors","2005 ","37","12","25",
"83 s","Short-term Visitors","2006 ","29","4","25",
"83 s","Short-term Visitors","2007 ","15","3","12",
"83 s","Short-term Visitors","2008 ","12","2","10",
"83 s","Short-term Visitors","2009 ","8","2","6",
"83 s","Short-term Visitors","2010 ","24","5","19",
"83 s","Short-term Visitors","2011 ","31","10","21",
"83 s","Short-term Visitors","2012 ","1","","1",
"83 s","Short-term Visitors","2013 ","10","2","8",
"83 s","Short-term Visitors","2014 ","5","3","2",
"83 s","Short-term Visitors","2015 ","5","4","1",
"83 s","Short-term Visitors","2016 ","6","2","4",
"83 s","Short-term Visitors","2017 ","3","0","3",
"83 s","Short-term Visitors","2018 ","4","2","2",
"83 s","Short-term Visitors","2019 ","6","1","5",
"83 s","Short-term Employment","2000 ","0","0","0",
"83 s","Short-term Employment","2001 ","0","0","0",
"83 s","Short-term Employment","2002 ","0","0","0",
"83 s","Short-term Employment","2003 ","0","0","0",
"83 s","Short-term Employment","2004 ","0","0","0",
"83 s","Short-term Employment","2005 ","0","0","0",
"83 s","Short-term Employment","2006 ","0","0","0",
"83 s","Short-term Employment","2007 ","0","0","0",
"83 s","Short-term Employment","2008 ","0","0","0",
"83 s","Short-term Employment","2009 ","0","0","0",
"83 s","Short-term Employment","2010 ","0","0","0",
"83 s","Job Seeking","2000 ","0","0","0",
"83 s","Job Seeking","2001 ","0","0","0",
"83 s","Job Seeking","2002 ","0","0","0",
"83 s","Job Seeking","2003 ","0","0","0",
"83 s","Job Seeking","2004 ","0","0","0",
"83 s","Job Seeking","2005 ","0","0","0",
"83 s","Job Seeking","2006 ","0","0","0",
"83 s","Job Seeking","2007 ","0","0","0",
"83 s","Job Seeking","2008 ","0","0","0",
"83 s","Job Seeking","2009 ","0","0","0",
"83 s","Job Seeking","2010 ","0","0","0",
"83 s","study","2000 ","0","0","0",
"83 s","study","2001 ","0","0","0",
"83 s","study","2002 ","0","0","0",
"83 s","study","2003 ","0","0","0",
"83 s","study","2004 ","0","0","0",
"83 s","study","2005 ","0","0","0",
"83 s","study","2006 ","0","0","0",
"83 s","study","2007 ","0","0","0",
"83 s","study","2008 ","0","0","0",
"83 s","study","2009 ","0","0","0",
"83 s","study","2010 ","0","0","0",
"83 s","study","2015 ","1","0","1",
"83 s","General Trainees","2000 ","0","0","0",
"83 s","General Trainees","2001 ","0","0","0",
"83 s","General Trainees","2002 ","0","0","0",
"83 s","General Trainees","2003 ","0","0","0",
"83 s","General Trainees","2004 ","0","0","0",
"83 s","General Trainees","2005 ","0","0","0",
"83 s","General Trainees","2006 ","0","0","0",
"83 s","General Trainees","2007 ","0","0","0",
"83 s","General Trainees","2008 ","0","0","0",
"83 s","General Trainees","2009 ","0","0","0",
"83 s","General Trainees","2010 ","0","0","0",
"83 s","Religious Activities","2000 ","1","1","0",
"83 s","Religious Activities","2001 ","2","1","1",
"83 s","Religious Activities","2002 ","0","0","0",
"83 s","Religious Activities","2003 ","1","1","0",
"83 s","Religious Activities","2004 ","0","0","0",
"83 s","Religious Activities","2005 ","0","0","0",
"83 s","Religious Activities","2006 ","0","0","0",
"83 s","Religious Activities","2007 ","1","1","0",
"83 s","Religious Activities","2008 ","0","0","0",
"83 s","Religious Activities","2009 ","0","0","0",
"83 s","Religious Activities","2010 ","0","0","0",
"83 s","Religious Activities","2013 ","2","1","1",
"83 s","Religious Activities","2014 ","1","1","0",
"83 s","Religious Activities","2016 ","1","1","0",
"83 s","Investors","2000 ","0","0","0",
"83 s","Investors","2001 ","0","0","0",
"83 s","Investors","2002 ","0","0","0",
"83 s","Investors","2003 ","0","0","0",
"83 s","Investors","2004 ","0","0","0",
"83 s","Investors","2005 ","0","0","0",
"83 s","Investors","2006 ","0","0","0",
"83 s","Investors","2007 ","0","0","0",
"83 s","Investors","2008 ","0","0","0",
"83 s","Investors","2009 ","0","0","0",
"83 s","Investors","2010 ","0","0","0",
"83 s","Trade and Business","2000 ","0","0","0",
"83 s","Trade and Business","2001 ","0","0","0",
"83 s","Trade and Business","2002 ","0","0","0",
"83 s","Trade and Business","2003 ","0","0","0",
"83 s","Trade and Business","2004 ","0","0","0",
"83 s","Trade and Business","2005 ","0","0","0",
"83 s","Trade and Business","2006 ","0","0","0",
"83 s","Trade and Business","2007 ","0","0","0",
"83 s","Trade and Business","2008 ","0","0","0",
"83 s","Trade and Business","2009 ","0","0","0",
"83 s","Trade and Business","2010 ","0","0","0",
"83 s","Research","2000 ","0","0","0",
"83 s","Research","2001 ","0","0","0",
"83 s","Research","2002 ","0","0","0",
"83 s","Research","2003 ","0","0","0",
"83 s","Research","2004 ","0","0","0",
"83 s","Research","2005 ","0","0","0",
"83 s","Research","2006 ","0","0","0",
"83 s","Research","2007 ","0","0","0",
"83 s","Research","2008 ","0","0","0",
"83 s","Research","2009 ","0","0","0",
"83 s","Research","2010 ","0","0","0",
"83 s","Art and Entertainment","2000 ","0","0","0",
"83 s","Art and Entertainment","2001 ","0","0","0",
"83 s","Art and Entertainment","2002 ","0","0","0",
"83 s","Art and Entertainment","2003 ","0","0","0",
"83 s","Art and Entertainment","2004 ","0","0","0",
"83 s","Art and Entertainment","2005 ","0","0","0",
"83 s","Art and Entertainment","2006 ","0","0","0",
"83 s","Art and Entertainment","2007 ","0","0","0",
"83 s","Art and Entertainment","2008 ","0","0","0",
"83 s","Art and Entertainment","2009 ","0","0","0",
"83 s","Art and Entertainment","2010 ","0","0","0",
"83 s","Unskilled Employment","2000 ","0","0","0",
"83 s","Unskilled Employment","2001 ","0","0","0",
"83 s","Unskilled Employment","2002 ","0","0","0",
"83 s","Unskilled Employment","2003 ","0","0","0",
"83 s","Unskilled Employment","2004 ","0","0","0",
"83 s","Unskilled Employment","2005 ","0","0","0",
"83 s","Unskilled Employment","2006 ","0","0","0",
"83 s","Unskilled Employment","2007 ","0","0","0",
"83 s","Unskilled Employment","2008 ","0","0","0",
"83 s","Unskilled Employment","2009 ","0","0","0",
"83 s","Unskilled Employment","2010 ","0","0","0",
"83 s","Visiting and Joining Family","2000 ","3","2","1",
"83 s","Visiting and Joining Family","2001 ","5","2","3",
"83 s","Visiting and Joining Family","2002 ","5","1","4",
"83 s","Visiting and Joining Family","2003 ","2","1","1",
"83 s","Visiting and Joining Family","2004 ","4","1","3",
"83 s","Visiting and Joining Family","2005 ","7","3","4",
"83 s","Visiting and Joining Family","2006 ","7","1","6",
"83 s","Visiting and Joining Family","2007 ","5","0","5",
"83 s","Visiting and Joining Family","2008 ","8","3","5",
"83 s","Visiting and Joining Family","2009 ","5","3","2",
"83 s","Visiting and Joining Family","2010 ","5","4","1",
"83 s","Visiting and Joining Family","2011 ","13","5","8",
"83 s","Visiting and Joining Family","2012 ","44","6","38",
"83 s","Visiting and Joining Family","2013 ","41","4","37",
"83 s","Visiting and Joining Family","2014 ","7","2","5",
"83 s","Visiting and Joining Family","2015 ","2","2","0",
"83 s","Visiting and Joining Family","2016 ","2","1","1",
"83 s","Visiting and Joining Family","2018 ","3","1","2",
"83 s","Visiting and Joining Family","2019 ","1","1","0",
"83 s","Overseas Koreans","2000 ","0","0","0",
"83 s","Overseas Koreans","2001 ","2","2","0",
"83 s","Overseas Koreans","2002 ","2","1","1",
"83 s","Overseas Koreans","2003 ","0","0","0",
"83 s","Overseas Koreans","2004 ","3","1","2",
"83 s","Overseas Koreans","2005 ","3","2","1",
"83 s","Overseas Koreans","2006 ","3","0","3",
"83 s","Overseas Koreans","2007 ","1","0","1",
"83 s","Overseas Koreans","2008 ","3","0","3",
"83 s","Overseas Koreans","2009 ","4","2","2",
"83 s","Overseas Koreans","2010 ","6","3","3",
"83 s","Overseas Koreans","2011 ","8","4","4",
"83 s","Overseas Koreans","2012 ","18","10","8",
"83 s","Overseas Koreans","2013 ","31","8","23",
"83 s","Overseas Koreans","2014 ","99","15","84",
"83 s","Overseas Koreans","2015 ","95","25","70",
"83 s","Overseas Koreans","2016 ","116","25","91",
"83 s","Overseas Koreans","2017 ","147","28","119",
"83 s","Overseas Koreans","2018 ","146","45","101",
"83 s","Overseas Koreans","2019 ","147","43","104",
"83 s","Permanent Residence","2000 ","0","0","0",
"83 s","Permanent Residence","2001 ","0","0","0",
"83 s","Permanent Residence","2002 ","0","0","0",
"83 s","Permanent Residence","2003 ","1","0","1",
"83 s","Permanent Residence","2004 ","1","1","0",
"83 s","Permanent Residence","2005 ","1","1","0",
"83 s","Permanent Residence","2006 ","1","0","1",
"83 s","Permanent Residence","2007 ","0","0","0",
"83 s","Permanent Residence","2008 ","4","2","2",
"83 s","Permanent Residence","2009 ","1","0","1",
"83 s","Permanent Residence","2010 ","3","0","3",
"83 s","Permanent Residence","2011 ","3","","3",
"83 s","Permanent Residence","2012 ","2","","2",
"83 s","Permanent Residence","2013 ","5","1","4",
"83 s","Permanent Residence","2014 ","5","4","1",
"83 s","Permanent Residence","2015 ","1","0","1",
"83 s","Permanent Residence","2016 ","3","1","2",
"83 s","Permanent Residence","2017 ","6","0","6",
"83 s","Permanent Residence","2018 ","2","0","2",
"83 s","Permanent Residence","2019 ","5","5","0",
"83 s","Marriage Immigration","2012 ","1","1","",
"83 s","Marriage Immigration","2014 ","2","2","0",
"83 s","Marriage Immigration","2017 ","1","0","1",
"83 s","Marriage Immigration","2018 ","1","1","0",
"84 s","Total","2000 ","16","8","8",
"84 s","Total","2001 ","22","7","15",
"84 s","Total","2002 ","14","9","5",
"84 s","Total","2003 ","27","13","14",
"84 s","Total","2004 ","32","10","22",
"84 s","Total","2005 ","41","17","24",
"84 s","Total","2006 ","54","13","41",
"84 s","Total","2007 ","46","10","36",
"84 s","Total","2008 ","44","7","37",
"84 s","Total","2009 ","32","10","22",
"84 s","Total","2010 ","44","13","31",
"84 s","Total","2011 ","64","17","47",
"84 s","Total","2012 ","80","30","50",
"84 s","Total","2013 ","68","23","45",
"84 s","Total","2014 ","115","31","84",
"84 s","Total","2015 ","112","31","81",
"84 s","Total","2016 ","111","29","82",
"84 s","Total","2017 ","124","38","86",
"84 s","Total","2018 ","151","45","106",
"84 s","Total","2019 ","143","45","98",
"84 s","Sightseeing Pass","2000 ","5","2","3",
"84 s","Sightseeing Pass","2001 ","7","2","5",
"84 s","Sightseeing Pass","2002 ","7","6","1",
"84 s","Sightseeing Pass","2003 ","9","4","5",
"84 s","Sightseeing Pass","2004 ","9","2","7",
"84 s","Sightseeing Pass","2005 ","12","4","8",
"84 s","Sightseeing Pass","2006 ","14","4","10",
"84 s","Sightseeing Pass","2007 ","11","3","8",
"84 s","Sightseeing Pass","2008 ","8","3","5",
"84 s","Sightseeing Pass","2009 ","12","3","9",
"84 s","Sightseeing Pass","2010 ","16","4","12",
"84 s","Sightseeing Pass","2011 ","14","8","6",
"84 s","Sightseeing Pass","2012 ","21","10","11",
"84 s","Sightseeing Pass","2013 ","8","3","5",
"84 s","Sightseeing Pass","2014 ","28","8","20",
"84 s","Sightseeing Pass","2015 ","27","10","17",
"84 s","Sightseeing Pass","2016 ","16","6","10",
"84 s","Sightseeing Pass","2017 ","12","5","7",
"84 s","Sightseeing Pass","2018 ","13","6","7",
"84 s","Sightseeing Pass","2019 ","11","4","7",
"84 s","Short-term Business","2000 ","0","0","0",
"84 s","Short-term Business","2001 ","0","0","0",
"84 s","Short-term Business","2002 ","0","0","0",
"84 s","Short-term Business","2003 ","0","0","0",
"84 s","Short-term Business","2004 ","0","0","0",
"84 s","Short-term Business","2005 ","0","0","0",
"84 s","Short-term Business","2006 ","0","0","0",
"84 s","Short-term Business","2007 ","0","0","0",
"84 s","Short-term Business","2008 ","0","0","0",
"84 s","Short-term Business","2009 ","0","0","0",
"84 s","Short-term Business","2010 ","0","0","0",
"84 s","Short-term Visitors","2000 ","5","3","2",
"84 s","Short-term Visitors","2001 ","9","3","6",
"84 s","Short-term Visitors","2002 ","2","0","2",
"84 s","Short-term Visitors","2003 ","7","2","5",
"84 s","Short-term Visitors","2004 ","12","1","11",
"84 s","Short-term Visitors","2005 ","22","9","13",
"84 s","Short-term Visitors","2006 ","29","5","24",
"84 s","Short-term Visitors","2007 ","20","2","18",
"84 s","Short-term Visitors","2008 ","15","1","14",
"84 s","Short-term Visitors","2009 ","8","1","7",
"84 s","Short-term Visitors","2010 ","18","5","13",
"84 s","Short-term Visitors","2011 ","28","5","23",
"84 s","Short-term Visitors","2012 ","12","3","9",
"84 s","Short-term Visitors","2013 ","5","3","2",
"84 s","Short-term Visitors","2014 ","4","2","2",
"84 s","Short-term Visitors","2017 ","3","1","2",
"84 s","Short-term Visitors","2018 ","3","1","2",
"84 s","Short-term Employment","2000 ","0","0","0",
"84 s","Short-term Employment","2001 ","0","0","0",
"84 s","Short-term Employment","2002 ","0","0","0",
"84 s","Short-term Employment","2003 ","0","0","0",
"84 s","Short-term Employment","2004 ","0","0","0",
"84 s","Short-term Employment","2005 ","0","0","0",
"84 s","Short-term Employment","2006 ","0","0","0",
"84 s","Short-term Employment","2007 ","0","0","0",
"84 s","Short-term Employment","2008 ","0","0","0",
"84 s","Short-term Employment","2009 ","0","0","0",
"84 s","Short-term Employment","2010 ","0","0","0",
"84 s","Job Seeking","2000 ","0","0","0",
"84 s","Job Seeking","2001 ","0","0","0",
"84 s","Job Seeking","2002 ","0","0","0",
"84 s","Job Seeking","2003 ","0","0","0",
"84 s","Job Seeking","2004 ","0","0","0",
"84 s","Job Seeking","2005 ","0","0","0",
"84 s","Job Seeking","2006 ","0","0","0",
"84 s","Job Seeking","2007 ","0","0","0",
"84 s","Job Seeking","2008 ","0","0","0",
"84 s","Job Seeking","2009 ","0","0","0",
"84 s","Job Seeking","2010 ","0","0","0",
"84 s","study","2000 ","0","0","0",
"84 s","study","2001 ","0","0","0",
"84 s","study","2002 ","0","0","0",
"84 s","study","2003 ","0","0","0",
"84 s","study","2004 ","0","0","0",
"84 s","study","2005 ","0","0","0",
"84 s","study","2006 ","0","0","0",
"84 s","study","2007 ","0","0","0",
"84 s","study","2008 ","0","0","0",
"84 s","study","2009 ","0","0","0",
"84 s","study","2010 ","0","0","0",
"84 s","General Trainees","2000 ","0","0","0",
"84 s","General Trainees","2001 ","0","0","0",
"84 s","General Trainees","2002 ","0","0","0",
"84 s","General Trainees","2003 ","0","0","0",
"84 s","General Trainees","2004 ","0","0","0",
"84 s","General Trainees","2005 ","0","0","0",
"84 s","General Trainees","2006 ","0","0","0",
"84 s","General Trainees","2007 ","0","0","0",
"84 s","General Trainees","2008 ","0","0","0",
"84 s","General Trainees","2009 ","0","0","0",
"84 s","General Trainees","2010 ","0","0","0",
"84 s","Religious Activities","2000 ","0","0","0",
"84 s","Religious Activities","2001 ","0","0","0",
"84 s","Religious Activities","2002 ","0","0","0",
"84 s","Religious Activities","2003 ","0","0","0",
"84 s","Religious Activities","2004 ","0","0","0",
"84 s","Religious Activities","2005 ","0","0","0",
"84 s","Religious Activities","2006 ","0","0","0",
"84 s","Religious Activities","2007 ","1","1","0",
"84 s","Religious Activities","2008 ","0","0","0",
"84 s","Religious Activities","2009 ","0","0","0",
"84 s","Religious Activities","2010 ","0","0","0",
"84 s","Religious Activities","2013 ","1","1","0",
"84 s","Investors","2000 ","0","0","0",
"84 s","Investors","2001 ","0","0","0",
"84 s","Investors","2002 ","0","0","0",
"84 s","Investors","2003 ","0","0","0",
"84 s","Investors","2004 ","0","0","0",
"84 s","Investors","2005 ","0","0","0",
"84 s","Investors","2006 ","0","0","0",
"84 s","Investors","2007 ","0","0","0",
"84 s","Investors","2008 ","0","0","0",
"84 s","Investors","2009 ","0","0","0",
"84 s","Investors","2010 ","0","0","0",
"84 s","Trade and Business","2000 ","0","0","0",
"84 s","Trade and Business","2001 ","0","0","0",
"84 s","Trade and Business","2002 ","0","0","0",
"84 s","Trade and Business","2003 ","0","0","0",
"84 s","Trade and Business","2004 ","0","0","0",
"84 s","Trade and Business","2005 ","0","0","0",
"84 s","Trade and Business","2006 ","0","0","0",
"84 s","Trade and Business","2007 ","0","0","0",
"84 s","Trade and Business","2008 ","0","0","0",
"84 s","Trade and Business","2009 ","0","0","0",
"84 s","Trade and Business","2010 ","0","0","0",
"84 s","Research","2000 ","0","0","0",
"84 s","Research","2001 ","0","0","0",
"84 s","Research","2002 ","0","0","0",
"84 s","Research","2003 ","0","0","0",
"84 s","Research","2004 ","0","0","0",
"84 s","Research","2005 ","0","0","0",
"84 s","Research","2006 ","0","0","0",
"84 s","Research","2007 ","0","0","0",
"84 s","Research","2008 ","0","0","0",
"84 s","Research","2009 ","0","0","0",
"84 s","Research","2010 ","0","0","0",
"84 s","Art and Entertainment","2000 ","0","0","0",
"84 s","Art and Entertainment","2001 ","0","0","0",
"84 s","Art and Entertainment","2002 ","0","0","0",
"84 s","Art and Entertainment","2003 ","0","0","0",
"84 s","Art and Entertainment","2004 ","0","0","0",
"84 s","Art and Entertainment","2005 ","0","0","0",
"84 s","Art and Entertainment","2006 ","0","0","0",
"84 s","Art and Entertainment","2007 ","0","0","0",
"84 s","Art and Entertainment","2008 ","0","0","0",
"84 s","Art and Entertainment","2009 ","0","0","0",
"84 s","Art and Entertainment","2010 ","0","0","0",
"84 s","Unskilled Employment","2000 ","0","0","0",
"84 s","Unskilled Employment","2001 ","0","0","0",
"84 s","Unskilled Employment","2002 ","0","0","0",
"84 s","Unskilled Employment","2003 ","0","0","0",
"84 s","Unskilled Employment","2004 ","0","0","0",
"84 s","Unskilled Employment","2005 ","0","0","0",
"84 s","Unskilled Employment","2006 ","0","0","0",
"84 s","Unskilled Employment","2007 ","0","0","0",
"84 s","Unskilled Employment","2008 ","0","0","0",
"84 s","Unskilled Employment","2009 ","0","0","0",
"84 s","Unskilled Employment","2010 ","0","0","0",
"84 s","Visiting and Joining Family","2000 ","2","0","2",
"84 s","Visiting and Joining Family","2001 ","4","1","3",
"84 s","Visiting and Joining Family","2002 ","1","0","1",
"84 s","Visiting and Joining Family","2003 ","4","2","2",
"84 s","Visiting and Joining Family","2004 ","6","4","2",
"84 s","Visiting and Joining Family","2005 ","2","2","0",
"84 s","Visiting and Joining Family","2006 ","6","2","4",
"84 s","Visiting and Joining Family","2007 ","6","1","5",
"84 s","Visiting and Joining Family","2008 ","7","2","5",
"84 s","Visiting and Joining Family","2009 ","3","0","3",
"84 s","Visiting and Joining Family","2010 ","1","0","1",
"84 s","Visiting and Joining Family","2011 ","10","1","9",
"84 s","Visiting and Joining Family","2012 ","27","7","20",
"84 s","Visiting and Joining Family","2013 ","28","6","22",
"84 s","Visiting and Joining Family","2014 ","6","2","4",
"84 s","Visiting and Joining Family","2015 ","1","1","0",
"84 s","Visiting and Joining Family","2017 ","3","2","1",
"84 s","Visiting and Joining Family","2018 ","1","1","0",
"84 s","Visiting and Joining Family","2019 ","3","1","2",
"84 s","Overseas Koreans","2000 ","1","1","0",
"84 s","Overseas Koreans","2001 ","1","1","0",
"84 s","Overseas Koreans","2002 ","3","2","1",
"84 s","Overseas Koreans","2003 ","3","2","1",
"84 s","Overseas Koreans","2004 ","0","0","0",
"84 s","Overseas Koreans","2005 ","0","0","0",
"84 s","Overseas Koreans","2006 ","3","1","2",
"84 s","Overseas Koreans","2007 ","5","2","3",
"84 s","Overseas Koreans","2008 ","2","0","2",
"84 s","Overseas Koreans","2009 ","3","2","1",
"84 s","Overseas Koreans","2010 ","4","2","2",
"84 s","Overseas Koreans","2011 ","6","3","3",
"84 s","Overseas Koreans","2012 ","12","8","4",
"84 s","Overseas Koreans","2013 ","20","8","12",
"84 s","Overseas Koreans","2014 ","73","16","57",
"84 s","Overseas Koreans","2015 ","80","19","61",
"84 s","Overseas Koreans","2016 ","92","21","71",
"84 s","Overseas Koreans","2017 ","99","28","71",
"84 s","Overseas Koreans","2018 ","128","36","92",
"84 s","Overseas Koreans","2019 ","124","39","85",
"84 s","Permanent Residence","2000 ","0","0","0",
"84 s","Permanent Residence","2001 ","0","0","0",
"84 s","Permanent Residence","2002 ","0","0","0",
"84 s","Permanent Residence","2003 ","1","1","0",
"84 s","Permanent Residence","2004 ","1","1","0",
"84 s","Permanent Residence","2005 ","1","1","0",
"84 s","Permanent Residence","2006 ","0","0","0",
"84 s","Permanent Residence","2007 ","1","0","1",
"84 s","Permanent Residence","2008 ","1","0","1",
"84 s","Permanent Residence","2009 ","3","2","1",
"84 s","Permanent Residence","2010 ","2","1","1",
"84 s","Permanent Residence","2011 ","3","","3",
"84 s","Permanent Residence","2012 ","1","1","",
"84 s","Permanent Residence","2013 ","3","1","2",
"84 s","Permanent Residence","2014 ","2","2","0",
"84 s","Permanent Residence","2015 ","3","1","2",
"84 s","Permanent Residence","2016 ","2","1","1",
"84 s","Permanent Residence","2017 ","7","2","5",
"84 s","Permanent Residence","2018 ","4","0","4",
"84 s","Permanent Residence","2019 ","3","1","2",
"84 s","Marriage Immigration","2013 ","1","1","0",
"84 s","Marriage Immigration","2014 ","1","1","0",
"85 s old & over","Total","2000 ","73","32","41",
"85 s old & over","Total","2001 ","87","36","51",
"85 s old & over","Total","2002 ","59","25","34",
"85 s old & over","Total","2003 ","73","35","38",
"85 s old & over","Total","2004 ","83","32","51",
"85 s old & over","Total","2005 ","149","51","98",
"85 s old & over","Total","2006 ","117","43","74",
"85 s old & over","Total","2007 ","114","31","83",
"85 s old & over","Total","2008 ","130","36","94",
"85 s old & over","Total","2009 ","109","29","80",
"85 s old & over","Total","2010 ","165","54","111",
"85 s old & over","Total","2011 ","209","58","151",
"85 s old & over","Total","2012 ","234","83","151",
"85 s old & over","Total","2013 ","212","64","148",
"85 s old & over","Total","2014 ","293","76","217",
"85 s old & over","Total","2015 ","359","123","236",
"85 s old & over","Total","2016 ","365","93","272",
"85 s old & over","Total","2017 ","340","98","242",
"85 s old & over","Total","2018 ","368","93","275",
"85 s old & over","Total","2019 ","404","130","274",
"85 s old & over","Sightseeing Pass","2000 ","19","10","9",
"85 s old & over","Sightseeing Pass","2001 ","40","18","22",
"85 s old & over","Sightseeing Pass","2002 ","27","11","16",
"85 s old & over","Sightseeing Pass","2003 ","21","11","10",
"85 s old & over","Sightseeing Pass","2004 ","35","10","25",
"85 s old & over","Sightseeing Pass","2005 ","38","18","20",
"85 s old & over","Sightseeing Pass","2006 ","39","17","22",
"85 s old & over","Sightseeing Pass","2007 ","37","10","27",
"85 s old & over","Sightseeing Pass","2008 ","37","9","28",
"85 s old & over","Sightseeing Pass","2009 ","54","11","43",
"85 s old & over","Sightseeing Pass","2010 ","71","25","46",
"85 s old & over","Sightseeing Pass","2011 ","89","29","60",
"85 s old & over","Sightseeing Pass","2012 ","103","32","71",
"85 s old & over","Sightseeing Pass","2013 ","68","19","49",
"85 s old & over","Sightseeing Pass","2014 ","64","24","40",
"85 s old & over","Sightseeing Pass","2015 ","102","41","61",
"85 s old & over","Sightseeing Pass","2016 ","90","28","62",
"85 s old & over","Sightseeing Pass","2017 ","53","19","34",
"85 s old & over","Sightseeing Pass","2018 ","78","21","57",
"85 s old & over","Sightseeing Pass","2019 ","69","20","49",
"85 s old & over","Short-term Business","2000 ","0","0","0",
"85 s old & over","Short-term Business","2001 ","2","2","0",
"85 s old & over","Short-term Business","2002 ","0","0","0",
"85 s old & over","Short-term Business","2003 ","0","0","0",
"85 s old & over","Short-term Business","2004 ","2","1","1",
"85 s old & over","Short-term Business","2005 ","2","1","1",
"85 s old & over","Short-term Business","2006 ","0","0","0",
"85 s old & over","Short-term Business","2007 ","0","0","0",
"85 s old & over","Short-term Business","2008 ","0","0","0",
"85 s old & over","Short-term Business","2009 ","0","0","0",
"85 s old & over","Short-term Business","2010 ","1","1","0",
"85 s old & over","Short-term Business","2011 ","1","","1",
"85 s old & over","Short-term Visitors","2000 ","36","14","22",
"85 s old & over","Short-term Visitors","2001 ","23","7","16",
"85 s old & over","Short-term Visitors","2002 ","17","6","11",
"85 s old & over","Short-term Visitors","2003 ","24","9","15",
"85 s old & over","Short-term Visitors","2004 ","29","10","19",
"85 s old & over","Short-term Visitors","2005 ","75","19","56",
"85 s old & over","Short-term Visitors","2006 ","50","13","37",
"85 s old & over","Short-term Visitors","2007 ","49","11","38",
"85 s old & over","Short-term Visitors","2008 ","42","9","33",
"85 s old & over","Short-term Visitors","2009 ","28","6","22",
"85 s old & over","Short-term Visitors","2010 ","39","11","28",
"85 s old & over","Short-term Visitors","2011 ","67","14","53",
"85 s old & over","Short-term Visitors","2012 ","16","5","11",
"85 s old & over","Short-term Visitors","2013 ","11","1","10",
"85 s old & over","Short-term Visitors","2014 ","4","2","2",
"85 s old & over","Short-term Visitors","2015 ","8","4","4",
"85 s old & over","Short-term Visitors","2016 ","6","3","3",
"85 s old & over","Short-term Visitors","2017 ","7","2","5",
"85 s old & over","Short-term Visitors","2018 ","5","2","3",
"85 s old & over","Short-term Visitors","2019 ","8","3","5",
"85 s old & over","Short-term Employment","2000 ","0","0","0",
"85 s old & over","Short-term Employment","2001 ","0","0","0",
"85 s old & over","Short-term Employment","2002 ","0","0","0",
"85 s old & over","Short-term Employment","2003 ","0","0","0",
"85 s old & over","Short-term Employment","2004 ","0","0","0",
"85 s old & over","Short-term Employment","2005 ","0","0","0",
"85 s old & over","Short-term Employment","2006 ","0","0","0",
"85 s old & over","Short-term Employment","2007 ","0","0","0",
"85 s old & over","Short-term Employment","2008 ","0","0","0",
"85 s old & over","Short-term Employment","2009 ","0","0","0",
"85 s old & over","Short-term Employment","2010 ","0","0","0",
"85 s old & over","Job Seeking","2000 ","0","0","0",
"85 s old & over","Job Seeking","2001 ","0","0","0",
"85 s old & over","Job Seeking","2002 ","0","0","0",
"85 s old & over","Job Seeking","2003 ","0","0","0",
"85 s old & over","Job Seeking","2004 ","0","0","0",
"85 s old & over","Job Seeking","2005 ","0","0","0",
"85 s old & over","Job Seeking","2006 ","0","0","0",
"85 s old & over","Job Seeking","2007 ","0","0","0",
"85 s old & over","Job Seeking","2008 ","0","0","0",
"85 s old & over","Job Seeking","2009 ","0","0","0",
"85 s old & over","Job Seeking","2010 ","0","0","0",
"85 s old & over","study","2000 ","0","0","0",
"85 s old & over","study","2001 ","0","0","0",
"85 s old & over","study","2002 ","0","0","0",
"85 s old & over","study","2003 ","0","0","0",
"85 s old & over","study","2004 ","0","0","0",
"85 s old & over","study","2005 ","0","0","0",
"85 s old & over","study","2006 ","1","0","1",
"85 s old & over","study","2007 ","0","0","0",
"85 s old & over","study","2008 ","0","0","0",
"85 s old & over","study","2009 ","0","0","0",
"85 s old & over","study","2010 ","0","0","0",
"85 s old & over","General Trainees","2000 ","0","0","0",
"85 s old & over","General Trainees","2001 ","0","0","0",
"85 s old & over","General Trainees","2002 ","0","0","0",
"85 s old & over","General Trainees","2003 ","0","0","0",
"85 s old & over","General Trainees","2004 ","0","0","0",
"85 s old & over","General Trainees","2005 ","0","0","0",
"85 s old & over","General Trainees","2006 ","0","0","0",
"85 s old & over","General Trainees","2007 ","0","0","0",
"85 s old & over","General Trainees","2008 ","0","0","0",
"85 s old & over","General Trainees","2009 ","0","0","0",
"85 s old & over","General Trainees","2010 ","0","0","0",
"85 s old & over","Religious Activities","2000 ","0","0","0",
"85 s old & over","Religious Activities","2001 ","0","0","0",
"85 s old & over","Religious Activities","2002 ","1","1","0",
"85 s old & over","Religious Activities","2003 ","0","0","0",
"85 s old & over","Religious Activities","2004 ","0","0","0",
"85 s old & over","Religious Activities","2005 ","0","0","0",
"85 s old & over","Religious Activities","2006 ","0","0","0",
"85 s old & over","Religious Activities","2007 ","0","0","0",
"85 s old & over","Religious Activities","2008 ","0","0","0",
"85 s old & over","Religious Activities","2009 ","0","0","0",
"85 s old & over","Religious Activities","2010 ","1","1","0",
"85 s old & over","Religious Activities","2013 ","1","1","0",
"85 s old & over","Religious Activities","2014 ","1","1","0",
"85 s old & over","Religious Activities","2015 ","1","1","0",
"85 s old & over","Religious Activities","2016 ","2","1","1",
"85 s old & over","Religious Activities","2017 ","1","0","1",
"85 s old & over","Religious Activities","2019 ","3","2","1",
"85 s old & over","Investors","2000 ","0","0","0",
"85 s old & over","Investors","2001 ","0","0","0",
"85 s old & over","Investors","2002 ","1","1","0",
"85 s old & over","Investors","2003 ","0","0","0",
"85 s old & over","Investors","2004 ","0","0","0",
"85 s old & over","Investors","2005 ","1","0","1",
"85 s old & over","Investors","2006 ","0","0","0",
"85 s old & over","Investors","2007 ","0","0","0",
"85 s old & over","Investors","2008 ","0","0","0",
"85 s old & over","Investors","2009 ","0","0","0",
"85 s old & over","Investors","2010 ","0","0","0",
"85 s old & over","Investors","2016 ","1","1","0",
"85 s old & over","Trade and Business","2000 ","0","0","0",
"85 s old & over","Trade and Business","2001 ","0","0","0",
"85 s old & over","Trade and Business","2002 ","0","0","0",
"85 s old & over","Trade and Business","2003 ","0","0","0",
"85 s old & over","Trade and Business","2004 ","0","0","0",
"85 s old & over","Trade and Business","2005 ","0","0","0",
"85 s old & over","Trade and Business","2006 ","0","0","0",
"85 s old & over","Trade and Business","2007 ","0","0","0",
"85 s old & over","Trade and Business","2008 ","0","0","0",
"85 s old & over","Trade and Business","2009 ","0","0","0",
"85 s old & over","Trade and Business","2010 ","0","0","0",
"85 s old & over","Research","2000 ","0","0","0",
"85 s old & over","Research","2001 ","0","0","0",
"85 s old & over","Research","2002 ","0","0","0",
"85 s old & over","Research","2003 ","0","0","0",
"85 s old & over","Research","2004 ","0","0","0",
"85 s old & over","Research","2005 ","0","0","0",
"85 s old & over","Research","2006 ","0","0","0",
"85 s old & over","Research","2007 ","0","0","0",
"85 s old & over","Research","2008 ","0","0","0",
"85 s old & over","Research","2009 ","0","0","0",
"85 s old & over","Research","2010 ","0","0","0",
"85 s old & over","Art and Entertainment","2000 ","1","0","1",
"85 s old & over","Art and Entertainment","2001 ","0","0","0",
"85 s old & over","Art and Entertainment","2002 ","0","0","0",
"85 s old & over","Art and Entertainment","2003 ","0","0","0",
"85 s old & over","Art and Entertainment","2004 ","0","0","0",
"85 s old & over","Art and Entertainment","2005 ","0","0","0",
"85 s old & over","Art and Entertainment","2006 ","0","0","0",
"85 s old & over","Art and Entertainment","2007 ","0","0","0",
"85 s old & over","Art and Entertainment","2008 ","0","0","0",
"85 s old & over","Art and Entertainment","2009 ","0","0","0",
"85 s old & over","Art and Entertainment","2010 ","0","0","0",
"85 s old & over","Unskilled Employment","2000 ","0","0","0",
"85 s old & over","Unskilled Employment","2001 ","0","0","0",
"85 s old & over","Unskilled Employment","2002 ","0","0","0",
"85 s old & over","Unskilled Employment","2003 ","0","0","0",
"85 s old & over","Unskilled Employment","2004 ","0","0","0",
"85 s old & over","Unskilled Employment","2005 ","0","0","0",
"85 s old & over","Unskilled Employment","2006 ","0","0","0",
"85 s old & over","Unskilled Employment","2007 ","0","0","0",
"85 s old & over","Unskilled Employment","2008 ","0","0","0",
"85 s old & over","Unskilled Employment","2009 ","0","0","0",
"85 s old & over","Unskilled Employment","2010 ","0","0","0",
"85 s old & over","Visiting and Joining Family","2000 ","5","2","3",
"85 s old & over","Visiting and Joining Family","2001 ","12","5","7",
"85 s old & over","Visiting and Joining Family","2002 ","1","0","1",
"85 s old & over","Visiting and Joining Family","2003 ","6","3","3",
"85 s old & over","Visiting and Joining Family","2004 ","5","3","2",
"85 s old & over","Visiting and Joining Family","2005 ","17","5","12",
"85 s old & over","Visiting and Joining Family","2006 ","13","4","9",
"85 s old & over","Visiting and Joining Family","2007 ","12","4","8",
"85 s old & over","Visiting and Joining Family","2008 ","12","7","5",
"85 s old & over","Visiting and Joining Family","2009 ","8","2","6",
"85 s old & over","Visiting and Joining Family","2010 ","9","2","7",
"85 s old & over","Visiting and Joining Family","2011 ","25","5","20",
"85 s old & over","Visiting and Joining Family","2012 ","68","21","47",
"85 s old & over","Visiting and Joining Family","2013 ","66","12","54",
"85 s old & over","Visiting and Joining Family","2014 ","5","1","4",
"85 s old & over","Visiting and Joining Family","2015 ","5","2","3",
"85 s old & over","Visiting and Joining Family","2016 ","5","3","2",
"85 s old & over","Visiting and Joining Family","2017 ","2","1","1",
"85 s old & over","Visiting and Joining Family","2018 ","2","2","0",
"85 s old & over","Visiting and Joining Family","2019 ","2","1","1",
"85 s old & over","Overseas Koreans","2000 ","2","1","1",
"85 s old & over","Overseas Koreans","2001 ","2","1","1",
"85 s old & over","Overseas Koreans","2002 ","1","1","0",
"85 s old & over","Overseas Koreans","2003 ","8","5","3",
"85 s old & over","Overseas Koreans","2004 ","5","3","2",
"85 s old & over","Overseas Koreans","2005 ","5","2","3",
"85 s old & over","Overseas Koreans","2006 ","6","2","4",
"85 s old & over","Overseas Koreans","2007 ","4","1","3",
"85 s old & over","Overseas Koreans","2008 ","16","7","9",
"85 s old & over","Overseas Koreans","2009 ","11","8","3",
"85 s old & over","Overseas Koreans","2010 ","25","8","17",
"85 s old & over","Overseas Koreans","2011 ","11","5","6",
"85 s old & over","Overseas Koreans","2012 ","29","19","10",
"85 s old & over","Overseas Koreans","2013 ","55","25","30",
"85 s old & over","Overseas Koreans","2014 ","205","44","161",
"85 s old & over","Overseas Koreans","2015 ","220","61","159",
"85 s old & over","Overseas Koreans","2016 ","239","49","190",
"85 s old & over","Overseas Koreans","2017 ","259","67","192",
"85 s old & over","Overseas Koreans","2018 ","270","62","208",
"85 s old & over","Overseas Koreans","2019 ","301","96","205",
"85 s old & over","Permanent Residence","2000 ","0","0","0",
"85 s old & over","Permanent Residence","2001 ","0","0","0",
"85 s old & over","Permanent Residence","2002 ","0","0","0",
"85 s old & over","Permanent Residence","2003 ","3","3","0",
"85 s old & over","Permanent Residence","2004 ","1","1","0",
"85 s old & over","Permanent Residence","2005 ","3","0","3",
"85 s old & over","Permanent Residence","2006 ","3","3","0",
"85 s old & over","Permanent Residence","2007 ","2","1","1",
"85 s old & over","Permanent Residence","2008 ","1","0","1",
"85 s old & over","Permanent Residence","2009 ","2","0","2",
"85 s old & over","Permanent Residence","2010 ","8","3","5",
"85 s old & over","Permanent Residence","2011 ","6","3","3",
"85 s old & over","Permanent Residence","2012 ","8","3","5",
"85 s old & over","Permanent Residence","2013 ","9","4","5",
"85 s old & over","Permanent Residence","2014 ","11","2","9",
"85 s old & over","Permanent Residence","2015 ","14","8","6",
"85 s old & over","Permanent Residence","2016 ","16","6","10",
"85 s old & over","Permanent Residence","2017 ","10","6","4",
"85 s old & over","Permanent Residence","2018 ","9","3","6",
"85 s old & over","Permanent Residence","2019 ","14","5","9",
"85 s old & over","Marriage Immigration","2014 ","1","1","0",
"85 s old & over","Marriage Immigration","2017 ","2","2","0",
"85 s old & over","Marriage Immigration","2018 ","1","1","0",
"85 s old & over","Marriage Immigration","2019 ","1","0","1",
"unknown","Total","2000 ","36","24","12",
"unknown","Total","2001 ","33","21","12",
"unknown","Total","2002 ","25","18","7",
"unknown","Total","2003 ","10","5","5",
"unknown","Total","2004 ","11","6","5",
"unknown","Total","2005 ","7","4","3",
"unknown","Total","2006 ","3","3","0",
"unknown","Total","2007 ","4","1","3",
"unknown","Total","2008 ","3","3","0",
"unknown","Total","2009 ","0","0","0",
"unknown","Total","2010 ","0","0","0",
"unknown","Total","2011 ","2","1","1",
"unknown","Total","2012 ","3","3","",
"unknown","Total","2013 ","1","0","1",
"unknown","Total","2014 ","1","0","1",
"unknown","Total","2016 ","1","0","1",
"unknown","Total","2019 ","3","2","1",
"unknown","Sightseeing Pass","2000 ","17","13","4",
"unknown","Sightseeing Pass","2001 ","13","10","3",
"unknown","Sightseeing Pass","2002 ","9","7","2",
"unknown","Sightseeing Pass","2003 ","2","2","0",
"unknown","Sightseeing Pass","2004 ","1","1","0",
"unknown","Sightseeing Pass","2005 ","4","3","1",
"unknown","Sightseeing Pass","2006 ","1","1","0",
"unknown","Sightseeing Pass","2007 ","1","0","1",
"unknown","Sightseeing Pass","2008 ","2","2","0",
"unknown","Sightseeing Pass","2009 ","0","0","0",
"unknown","Sightseeing Pass","2010 ","0","0","0",
"unknown","Sightseeing Pass","2011 ","1","1","",
"unknown","Sightseeing Pass","2012 ","1","1","",
"unknown","Sightseeing Pass","2014 ","1","0","1",
"unknown","Sightseeing Pass","2016 ","1","0","1",
"unknown","Sightseeing Pass","2019 ","2","1","1",
"unknown","Short-term Business","2000 ","1","1","0",
"unknown","Short-term Business","2001 ","2","2","0",
"unknown","Short-term Business","2002 ","2","2","0",
"unknown","Short-term Business","2003 ","0","0","0",
"unknown","Short-term Business","2004 ","0","0","0",
"unknown","Short-term Business","2005 ","0","0","0",
"unknown","Short-term Business","2006 ","0","0","0",
"unknown","Short-term Business","2007 ","1","0","1",
"unknown","Short-term Business","2008 ","0","0","0",
"unknown","Short-term Business","2009 ","0","0","0",
"unknown","Short-term Business","2010 ","0","0","0",
"unknown","Short-term Visitors","2000 ","7","3","4",
"unknown","Short-term Visitors","2001 ","10","4","6",
"unknown","Short-term Visitors","2002 ","8","6","2",
"unknown","Short-term Visitors","2003 ","1","0","1",
"unknown","Short-term Visitors","2004 ","2","0","2",
"unknown","Short-term Visitors","2005 ","1","0","1",
"unknown","Short-term Visitors","2006 ","1","1","0",
"unknown","Short-term Visitors","2007 ","1","0","1",
"unknown","Short-term Visitors","2008 ","0","0","0",
"unknown","Short-term Visitors","2009 ","0","0","0",
"unknown","Short-term Visitors","2010 ","0","0","0",
"unknown","Short-term Employment","2000 ","0","0","0",
"unknown","Short-term Employment","2001 ","0","0","0",
"unknown","Short-term Employment","2002 ","0","0","0",
"unknown","Short-term Employment","2003 ","0","0","0",
"unknown","Short-term Employment","2004 ","0","0","0",
"unknown","Short-term Employment","2005 ","0","0","0",
"unknown","Short-term Employment","2006 ","0","0","0",
"unknown","Short-term Employment","2007 ","0","0","0",
"unknown","Short-term Employment","2008 ","0","0","0",
"unknown","Short-term Employment","2009 ","0","0","0",
"unknown","Short-term Employment","2010 ","0","0","0",
"unknown","Job Seeking","2000 ","0","0","0",
"unknown","Job Seeking","2001 ","0","0","0",
"unknown","Job Seeking","2002 ","0","0","0",
"unknown","Job Seeking","2003 ","0","0","0",
"unknown","Job Seeking","2004 ","0","0","0",
"unknown","Job Seeking","2005 ","0","0","0",
"unknown","Job Seeking","2006 ","0","0","0",
"unknown","Job Seeking","2007 ","0","0","0",
"unknown","Job Seeking","2008 ","0","0","0",
"unknown","Job Seeking","2009 ","0","0","0",
"unknown","Job Seeking","2010 ","0","0","0",
"unknown","study","2000 ","0","0","0",
"unknown","study","2001 ","0","0","0",
"unknown","study","2002 ","0","0","0",
"unknown","study","2003 ","0","0","0",
"unknown","study","2004 ","1","0","1",
"unknown","study","2005 ","0","0","0",
"unknown","study","2006 ","0","0","0",
"unknown","study","2007 ","0","0","0",
"unknown","study","2008 ","0","0","0",
"unknown","study","2009 ","0","0","0",
"unknown","study","2010 ","0","0","0",
"unknown","General Trainees","2000 ","0","0","0",
"unknown","General Trainees","2001 ","0","0","0",
"unknown","General Trainees","2002 ","0","0","0",
"unknown","General Trainees","2003 ","0","0","0",
"unknown","General Trainees","2004 ","0","0","0",
"unknown","General Trainees","2005 ","0","0","0",
"unknown","General Trainees","2006 ","0","0","0",
"unknown","General Trainees","2007 ","0","0","0",
"unknown","General Trainees","2008 ","0","0","0",
"unknown","General Trainees","2009 ","0","0","0",
"unknown","General Trainees","2010 ","0","0","0",
"unknown","Religious Activities","2000 ","0","0","0",
"unknown","Religious Activities","2001 ","0","0","0",
"unknown","Religious Activities","2002 ","0","0","0",
"unknown","Religious Activities","2003 ","0","0","0",
"unknown","Religious Activities","2004 ","0","0","0",
"unknown","Religious Activities","2005 ","0","0","0",
"unknown","Religious Activities","2006 ","0","0","0",
"unknown","Religious Activities","2007 ","0","0","0",
"unknown","Religious Activities","2008 ","0","0","0",
"unknown","Religious Activities","2009 ","0","0","0",
"unknown","Religious Activities","2010 ","0","0","0",
"unknown","Investors","2000 ","0","0","0",
"unknown","Investors","2001 ","1","1","0",
"unknown","Investors","2002 ","0","0","0",
"unknown","Investors","2003 ","0","0","0",
"unknown","Investors","2004 ","0","0","0",
"unknown","Investors","2005 ","0","0","0",
"unknown","Investors","2006 ","0","0","0",
"unknown","Investors","2007 ","0","0","0",
"unknown","Investors","2008 ","0","0","0",
"unknown","Investors","2009 ","0","0","0",
"unknown","Investors","2010 ","0","0","0",
"unknown","Trade and Business","2000 ","0","0","0",
"unknown","Trade and Business","2001 ","0","0","0",
"unknown","Trade and Business","2002 ","0","0","0",
"unknown","Trade and Business","2003 ","0","0","0",
"unknown","Trade and Business","2004 ","0","0","0",
"unknown","Trade and Business","2005 ","0","0","0",
"unknown","Trade and Business","2006 ","0","0","0",
"unknown","Trade and Business","2007 ","0","0","0",
"unknown","Trade and Business","2008 ","0","0","0",
"unknown","Trade and Business","2009 ","0","0","0",
"unknown","Trade and Business","2010 ","0","0","0",
"unknown","Research","2000 ","0","0","0",
"unknown","Research","2001 ","0","0","0",
"unknown","Research","2002 ","0","0","0",
"unknown","Research","2003 ","0","0","0",
"unknown","Research","2004 ","0","0","0",
"unknown","Research","2005 ","0","0","0",
"unknown","Research","2006 ","0","0","0",
"unknown","Research","2007 ","0","0","0",
"unknown","Research","2008 ","0","0","0",
"unknown","Research","2009 ","0","0","0",
"unknown","Research","2010 ","0","0","0",
"unknown","Art and Entertainment","2000 ","0","0","0",
"unknown","Art and Entertainment","2001 ","1","0","1",
"unknown","Art and Entertainment","2002 ","0","0","0",
"unknown","Art and Entertainment","2003 ","0","0","0",
"unknown","Art and Entertainment","2004 ","0","0","0",
"unknown","Art and Entertainment","2005 ","0","0","0",
"unknown","Art and Entertainment","2006 ","0","0","0",
"unknown","Art and Entertainment","2007 ","0","0","0",
"unknown","Art and Entertainment","2008 ","0","0","0",
"unknown","Art and Entertainment","2009 ","0","0","0",
"unknown","Art and Entertainment","2010 ","0","0","0",
"unknown","Unskilled Employment","2000 ","0","0","0",
"unknown","Unskilled Employment","2001 ","0","0","0",
"unknown","Unskilled Employment","2002 ","0","0","0",
"unknown","Unskilled Employment","2003 ","0","0","0",
"unknown","Unskilled Employment","2004 ","0","0","0",
"unknown","Unskilled Employment","2005 ","0","0","0",
"unknown","Unskilled Employment","2006 ","0","0","0",
"unknown","Unskilled Employment","2007 ","0","0","0",
"unknown","Unskilled Employment","2008 ","0","0","0",
"unknown","Unskilled Employment","2009 ","0","0","0",
"unknown","Unskilled Employment","2010 ","0","0","0",
"unknown","Visiting and Joining Family","2000 ","0","0","0",
"unknown","Visiting and Joining Family","2001 ","0","0","0",
"unknown","Visiting and Joining Family","2002 ","1","0","1",
"unknown","Visiting and Joining Family","2003 ","0","0","0",
"unknown","Visiting and Joining Family","2004 ","0","0","0",
"unknown","Visiting and Joining Family","2005 ","0","0","0",
"unknown","Visiting and Joining Family","2006 ","0","0","0",
"unknown","Visiting and Joining Family","2007 ","0","0","0",
"unknown","Visiting and Joining Family","2008 ","0","0","0",
"unknown","Visiting and Joining Family","2009 ","0","0","0",
"unknown","Visiting and Joining Family","2010 ","0","0","0",
"unknown","Visiting and Joining Family","2013 ","1","0","1",
"unknown","Overseas Koreans","2000 ","1","1","0",
"unknown","Overseas Koreans","2001 ","0","0","0",
"unknown","Overseas Koreans","2002 ","1","1","0",
"unknown","Overseas Koreans","2003 ","0","0","0",
"unknown","Overseas Koreans","2004 ","1","1","0",
"unknown","Overseas Koreans","2005 ","0","0","0",
"unknown","Overseas Koreans","2006 ","0","0","0",
"unknown","Overseas Koreans","2007 ","0","0","0",
"unknown","Overseas Koreans","2008 ","0","0","0",
"unknown","Overseas Koreans","2009 ","0","0","0",
"unknown","Overseas Koreans","2010 ","0","0","0",
"unknown","Permanent Residence","2000 ","0","0","0",
"unknown","Permanent Residence","2001 ","0","0","0",
"unknown","Permanent Residence","2002 ","0","0","0",
"unknown","Permanent Residence","2003 ","0","0","0",
"unknown","Permanent Residence","2004 ","0","0","0",
"unknown","Permanent Residence","2005 ","0","0","0",
"unknown","Permanent Residence","2006 ","0","0","0",
"unknown","Permanent Residence","2007 ","0","0","0",
"unknown","Permanent Residence","2008 ","0","0","0",
"unknown","Permanent Residence","2009 ","0","0","0",
"unknown","Permanent Residence","2010 ","0","0","0",
